Ianthopappus corymbosus	ARG(COS) / BRA(RGS) / URY(ART)
Ibatia boliviensis	ARG(SAL)
Ibatia schreiteri	ARG(JUJ, SAL, TUC)
Ibatia venturii	ARG(TUC)
Iberis amara	ARG(NEU, RNE, SFE)
Ibicella lutea	ARG(BAI, CHA, COR, COS, DFE, ERI, LPA, LRI, MEN, SAL, SDE, SFE, SLU, TUC) / BRA(RGS, SCA) / PRY(APY, GUA) / URY(ART, MON, SJO)
Ibicella parodii	ARG(CAT, COR, JUJ, LRI, MEN, SAL, SDE, SJU, SLU, TUC)
Ichnanthus bambusiflorus	BRA(PAR)
Ichnanthus inconstans	ARG(MIS) / BRA(PAR, RGS, SCA) / PRY(AMA, COA, PAI, SPE)
Ichnanthus leiocarpus	BRA(PAR, RGS, SCA)
Ichnanthus nemoralis	BRA(PAR, SCA)
Ichnanthus procurrens var. subaequiglume	ARG(COS, MIS) / BRA(PAR, RGS, SCA) / PRY(AMA, CAU, CEN, COA, PAI)
Ichnanthus tarijianus	ARG(JUJ, SAL)
Ichthyothere agrestis	BRA(PAR)
Idiothamnus lilloi	ARG(JUJ, SAL, SDE, TUC) / PRY(APY)
Ilex affinis	ARG(MIS) / BRA(PAR) / PRY(APA, AMA, CAA, CAN, SPE)
Ilex argentina	ARG(CAT, JUJ, SAL, TUC)
Ilex brasiliensis	ARG(MIS) / BRA(PAR) / PRY(APA, AMA, CAU, CAA, CAN, GUA, MIE, SPE)
Ilex brevicuspis	ARG(COS, MIS) / BRA(PAR, RGS, SCA) / PRY(APA, CAU, CAA, GUA, ITA)
Ilex chamaedryfolia	BRA(PAR, RGS, SCA)
Ilex dumosa var. dumosa	BRA(PAR, RGS, SCA) / PRY(APA, AMA, CAU, CAA, COA, MIE, SPE) / URY(MON)
Ilex dumosa var. guaranina	ARG(COS, MIS) / BRA(Fuera del área del proyecto) / PRY(APA, AMA, CAU, CAA, CAN, CEN, COA, GUA, PAI, SPE)
Ilex integerrima	BRA(PAR, SCA)
Ilex microdonta	BRA(PAR, RGS, SCA)
Ilex paraguariensis var. paraguariensis	ARG(COS, MIS) / BRA(PAR, RGS, SCA) / PRY(APA, AMA, CAU, CAN, CEN, COA, GUA, ITA, MIE, SPE) / URY(MAL, TAC, TYT)
Ilex paraguariensis var. vestita	BRA(PAR)
Ilex pseudobuxus	BRA(SCA)
Ilex taubertiana	BRA(PAR, RGS, SCA)
Ilex theezans	ARG(MIS) / BRA(PAR, RGS, SCA) / PRY(APA, CAN)
Impatiens balsamina	BRA(SCA)
Impatiens glandulifera	ARG(NEU, RNE)
Impatiens walleriana	ARG(MIS) / BRA(RGS, SCA)
Imperata brasiliensis	ARG(BAI, CHA, COR, COS, ERI, FOR, JUJ, LPA, MIS, SAL, SLU, SFE, TUC) / BRA(PAR, SCA) / PRY(COA) / URY(SJO)
Imperata condensata	ARG(CHU, LPA, MEN, NEU, SJU, SLU) / CHL(ATA, COQ, VAL, MAU, BIO, ARA, LLA, RME)
Imperata contracta	ARG(CHA, FOR) / BRA(PAR, SCA) / PRY(AMA, CAU, CAA, PAI)
Imperata minutiflora	ARG(FOR, JUJ, SAL, SDE, TUC)
Imperata parodii	CHL(ARA)
Imperata tenuis	ARG(COS) / BRA(RGS) / PRY(AMA)
Indigofera asperifolia	ARG(CHA, COS, ERI, FOR, MIS, SFE) / BRA(PAR, RGS) / PRY(CAA, CAN, GUA, MIE, ÑEE) / URY(ART, PAY, RNO, RIV, SAO, SOR, TAC)
Indigofera bongardiana var. bongardiana	ARG(COS) / BRA(PAR) / PRY(AMA, CAU, CAN, CEN, ITA, SPE)
Indigofera bongardiana var. graminoides	PRY(GUA, SPE)
Indigofera campestris	ARG(CAT, JUJ, SAL, TUC) / BRA(PAR, RGS) / PRY(CEN, GUA, ITA, PHA) / URY(ART, PAY, RNO, TAC)
Indigofera guaranitica	ARG(COS, FOR) / BRA(Fuera del área del proyecto) / PRY(CEN, SPE)
Indigofera kurtzii	ARG(CAT, COR)
Indigofera latifolia	ARG(COS, MIS) / PRY(APA, CAU, GUA, ITA)
Indigofera lespedezioides	PRY(APY, CON)
Indigofera parodiana	ARG(COR, COS, SAL, SDE, TUC) / PRY(APY)
Indigofera sabulicola	ARG(COS) / BRA(RGS) / PRY(CEN, COA, ÑEE) / URY(ART, PAY)
Indigofera suffruticosa	ARG(BAI, CAT, CHA, COR, COS, ERI, JUJ, MIS, SAL, SDE, SFE, TUC) / BRA(PAR, RGS, SCA) / PRY(CAU, CAA, CON, COA, GUA) / URY(COL, MAL, RNO, SJO)
Indigofera truxillensis	CHL(TAR)
Inga affinis	ARG(COS, MIS) / BRA(RGS) / PRY(APA, AMA, CAU, CAA, CAN, CEN, CON, COA, ÑEE, PAI)
Inga barbata	BRA(PAR)
Inga edulis	ARG(JUJ, SAL) / BRA(PAR, SCA)
Inga edwallii	BRA(PAR, SCA)
Inga globularis	BRA(SCA)
Inga heterophylla	BRA(PAR, SCA)
Inga laurina	ARG(COS) / BRA(Fuera del área del proyecto) / PRY(CON)
Inga lentiscifolia	BRA(PAR, RGS, SCA)
Inga marginata	ARG(COS, JUJ, MIS, SAL) / BRA(PAR, RGS, SCA) / PRY(APA, CAU, CAA, CAN, COA, GUA, ITA, PAI, SPE)
Inga saltensis	ARG(JUJ, SAL)
Inga sellowiana	BRA(PAR, SCA)
Inga sessilis	BRA(PAR, RGS, SCA)
Inga striata	BRA(PAR, RGS, SCA)
Inga subnuda ssp. luschnathiana	BRA(PAR, SCA)
Inga uraguensis	ARG(BAI, CHA, COS, ERI, FOR, MIS, SFE) / BRA(PAR, RGS, SCA) / PRY(APA, AMA, CAU, CAA, CAN, CEN, CON, COA, PAI) / URY(ART, COL, PAY, RNO, SAO, SOR)
Inga virescens	ARG(MIS) / BRA(PAR, RGS, SCA) / PRY(Desconocida)
Inga vulpina	BRA(PAR, SCA)
Inulopsis scaposa	BRA(PAR) / PRY(APA, CAU, CAA, ITA)
Inulopsis stenophylla	BRA(PAR)
Iochroma australe	ARG(CAT, JUJ, SAL, TUC)
Ionopsis utricularioides	BRA(PAR, SCA) / PRY(AMA, CAN, CON, SPE)
Ipheion sessile	ARG(BAI, ERI) / BRA(RGS) / CHL(MAU, RME) / URY(CAS, LAV, MAL, MON, SJO)
Ipheion setaceum	ARG(TUC)
Ipheion tweedieanum	ARG(BAI, ERI) / URY(RNO)
Ipheion uniflorum	ARG(BAI, LPA, MEN, SLU) / URY(CAS, COL, FLA, MAL, MON, RNO, ROC, SJO, SOR)
Ipomoea acutisepala	ARG(MIS) / BRA(RGS, SCA)
Ipomoea aemilii	PRY(APA)
Ipomoea alba	ARG(BAI, CAT, CHA, COR, COS, DFE, ERI, FOR, JUJ, LPA, MIS, SAL, SFE, TUC) / BRA(PAR, RGS, SCA) / PRY(CEN, COA, PAI) / URY(MON)
Ipomoea altoparanaensis	PRY(APA)
Ipomoea amnicola	ARG(CAT, CHA, COR, COS, FOR, JUJ, LRI, SAL, SDE, SFE) / BRA(Fuera del área del proyecto) / PRY(APY)
Ipomoea argentea	BRA(PAR) / PRY(AMA)
Ipomoea argentinica	ARG(JUJ, SAL) / BRA(SCA)
Ipomoea aristolochaefolia	ARG(COS, JUJ, SAL, TUC) / BRA(Fuera del área del proyecto)
Ipomoea asarifolia	ARG(COS) / BRA(Fuera del área del proyecto) / PRY(APY, COA)
Ipomoea bonariensis var. bonariensis	ARG(BAI, CAT, CHA, COS, DFE, ERI, FOR, MIS, SAL, SDE, SFE) / BRA(PAR, RGS) / PRY(APY, AMA, COA, MIE, PAI, PHA) / URY(ART, COL, SAO)
Ipomoea bonariensis var. erecta	PRY(APY)
Ipomoea cairica	ARG(BAI, CAT, CHA, COR, COS, DFE, ERI, FOR, JUJ, LPA, LRI, MIS, SAL, SDE, SFE, SJU, SLU, TUC) / BRA(PAR, RGS, SCA) / PRY(CAA, CEN, PAI, PHA) / URY(ART, COL, MON, PAY)
Ipomoea carnea ssp. fistulosa	ARG(CHA, COR, COS, ERI, FOR, SAL, SDE, SFE, TUC) / BRA(Fuera del área del proyecto) / PRY(APY, BOQ, CAA, CEN, COA, ÑEE, PHA)
Ipomoea cheirophylla	ARG(CAT, FOR, JUJ, SAL, TUC) / PRY(APY)
Ipomoea chiliantha	ARG(CHA, COS, FOR, SFE) / BRA(Fuera del área del proyecto) / PRY(APY, COA, PHA)
Ipomoea chodatiana	PRY(AMA, CAU, CAN, CEN)
Ipomoea chondrosepala	PRY(CAN)
Ipomoea cordatotriloba var. australis	ARG(BAI, CAT, CHA, COR, COS, FOR, JUJ, SAL, SDE, TUC) / PRY(AMA, CAU, CEN, COA, GUA, PAI)
Ipomoea crinicalyx	ARG(JUJ, SAL) / BRA(Fuera del área del proyecto)
Ipomoea delphinioides	BRA(PAR, RGS, SCA)
Ipomoea descolei	ARG(COS, MIS) / BRA(RGS) / PRY(ITA)
Ipomoea dumetorum	ARG(CAT, JUJ, SAL, TUC) / CHL(ANT) / PRY(APY)
Ipomoea estrellensis	PRY(AMA)
Ipomoea fiebrigii	PRY(APA)
Ipomoea fimbriosepala	ARG(BAI, CHA, COS, DFE, MIS) / BRA(PAR, RGS, SCA) / PRY(PHA) / URY(COL, ROC)
Ipomoea grandifolia	ARG(BAI, CHA, COS, ERI, FOR, MIS, SAL, SFE, TUC) / BRA(PAR, RGS, SCA) / PRY(APY, BOQ, CAN, CEN, COA, GUA, ÑEE, PAI, SPE) / URY(ART, CLA, MON, PAY, SOR)
Ipomoea hederifolia	ARG(SAL, TUC) / BRA(Fuera del área del proyecto) / PRY(AMA)
Ipomoea hieronymi	ARG(CAT, COR, JUJ, LRI, SAL, SLU, TUC)
Ipomoea homotrichoidea	PRY(AMA)
Ipomoea imperati	BRA(PAR, RGS, SCA)
Ipomoea indica	ARG(BAI, CAT, CHA, COR, COS, DFE, ERI, FOR, MIS, SFE, TUC) / BRA(PAR, RGS, SCA) / CHL(VAL) / PRY(GUA, ÑEE, PAI) / URY(ART, CAS, COL, MON, PAY, SOR)
Ipomoea indivisa	ARG(BAI, ERI, MIS, SFE) / BRA(PAR, RGS, SCA) / URY(CLA, MON, PAY, ROC, SOR, TAC)
Ipomoea itapuaensis	PRY(CAA, ITA)
Ipomoea jujuyensis	ARG(CAT, JUJ, SAL, TUC)
Ipomoea kunthiana	ARG(COS, MIS) / BRA(RGS) / PRY(APA) / URY(CLA, RIV, TAC)
Ipomoea lanuginosa	ARG(MIS) / BRA(RGS) / PRY(ITA)
Ipomoea lilloana	ARG(SAL, TUC)
Ipomoea lobata	ARG(JUJ)
Ipomoea malpighipila	ARG(COS, MIS) / BRA(RGS) / PRY(APA, AMA, COA)
Ipomoea malvaeoides var. argentea	ARG(COS)
Ipomoea malvaeoides var. lineariloba	ARG(COS, MIS) / PRY(PAI)
Ipomoea malvaeoides var. malvaeoides	ARG(COS) / BRA(RGS) / PRY(CAN, CEN, CON) / URY(ART, RIV)
Ipomoea marginisepala	ARG(CAT, JUJ, SAL, SDE, TUC)
Ipomoea maurandioides var. maurandioides	ARG(COS, ERI, MIS) / BRA(PAR, RGS) / PRY(AMA, COA, PAI, PHA)
Ipomoea maurandioides var. subtomentosa	PRY(AMA, CEN, COA, PAI)
Ipomoea mirabilis	ARG(MIS) / BRA(RGS, SCA)
Ipomoea morongii	PRY(CEN, COA)
Ipomoea nil	ARG(CAT, CHA, COR, COS, ERI, FOR, JUJ, LRI, MIS, SAL, SDE, SFE, SJU, SLU, TUC) / BRA(RGS) / PRY(CEN, COA, PAI, SPE) / URY(SAO)
Ipomoea nitida	ARG(COS, ERI, MIS) / BRA(RGS) / URY(ART, PAY)
Ipomoea oblongifolia	PRY(AMA)
Ipomoea oranensis	ARG(SAL)
Ipomoea padillae	ARG(COS, MIS) / BRA(RGS)
Ipomoea paludosa	ARG(COS, MIS) / PRY(APA, AMA, CAA, CAN, COA, GUA, ITA, PAI, SPE)
Ipomoea pampeana	BRA(RGS)
Ipomoea paraguariensis	PRY(CAU, GUA, PAI)
Ipomoea pes-caprae	BRA(RGS, SCA)
Ipomoea platensis	ARG(BAI, CHA, COS, DFE, ERI, FOR, SAL, SDE, SFE, TUC) / PRY(CEN, SPE) / URY(MON, SJO)
Ipomoea plummerae var. plummerae	ARG(CAT, COR, JUJ, LRI, SAL, SLU, TUC)
Ipomoea plummerae var. cuneifolia	ARG(JUJ, SAL, TUC)
Ipomoea procurrens	BRA(Fuera del área del proyecto) / PRY(AMA)
Ipomoea pubescens	ARG(CAT, JUJ, SAL, TUC)
Ipomoea purpurea	ARG(BAI, CAT, CHA, COR, COS, DFE, ERI, FOR, JUJ, LPA, LRI, MEN, MIS, SAL, SDE, SFE, SJU, SLU, TUC) / BRA(PAR, RGS, SCA) / CHL(VAL, RME) / URY(MON, PAY)
Ipomoea quamoclit	ARG(BAI, MIS, SAL, SFE, TUC) / BRA(PAR, RGS, SCA) / PRY(AMA)
Ipomoea ramboi	BRA(RGS)
Ipomoea ramosissima	ARG(SAL) / BRA(PAR, SCA) / PRY(APY)
Ipomoea riograndensis	BRA(RGS)
Ipomoea rojasii	PRY(AMA, CON)
Ipomoea rubens	ARG(CHA, COS, ERI, MIS) / BRA(PAR) / PRY(CEN)
Ipomoea rubriflora	ARG(CAT, COR, JUJ, LRI, SAL, SDE, SLU, TUC)
Ipomoea saopaulista	ARG(MIS) / BRA(PAR, RGS, SCA)
Ipomoea schulziana	ARG(JUJ, SAL)
Ipomoea setifera	ARG(COS, MIS) / BRA(PAR) / PRY(APA, APY, ITA)
Ipomoea setosa	ARG(JUJ, SAL)
Ipomoea stuckertii	ARG(CAT, COR, SDE, SLU)
Ipomoea subrevoluta	ARG(COS, MIS) / BRA(PAR) / PRY(CEN, GUA, PAI)
Ipomoea subtomentosa f. albiflora	PRY(COA, PAI)
Ipomoea sulina	BRA(RGS, SCA)
Ipomoea syringifolia	ARG(MIS) / BRA(PAR, RGS, SCA) / PRY(CAN, GUA, PAI)
Ipomoea theodori	PRY(CAU)
Ipomoea tiliacea	BRA(PAR, RGS, SCA)
Ipomoea tricolor	ARG(BAI, SAL)
Ipomoea turbinata	ARG(JUJ, SAL)
Ipomoea valenzuelensis	PRY(GUA)
Ipomoea vivianae	ARG(FOR, SAL) / PRY(APY, AMA)
Ipomoea volcanensis	ARG(JUJ, SAL)
Ipomoea wrightii	ARG(COS) / BRA(Fuera del área del proyecto) / PRY(PHA)
Ipomopsis gossypifera	ARG(CAT, JUJ, LRI, MEN, NEU, RNE, SAL, SJU) / CHL(TAR, ANT, ATA)
Iresine diffusa var. diffusa	ARG(BAI, CAT, CHA, COR, COS, DFE, ERI, FOR, JUJ, LRI, MIS, SAL, SDE, SFE, SJU, SLU, TUC) / BRA(RGS, SCA) / PRY(APA, APY, AMA, BOQ, CAU, CAA, CAN, CEN, CON, COA, GUA, ITA, ÑEE, PAI, PHA, SPE) / URY(CAS, COL, LAV, MAL)
Iresine diffusa var. macrophylla	ARG(JUJ, SAL, TUC)
Iris germanica	ARG(COR)
Iris orientalis	ARG(BAI, COS, ERI, LPA)
Iris pseudacorus	ARG(BAI, ERI) / CHL(LLA) / URY(CAS, MON, ROC, SJO, TYT)
Iris unguicularis	ARG(COR)
Irlbachia alata ssp. angustifolia	PRY(CAN)
Isabelia pulchella	BRA(PAR, RGS, SCA)
Isabelia violacea	BRA(PAR, RGS)
Isabelia virginalis	ARG(MIS) / BRA(PAR)
Isabelia x pabstii	BRA(PAR)
Isatis tinctoria	CHL(LBO, MAU, RME)
Ischaemum minus	ARG(BAI, DFE, ERI) / BRA(PAR, RGS, SCA) / URY(MAL, ROC)
Ischnosiphon ovatus 	BRA(PAR, SCA)
Iseia luxurians	ARG(CHA, COS, MIS) / BRA(PAR) / PRY(ÑEE)
Islaya caligophila	CHL(TAR)
Islaya iquiquensis	CHL(TAR, ANT)
Islaya islayensis	CHL(TAR)
Islaya laui	CHL(ANT)
Isochilus linearis	ARG(COS, JUJ, MIS, SAL, TUC) / BRA(PAR, RGS, SCA) / PRY(APA, GUA)
Isoëtes alcalophila	ARG(CAT, TUC)
Isoëtes araucaniana	CHL(ARA)
Isoëtes brasiliensis	BRA(RGS, SCA)
Isoëtes chubutiana	ARG(CHU, NEU, RNE) / CHL(LLA, AIS)
Isoëtes ekmanii	ARG(BAI, COS, MIS)
Isoëtes escondidensis	ARG(TUC)
Isoëtes fusco-marginata	BRA(RGS)
Isoëtes gardneriana	ARG(COS)
Isoëtes hieronymi	ARG(COR, RNE) / CHL(COQ)
Isoëtes itaboensis	PRY(APY)
Isoëtes mourabaptistae	BRA(RGS)
Isoëtes naipiana	BRA(RGS)
Isoëtes panamensis	PRY(APA, CAU)
Isoëtes pedersenii	ARG(COS)
Isoëtes quiririensis	BRA(SCA)
Isoëtes ramboi	BRA(RGS, SCA)
Isoëtes savatieri	ARG(CHU, NEU, RNE, TDF) / CHL(BIO, ARA, LLA, AIS, MAG)
Isoëtes sehnemii	BRA(RGS)
Isoëtes smithii	BRA(RGS, SCA)
Isoëtes spannagellii	BRA(RGS, SCA)
Isoëtes weberi	BRA(RGS) / URY(ROC)
Isolepis aucklandica	ARG(RNE)
Isolepis cernua	ARG(BAI, CHU, COR, ERI, LPA, LRI, MEN, NEU, RNE, SAL, SCR, SFE, SJU, SLU, TDF, TUC) / BRA(RGS, SCA) / CHL(TAR, ANT, COQ, VAL, LBO, MAU, BIO, ARA, LLA, AIS, MAG, RME) / URY(CAS, DUR, MAL, MON, SJO, TAC)
Isolepis nigricans	ARG(LPA, NEU, RNE, SCR) / CHL(COQ, VAL, LBO, MAU, BIO, ARA, LLA, AIS, MAG, RME)
Isolepis ranko	ARG(CHU, RNE) / CHL(BIO, AIS)
Isolepis varians	ARG(BAI, CHU) / CHL(BIO, ARA, LLA)
Isostigma acaule	PRY(CEN, PHA)
Isostigma cordobense	ARG(COR)
Isostigma dissitifolium	ARG(MIS) / PRY(COA, PAI)
Isostigma herzogii	PRY(APY)
Isostigma hoffmannii	ARG(COS) / PRY(APY)
Isostigma molfinianum	ARG(CAT, LRI)
Isostigma peucedanifolium var. crithmifolium	ARG(COS, ERI, MIS) / BRA(RGS) / PRY(ITA, MIE) / URY(ART, PAY, RIV, SAO, TAC)
Isostigma peucedanifolium var. peucedanifolium	ARG(COS, ERI, MIS) / BRA(PAR, RGS) / PRY(ITA, MIE) / URY(ART, SAO)
Isostigma peucedanifolium var. speciosum	ARG(MIS) / BRA(PAR) / PRY(APA, AMA, CAN, COA)
Isostigma simplicifolium var. riedelii	BRA(RGS) / PRY(AMA, CAU, CAN, CON, SPE)
Ivania cremnophila	CHL(ATA)
Ivania juncalensis	CHL(VAL)
Ixora heterodoxa	BRA(PAR)
Ixora venulosa	ARG(MIS) / BRA(PAR, SCA) / PRY(APA, CAA, CAN)
Ixorhea tschudiana	ARG(SAL, TUC)
