Dactylaena pauciflora	ARG(JUJ, SAL, SDE, TUC)
Dactylis glomerata	ARG(BAI, CHU, COR, ERI, LPA, MEN, NEU, RNE, SLU, SCR, SFE, TDF, TUC) / BRA(RGS) / CHL(VAL, LBO, MAU, BIO, ARA, LLA, AIS, MAG, RME, JFE) / URY(MON)
Dactyloctenium aegyptium	ARG(BAI, CAT, CHA, COR, FOR, JUJ, LPA, LRI, MEN, SAL, SJU, SLU, SFE, SDE, TUC) / BRA(Fuera del área del proyecto) / PRY(PHA) / URY(MON)
Dahlia pinnata	ARG(SAL)
Dahlstedtia pinnata	ARG(MIS) / BRA(PAR, RGS, SCA)
Dalbergia brasiliensis	BRA(PAR, SCA)
Dalbergia ecastaphyllum	BRA(PAR, SCA)
Dalbergia ernest-ulei	BRA(SCA)
Dalbergia frutescens	ARG(COS, MIS) / BRA(PAR, RGS, SCA) / PRY(APA, AMA, CAA, CAN, COA, GUA, PAI, SPE) / URY(ART)
Dalbergia lateriflora	BRA(PAR, SCA)
Dalbergia miscolobium	BRA(PAR)
Dalea azurea	CHL(ANT)
Dalea boliviana	ARG(CAT, JUJ, SAL, TUC)
Dalea elegans var. elegans	ARG(COR, JUJ, SAL, SLU)
Dalea elegans var. onobrychioides	ARG(JUJ, SAL, TUC)
Dalea leporina	ARG(JUJ, SAL, TUC)
Dalea moquehuana	CHL(TAR)
Dalea pennellii var. chilensis	CHL(TAR)
Dalechampia anomala	PRY(AMA)
Dalechampia bangii	PRY(AMA, CON)
Dalechampia clausseniana	BRA(PAR, SCA)
Dalechampia ficifolia	BRA(SCA)
Dalechampia glechomifolia	ARG(MIS) / BRA(PAR, RGS, SCA)
Dalechampia guaranitica	PRY(SPE)
Dalechampia hassleriana	PRY(SPE)
Dalechampia leandrii	BRA(SCA)
Dalechampia linearis	BRA(Fuera del área del proyecto) / PRY(CAN)
Dalechampia meridionalis	BRA(Fuera del área del proyecto) / URY(Desconocida)
Dalechampia micromeria	ARG(COS, MIS) / BRA(PAR, RGS, SCA) / PRY(COA)
Dalechampia pentaphylla	BRA(PAR)
Dalechampia reitzkleinii	BRA(SCA)
Dalechampia riparia	BRA(SCA)
Dalechampia scandens	ARG(FOR, JUJ, MIS, SAL) / BRA(PAR) / PRY(CEN, COA, PHA)
Dalechampia serrula	PRY(CAN)
Dalechampia stenosepala	ARG(COS, ERI, MIS) / BRA(PAR, RGS) / PRY(APA, CAU, CAA, CAN, CON, COA, GUA, PAI, SPE)
Dalechampia stipulacea	ARG(COS, MIS) / BRA(PAR, RGS, SCA) / PRY(APA, CAA, CAN, COA, GUA, PAI, SPE)
Dalechampia sylvestris	BRA(Fuera del área del proyecto) / PRY(AMA)
Dalechampia triphylla	BRA(RGS) / PRY(PAI)
Dalechampia ulmifolia	ARG(COS, MIS) / BRA(RGS) / PRY(CAN, COA)
Dalechampia weddelliana	BRA(Fuera del área del proyecto) / PRY(AMA, SPE)
Danaea elliptica	BRA(SCA)
Danaea moritziana	BRA(SCA) / PRY(Desconocida)
Danaea nodosa	BRA(SCA) / PRY(APY, APA, AMA, CAU, CAN, CEN, COA, GUA)
Danthonia annableae	ARG(JUJ, SAL)
Danthonia araucana	CHL(MAU, BIO, ARA, LLA)
Danthonia californica var. americana	CHL(MAU, BIO, ARA)
Danthonia chilensis var. chilensis	ARG(NEU) / CHL(MAU, BIO, ARA, LLA, JFE)
Danthonia chilensis var. glabriflora	ARG(NEU) / CHL(BIO, ARA, LLA)
Danthonia chilensis var. aureofulva	CHL(VAL, LBO, MAU, BIO, ARA, LLA)
Danthonia cirrata	ARG(BAI, COR, RNE, SLU) / BRA(RGS, SCA) / URY(ART, CAS, CLA, COL, FLO, FLA, LAV, MAL, MON, PAY, RIV, ROC, SJO, SOR, TAC, TYT)
Danthonia decumbens	CHL(LLA)
Danthonia malacantha	CHL(COQ, VAL, LBO, MAU, BIO, ARA, LLA, JFE)
Danthonia melanathera	ARG(COR, SLU)
Danthonia montevidensis	ARG(BAI, COR) / BRA(RGS, SCA) / URY(CAS, CLA, COL, DUR, FLO, FLA, LAV, MAL, MON, PAY, RNO, RIV, ROC, SAO, SJO, SOR, TAC, TYT)
Danthonia rhizomata	BRA(RGS) / URY(CAS, LAV, MAL, ROC, TYT)
Danthonia rugoloana	ARG(SAL)
Danthonia secundiflora ssp. secundiflora	ARG(SAL) / BRA(PAR, RGS, SCA) / URY(CAS, CLA, LAV, MAL, MON, ROC, SJO, TYT)
Danthonia secundiflora ssp. charruana	BRA(RGS) / URY(FLO, RIV, ROC)
Danthonia secundiflora ssp. mattheii	BRA(PAR)
Daphnopsis brasiliensis	BRA(PAR)
Daphnopsis coriacea	BRA(PAR, SCA)
Daphnopsis fasciculata	BRA(PAR, RGS, SCA)
Daphnopsis pseudosalix	BRA(SCA)
Daphnopsis racemosa	ARG(BAI, COS, ERI, MIS) / BRA(PAR, RGS, SCA) / PRY(CAU, CAA, CAN, GUA, ITA, MIE, PAI) / URY(CLA, COL, DUR, FLA, LAV, MAL, MON, PAY, ROC, TAC, TYT)
Daphnopsis sellowiana	BRA(PAR, RGS)
Dasyphyllum armatum	ARG(JUJ, SAL)
Dasyphyllum brasiliense var. brasiliense	ARG(COS, MIS) / BRA(PAR, RGS, SCA) / PRY(APA, AMA, CAN, GUA, ITA, MIE, PAI, SPE)
Dasyphyllum brasiliense var. divaricatum	ARG(JUJ, SAL)
Dasyphyllum diacanthoides	ARG(CHU, NEU, RNE) / CHL(MAU, BIO, ARA, LLA)
Dasyphyllum excelsum	CHL(VAL, RME)
Dasyphyllum flagellare	BRA(PAR)
Dasyphyllum floribundum	BRA(Fuera del área del proyecto) / PRY(APY, AMA)
Dasyphyllum inerme	ARG(JUJ, SAL)
Dasyphyllum latifolium	BRA(Fuera del área del proyecto) / PRY(AMA)
Dasyphyllum maria-lianae	PRY(GUA)
Dasyphyllum spinescens	BRA(PAR, RGS, SCA)
Dasyphyllum synacanthum	BRA(RGS, SCA)
Dasyphyllum tomentosum var. tomentosum	ARG(MIS) / BRA(RGS, SCA)
Dasyphyllum tomentosum var. multiflorum	ARG(MIS) / BRA(PAR, RGS, SCA)
Dasyphyllum vagans	BRA(PAR)
Dasyphyllum varians	BRA(Fuera del área del proyecto) / PRY(APY, AMA, CAU, CEN, CON, COA, PAI, SPE)
Datura ferox	ARG(BAI, CAT, CHA, CHU, COR, COS, DFE, ERI, FOR, JUJ, LPA, LRI, MIS, NEU, SAL, SLU, SFE, SDE, TUC) / CHL(ATA, COQ, LBO, MAU, BIO, LLA, RME) / PRY(ÑEE) / URY(CAS, COL, FLA, MON, SJO)
Datura inoxia	ARG(BAI, CAT, CHA, CHU, COR, COS, ERI, FOR, JUJ, LRI, MEN, MIS, RNE, SAL, SJU, SLU, SDE, TUC) / CHL(ANT) / PRY(APY, CON, PAI) / URY(ART)
Datura stramonium	ARG(BAI, COS, NEU, SAL, SJU) / BRA(SCA) / CHL(TAR, ANT, COQ, VAL, LBO, MAU, BIO, ARA, RME, JFE)
Daucus carota	ARG(BAI, COS, NEU, RNE, SLU) / BRA(RGS, SCA) / CHL(VAL, LBO, MAU, BIO, ARA, LLA, RME, IPA) / URY(MON)
Daucus montanus	ARG(CHU, JUJ, LPA, NEU, RNE, SAL, TDF) / CHL(ANT, COQ, VAL, MAU, LLA, AIS, MAG, JFE)
Daucus pusillus	ARG(BAI, CHU, COR, COS, ERI, LPA, MIS, NEU, RNE, SDE, SFE, SLU) / BRA(PAR, RGS, SCA) / CHL(COQ, VAL, LBO, MAU, BIO, LLA, AIS, RME) / URY(ART, CAS, CLA, COL, FLA, LAV, MAL, MON, SAO, SJO, SOR, TAC)
Davilla elliptica	BRA(Fuera del área del proyecto) / PRY(CAN)
Davilla grandiflora	BRA(Fuera del área del proyecto) / PRY(AMA)
Davilla rugosa var. rugosa	BRA(PAR, SCA) / PRY(AMA, CAN)
Declieuxia cordigera var. angustifolia	BRA(PAR, SCA)
Declieuxia dusenii	BRA(PAR, SCA)
Declieuxia fruticosa	BRA(PAR) / PRY(AMA, CON)
Delairea odorata	ARG(BAI, COR, LPA) / CHL(VAL, BIO, LLA, JFE) / URY(CAS, MON)
Delilia biflora	ARG(JUJ, SAL) / BRA(Fuera del área del proyecto)
Delpinophytum patagonicum	ARG(CHU, SCR)
Dendropanax affinis	ARG(COS, MIS) / BRA(Fuera del área del proyecto) / PRY(AMA, COA, SPE)
Dendropanax cuneatus	ARG(COS, MIS) / BRA(PAR, RGS) / PRY(APA, AMA, CAU, CAN, CEN, COA, GUA, PAI, SPE)
Dendropanax monogynum	BRA(PAR, SCA)
Dendrophorbium bomanii	ARG(CAT, JUJ, SAL, TUC)
Dendrophorbium catharinense	ARG(MIS) / BRA(SCA)
Dendrophorbium peregrinum	ARG(CAT, JUJ, SAL, TUC)
Dendrophorbium pluricephalum	ARG(MIS) / BRA(PAR, RGS, SCA) / PRY(GUA, PAI)
Dendrophorbium subnemoralis	BRA(PAR, RGS, SCA)
Dendroseris berteroana	CHL(JFE)
Dendroseris gigantea	CHL(JFE)
Dendroseris litoralis	CHL(JFE)
Dendroseris macrantha	CHL(JFE)
Dendroseris macrophylla	CHL(JFE)
Dendroseris marginata	CHL(JFE)
Dendroseris micrantha	CHL(JFE)
Dendroseris neriifolia	CHL(JFE)
Dendroseris pinnata	CHL(JFE)
Dendroseris pruinata	CHL(JFE)
Dendroseris regia	CHL(JFE)
Denmoza rhodacantha	ARG(CAT, LRI, MEN, SAL, SJU, TUC)
Dennstaedtia cicutaria	ARG(JUJ, MIS, SAL, TUC) / BRA(PAR, RGS, SCA) / PRY(APA, CAA, COA)
Dennstaedtia dissecta	ARG(MIS) / BRA(PAR)
Dennstaedtia glauca	ARG(CAT, JUJ, LRI, SAL, TUC) / CHL(COQ, VAL, LBO, MAU, RME)
Dennstaedtia globulifera	ARG(CHA, COR, JUJ, MIS, SAL, TUC) / BRA(PAR, RGS, SCA) / PRY(APA, CAA, CAN, COA) / URY(CLA, PAY, RIV, TAC)
Dennstaedtia obtusifolia	BRA(PAR, RGS, SCA) / PRY(CEN, COA, MIE, PAI)
Deparia petersenii	ARG(MIS) / BRA(PAR, RGS) / PRY(CAA)
Deppea blumenaviensis	ARG(MIS) / BRA(PAR, RGS, SCA)
Deschampsia airiformis	ARG(CHU, NEU, RNE) / CHL(ARA, LLA, RME)
Deschampsia antarctica	ARG(CHU, MEN, RNE, SCR, TDF) / CHL(MAU, ARA, MAG, RME)
Deschampsia berteroana	ARG(MEN) / CHL(COQ, VAL, LBO, MAU, BIO, LLA, MAG, RME)
Deschampsia caespitosa var. caespitosa	ARG(CHU, MEN, NEU, RNE, SJU, SCR, TDF) / BRA(PAR, RGS, SCA) / CHL(COQ, MAU, ARA, AIS, MAG, RME)
Deschampsia caespitosa var. pulchra	ARG(CHU, MEN, NEU, SJU) / CHL(LBO, BIO)
Deschampsia cordillerarum	ARG(MEN) / CHL(COQ, VAL, RME)
Deschampsia elongata	ARG(CHU, NEU, TDF) / CHL(COQ, ARA, AIS, MAG, RME)
Deschampsia kingii	ARG(SCR, TDF) / CHL(ARA, AIS, MAG)
Deschampsia laxa	ARG(CHU) / CHL(LLA, AIS, MAG)
Deschampsia looseriana var. looseriana	CHL(COQ, VAL, LBO, MAU, BIO, ARA, RME)
Deschampsia looseriana var. triandra	CHL(RME)
Deschampsia mendocina	ARG(MEN)
Deschampsia micrantha	CHL(COQ)
Deschampsia monandra	CHL(COQ, LBO, RME)
Deschampsia parvula	ARG(SCR, TDF) / CHL(AIS, MAG)
Deschampsia patula	ARG(CHU, SCR, TDF) / CHL(MAG, RME)
Deschampsia setacea	CHL(COQ, RME)
Deschampsia venustula	ARG(MEN, NEU) / CHL(MAU, MAG, RME)
Descurainia antarctica	ARG(CHU, NEU, RNE, SCR, TDF) / CHL(MAG)
Descurainia depressa	ARG(CAT, JUJ, LRI, MEN, SAL, SJU, TUC) / CHL(TAR, ANT)
Descurainia erodiifolia	ARG(BAI, CAT, CHA, CHU, COR, ERI, LPA, LRI, MEN, MIS, NEU, RNE, SAL, SJU, SLU, SFE, SDE, TUC) / CHL(VAL, MAU, RME) / URY(SAO)
Descurainia myriophylla	ARG(CAT, JUJ, LRI, SAL, TUC) / CHL(TAR, ANT)
Descurainia nuttallii	ARG(CHU, JUJ, MEN, NEU, RNE, SJU, SCR) / CHL(ANT, ATA, COQ, VAL, MAU, LLA, MAG, RME)
Descurainia pimpinellifolia	ARG(CHU, JUJ, LRI, MEN, NEU, RNE, SJU, SCR, TUC) / CHL(ATA, COQ, VAL, RME)
Descurainia pinnata	ARG(MEN, NEU, RNE)
Descurainia sophia	ARG(CHU, NEU, RNE, SCR, TDF) / CHL(MAG, RME)
Descurainia stricta	ARG(CAT, JUJ, LRI, SAL, SJU, TUC) / CHL(TAR, ANT, ATA, COQ)
Desfontainia fulgens	ARG(NEU, RNE, SCR, TDF) / CHL(MAU, BIO, ARA, LLA, AIS, MAG)
Desmanthus acuminatus	ARG(BAI, COR, COS, ERI, FOR, JUJ, LPA, SAL, SDE, SFE) / PRY(MIE) / URY(ART, CAS, CLA, COL, DUR, FLA, MAL, MON, PAY, RNO, RIV, ROC, SAO, SOR, TYT)
Desmanthus hexapetalus	ARG(MIS) / PRY(CAU)
Desmanthus paspalaceus	ARG(CHA, COS, ERI, FOR, JUJ, MIS, SAL, SDE, SFE, TUC) / BRA(RGS, SCA) / PRY(AMA, CAN, CEN, COA, GUA, PAI, PHA, SPE) / URY(COL, FLA)
Desmanthus pernambucanus	BRA(Fuera del área del proyecto) / URY(MON)
Desmanthus tatuhyensis var. tatuhyensis	ARG(BAI, COS, ERI, MIS) / BRA(PAR, RGS, SCA) / PRY(COA, MIE, PAI) / URY(LAV, MAL, MON, RIV, SJO)
Desmanthus tatuhyensis var. brevipes	ARG(CHA, COR, COS, FOR, JUJ, SDE, SFE, TUC) / PRY(PHA)
Desmanthus virgatus	ARG(BAI, CHA, COR, COS, ERI, FOR, JUJ, LPA, MIS, SAL, SFE, SDE, TUC) / BRA(RGS, SCA) / CHL(TAR) / PRY(APY, BOQ, CHO, GUA, ÑEE, SPE) / URY(ART, CAS, CLA, DUR, FLA, LAV, MAL, MON, PAY, RNO, RIV, ROC, SAO, SJO, SOR, TAC, TYT)
Desmaria mutabilis	CHL(MAU, BIO, ARA, LLA)
Desmodium adscendens	ARG(MIS) / BRA(PAR, RGS, SCA)
Desmodium affine	ARG(BAI, CAT, CHA, COS, ERI, FOR, JUJ, MIS, SAL, SFE, TUC) / BRA(PAR, RGS, SCA) / PRY(APA, AMA, CEN, GUA, PAI) / URY(ART, CAS, PAY, RIV, TAC, TYT)
Desmodium album	ARG(FOR) / BRA(PAR, SCA) / PRY(SPE)
Desmodium arechavaletae	ARG(COS, MIS) / BRA(PAR, RGS) / PRY(APA, APY, AMA, GUA, SPE) / URY(CLA, PAY, RIV, TAC)
Desmodium barbatum	ARG(CHA, COS, MIS) / BRA(PAR, RGS, SCA) / PRY(CAA, CAN, CEN, COA, GUA, ITA)
Desmodium bridgesii	ARG(JUJ, SAL)
Desmodium burkartii	ARG(COS)
Desmodium cajanifolium	BRA(PAR)
Desmodium craspediferum	BRA(PAR, RGS)
Desmodium cuneatum	ARG(CHA, COR, COS, ERI, FOR, JUJ, MIS, SDE, SFE, TUC) / BRA(PAR, RGS, SCA) / PRY(APY, CEN, GUA, MIE, ÑEE, PAI, PHA) / URY(MON, PAY, SAO)
Desmodium distortum	ARG(FOR) / BRA(Fuera del área del proyecto) / PRY(CAN, CEN)
Desmodium glabrum	ARG(JUJ, SAL) / BRA(Fuera del área del proyecto) / PRY(APY)
Desmodium guaraniticum	BRA(PAR) / PRY(CAN)
Desmodium hassleri	ARG(COS, MIS) / BRA(PAR, RGS) / PRY(AMA, CAN, MIE, PAI, SPE)
Desmodium incanum	ARG(CAT, CHA, COS, ERI, FOR, JUJ, MIS, SAL, SFE, TUC) / BRA(PAR, RGS, SCA) / PRY(CEN, ITA, MIE, ÑEE, PAI) / URY(ART, CLA, COL, MON, PAY, RIV, SAO, TAC, TYT)
Desmodium intermedium	ARG(CHA, FOR)
Desmodium leiocarpum	ARG(MIS) / BRA(PAR, RGS, SCA) / PRY(APA, AMA)
Desmodium membranifolium	BRA(Fuera del área del proyecto) / PRY(CON)
Desmodium microcarpum	ARG(CHA, COS, FOR, MIS, SFE, TUC) / BRA(PAR) / PRY(AMA, COA, SPE) / URY(COL)
Desmodium pachyrrhizum	ARG(CHA, COS, FOR, MIS, SFE, TUC) / BRA(PAR, RGS, SCA) / PRY(APY, CAA, CAN, SPE) / URY(ART, MON, RIV, TAC)
Desmodium platycarpum	BRA(Fuera del área del proyecto)
Desmodium polygaloides	ARG(CHA, COS, ERI, FOR, MIS) / BRA(PAR, RGS, SCA) / PRY(COA, MIE) / URY(RIV, TAC)
Desmodium procumbens	ARG(CAT, JUJ, SAL, SJU, SDE, TUC) / BRA(PAR)
Desmodium riedelii	ARG(COS) / BRA(Fuera del área del proyecto)
Desmodium sclerophyllum	BRA(Fuera del área del proyecto)
Desmodium subsecundum	BRA(PAR, RGS, SCA)
Desmodium subsericeum	ARG(CAT, JUJ, SAL, TUC) / BRA(PAR, RGS, SCA) / CHL(TAR)
Desmodium tortuosum	ARG(COR, COS, JUJ, MIS, SAL, TUC) / BRA(PAR, RGS, SCA) / PRY(AMA, CAU, CON, ITA)
Desmodium triarticulatum	BRA(RGS, SCA)
Desmodium triflorum	BRA(SCA)
Desmodium uncinatum	ARG(BAI, CHA, COR, COS, ERI, FOR, JUJ, MIS, SAL, SFE, TUC) / BRA(PAR, RGS, SCA) / PRY(APA, CAA, GUA) / URY(CLA, COL, LAV, RNO, RIV, ROC, SAO, SJO, SOR, TAC, TYT)
Desmodium venosum	ARG(CHA, FOR, MIS, SFE) / BRA(PAR, RGS, SCA) / URY(RIV)
Desmoscelis villosa	PRY(AMA)
Deuterocohnia brevifolia	ARG(CAT, JUJ, LRI, SAL, TUC)
Deuterocohnia chrysantha	CHL(ANT, ATA)
Deuterocohnia digitata	ARG(SAL)
Deuterocohnia haumanii	ARG(CAT, COR, LRI, SAL, SJU, TUC)
Deuterocohnia longipetala	ARG(CAT, COR, JUJ, LPA, LRI, MEN, SAL, SDE, SJU, SLU, TUC)
Deuterocohnia lorentziana	ARG(CAT, JUJ, LRI, SAL)
Deuterocohnia meziana	BRA(Fuera del área del proyecto) / PRY(APY, AMA, BOQ, CON)
Deuterocohnia meziana ssp. vogtii	PRY(APY, PHA)
Deuterocohnia meziana ssp. vallegrandensis	ARG(JUJ)
Deuterocohnia recurvipetala	ARG(Desconocida)
Deuterocohnia schreiteri	ARG(CAT, COR, LRI, MEN, SAL, SJU, SLU, TUC)
Deuterocohnia strobilifera var. inermis	ARG(SAL)
Deyeuxia alba ssp. alba	ARG(BAI, COR, COS) / BRA(RGS, SCA) / PRY(SPE) / URY(CAS, CLA, DUR, FLO, FLA, LAV, MAL, MON, RNO, RIV, ROC, SAO, SJO, SOR, TAC, TYT)
Deyeuxia alba ssp. tricholemma	ARG(ERI) / BRA(RGS) / URY(MAL, PAY, SOR)
Deyeuxia alba ssp. breviaristata	ARG(BAI) / BRA(RGS) / URY(MAL)
Deyeuxia breviaristata	ARG(CAT, JUJ, LRI, SAL, TUC) / CHL(TAR, ANT, ATA)
Deyeuxia brevifolia var. brevifolia	ARG(CAT, JUJ, LRI, SAL, TUC)
Deyeuxia brevifolia var. expansa	CHL(TAR)
Deyeuxia cabrerae var. cabrerae	ARG(JUJ, SAL) / CHL(ANT)
Deyeuxia cabrerae var. maxima	ARG(JUJ)
Deyeuxia cabrerae var. trichopoda	ARG(CAT, JUJ, LRI, SAL) / CHL(ANT)
Deyeuxia cabrerae var. aristulata	ARG(JUJ, SAL) / CHL(ANT)
Deyeuxia calderillensis	ARG(JUJ, TUC)
Deyeuxia chrysantha var. chrysantha	ARG(JUJ) / CHL(TAR, ANT)
Deyeuxia chrysantha var. phalaroides	ARG(JUJ, SAL) / CHL(TAR, ANT)
Deyeuxia chrysophylla	ARG(CAT, JUJ, LRI, SAL, TUC) / CHL(ANT, ATA)
Deyeuxia chrysostachya	ARG(JUJ, MEN, SAL, SJU) / CHL(ANT, COQ, VAL, RME)
Deyeuxia colorata	ARG(CAT, COR, JUJ, LRI, SAL, TUC)
Deyeuxia crispa	ARG(CAT, JUJ, LRI, SAL) / CHL(TAR, ANT)
Deyeuxia cryptolopha	ARG(JUJ, SAL)
Deyeuxia curta	ARG(SAL, TUC)
Deyeuxia curvula	ARG(CAT, JUJ, LRI, SAL, SJU, TUC) / CHL(TAR, ANT)
Deyeuxia deserticola var. breviaristata	ARG(CAT, JUJ, LRI, SJU) / CHL(TAR, ANT)
Deyeuxia deserticola var. deserticola	ARG(CAT, JUJ, LRI, SAL, SJU, TUC) / CHL(TAR, ANT)
Deyeuxia diemii	ARG(NEU) / CHL(MAU)
Deyeuxia eminens var. eminens	ARG(CAT, COR, JUJ, LRI, MEN, SAL, SJU, TUC) / CHL(TAR, ANT, ATA, COQ)
Deyeuxia eminens var. fulva	ARG(CAT, COR, JUJ, LRI, MEN, SAL, SJU, TUC) / CHL(ANT, ATA, COQ, VAL)
Deyeuxia eminens var. discreta	CHL(TAR, ANT)
Deyeuxia eminens var. inclusa	ARG(JUJ, LRI, SAL, SJU)
Deyeuxia erythrostachya var. erythrostachya	ARG(CHU, MEN, NEU, RNE, SCR, TDF) / CHL(COQ, VAL, MAU, BIO, LLA, AIS, MAG, RME)
Deyeuxia erythrostachya var. neuquenensis	ARG(MEN, NEU, RNE) / CHL(LBO, MAU, BIO, LLA, MAG, RME)
Deyeuxia fiebrigii	ARG(JUJ, TUC)
Deyeuxia filifolia	ARG(CAT, JUJ, SAL, TUC)
Deyeuxia hackelii	ARG(CAT, JUJ, LRI, SAL, TUC)
Deyeuxia heterophylla	ARG(JUJ, LRI, SAL) / CHL(TAR)
Deyeuxia hieronymi	ARG(COR, JUJ, LRI, SAL, SLU, TUC)
Deyeuxia lagurus	ARG(CAT, JUJ, SAL, TUC)
Deyeuxia malamalensis	ARG(CAT, JUJ, SAL, TUC)
Deyeuxia minima	ARG(JUJ, SAL)
Deyeuxia orbignyana	ARG(JUJ)
Deyeuxia patagonica	ARG(CHU) / CHL(ARA)
Deyeuxia poaeoides	ARG(CHU, RNE, SCR, TDF) / CHL(MAG)
Deyeuxia polygama	ARG(CAT, JUJ, SAL, TUC)
Deyeuxia recta	ARG(JUJ)
Deyeuxia reitzii	BRA(SCA)
Deyeuxia rigescens	ARG(CAT, JUJ, LRI, SAL, SJU, TUC) / CHL(TAR, ATA)
Deyeuxia rigida	ARG(JUJ, SAL, SCR, TDF) / CHL(MAG)
Deyeuxia rupestris var. rupestris	ARG(ERI) / BRA(PAR, RGS, SCA) / URY(CAS, MON, RIV, ROC, TAC, TYT)
Deyeuxia rupestris f. pilosa	BRA(PAR, RGS, SCA)
Deyeuxia rupestris var. minor	BRA(RGS)
Deyeuxia sclerantha	ARG(CAT, JUJ, SAL, TUC)
Deyeuxia setiflora	ARG(JUJ, SAL)
Deyeuxia spicigera var. cephalotes	ARG(LRI)
Deyeuxia spicigera var. spicigera	ARG(CAT, JUJ, LRI, SAL, TUC)
Deyeuxia suka	ARG(SCR, TDF) / CHL(LLA, MAG)
Deyeuxia tarmensis var. macrochaeta	ARG(JUJ, SAL)
Deyeuxia trichodonta var. trichodonta	ARG(JUJ, LRI, SAL)
Deyeuxia trichodonta var. hirsuta	ARG(SAL)
Deyeuxia velutina var. nardifolia	ARG(CAT, JUJ, LRI, SAL, TUC) / CHL(TAR, ANT, ATA)
Deyeuxia velutina var. velutina	ARG(CAT, LRI, MEN, NEU, RNE, SJU, TUC) / CHL(TAR, ANT, ATA, COQ, LLA, RME)
Deyeuxia vicunarum	ARG(CAT, JUJ, SAL, TUC) / CHL(TAR)
Deyeuxia violacea var. violacea	ARG(JUJ, SAL)
Deyeuxia violacea var. puberula	ARG(JUJ, SAL, TUC)
Deyeuxia viridiflavescens var. montevidensis	ARG(BAI, CAT, CHA, COR, COS, DFE, ERI, FOR, JUJ, LPA, MEN, MIS, SAL, SLU, SFE, SDE, TUC) / BRA(PAR, RGS, SCA) / CHL(BIO) / PRY(APA, APY, BOQ, CEN, CON, GUA, ITA, MIE, PAI, PHA) / URY(ART, CAS, CLA, COL, DUR, FLO, FLA, LAV, MAL, MON, RNO, RIV, ROC, SAO, SJO, SOR, TAC, TYT)
Deyeuxia viridiflavescens var. viridiflavescens	ARG(BAI, COR, COS, ERI, FOR, JUJ, LRI, MIS, SAL, SFE, TUC) / BRA(PAR, RGS, SCA) / CHL(BIO) / PRY(APA, AMA, CAU, CAN, CEN, CON, MIE, PAI) / URY(COL, FLO, FLA, MAL, MON, PAY, ROC, TAC)
Deyeuxia viridis	ARG(CHU, NEU, RNE) / CHL(BIO, ARA, LLA, MAG)
Dianthus armeria	ARG(CHU) / CHL(ARA)
Dianthus deltoides	ARG(NEU, RNE)
Diastatea micrantha	ARG(JUJ)
Diatenopteryx sorbifolia	ARG(COS, JUJ, MIS, SAL) / BRA(PAR, RGS, SCA) / PRY(APA, AMA, CAA, CAN, CEN, COA, GUA, ITA, PAI, SPE)
Dicella bracteosa	BRA(PAR, RGS, SCA)
Dicella nucifera	ARG(COS, MIS) / BRA(PAR, RGS, SCA) / PRY(APA, CAU, CAA, CEN, COA, GUA, PAI, SPE)
Dichaea anchorifera	BRA(PAR, SCA)
Dichaea australis	BRA(PAR, SCA)
Dichaea brevicaulis	BRA(PAR)
Dichaea bryophyla	BRA(PAR)
Dichaea cogniauxiana	BRA(PAR, SCA)
Dichaea graminioides	BRA(PAR)
Dichaea pendula	BRA(PAR, RGS, SCA)
Dichaea trulla	BRA(PAR)
Dichanthelium hebotes	BRA(PAR, RGS, SCA)
Dichanthelium sabulorum var. sabulorum	ARG(BAI, CHA, COS, ERI, MIS) / BRA(PAR, RGS, SCA) / CHL(ARA) / PRY(COA, GUA, PAI) / URY(CAS, CLA, COL, LAV, MAL, MON, PAY, RNO, RIV, ROC, SAO, SJO, TAC)
Dichanthelium sabulorum var. polycladum	ARG(BAI, COR, COS, DFE, ERI, FOR, JUJ, MIS, SAL) / BRA(PAR, RGS, SCA) / CHL(MAU, BIO) / PRY(CAU, CAA, GUA, ITA, PAI, SPE) / URY(CLA, FLO, FLA, LAV, MAL, MON, PAY, RNO, RIV, ROC, SAO, SJO, SOR, TAC, TYT)
Dichanthelium sabulorum var. cordatum	ARG(MIS) / BRA(PAR, RGS, SCA)
Dichanthelium sciurotoides	BRA(PAR, SCA)
Dichanthelium stigmosum	BRA(PAR, SCA)
Dichanthelium superatum	BRA(PAR, RGS, SCA)
Dichanthelium surrectum	BRA(PAR, RGS, SCA) / PRY(CAU)
Dichanthium annulatum	ARG(SFE)
Dichanthium aristatum	ARG(CHA, COS, FOR) / PRY(PHA)
Dichondra argentea	ARG(JUJ, SAL, SLU)
Dichondra macrocalyx	ARG(CHA, COR, COS, ERI, MIS, TUC) / BRA(PAR, SCA)
Dichondra microcalyx	ARG(BAI, CAT, CHA, COR, COS, DFE, ERI, FOR, JUJ, MIS, RNE, SAL, SJU, SDE, TUC) / BRA(PAR, RGS, SCA) / CHL(COQ, ARA) / PRY(COA, GUA, ÑEE) / URY(CLA, DUR, FLA, MON, ROC)
Dichondra sericea var. sericea	ARG(BAI, CHA, COR, COS, FOR, MIS, SFE, TUC) / BRA(RGS) / CHL(ANT, ATA, COQ, VAL, LBO, MAU, BIO, ARA, LLA, RME, JFE) / PRY(CEN, COA, PAI) / URY(CLA, LAV, MAL, MON, ROC, SOR)
Dichondra sericea var. holosericea	ARG(BAI, CAT, CHU, COR, ERI, LPA, LRI, MEN, RNE, SDE, SLU) / CHL(COQ, VAL, MAU, BIO, ARA) / URY(ART, FLO, FLA, MAL, MON, SJO, SOR)
Dichondra sericea var. tomentosa	ARG(BAI, COR, COS, ERI) / URY(RIV, SJO, TAC)
Dichorisandra hexandra	ARG(COS, JUJ, MIS, SAL) / BRA(PAR, RGS, SCA) / PRY(APA, AMA, CAU, CEN, COA, GUA, PAI)
Dichorisandra paranaënsis	BRA(PAR)
Dichorisandra pubescens	BRA(PAR, SCA)
Dichorisandra thyrsiflora	BRA(PAR, RGS, SCA)
Dicksonia berteroana	CHL(JFE)
Dicksonia externa	CHL(JFE)
Dicksonia sellowiana	ARG(MIS) / BRA(PAR, RGS, SCA) / URY(CLA, TAC, TYT)
Dicliptera cabrerae	ARG(JUJ)
Dicliptera cochabambensis	ARG(SAL)
Dicliptera jujuyensis	ARG(JUJ, SAL, TUC)
Dicliptera paposana	CHL(ANT)
Dicliptera scutellata	ARG(CAT, COR, JUJ, LRI, SAL, TUC)
Dicliptera squarrosa	ARG(BAI, CAT, CHA, COR, COS, ERI, FOR, JUJ, LRI, MIS, SAL, SDE, SFE, TUC) / BRA(PAR, RGS, SCA) / PRY(APY, AMA, BOQ, CAU, CAA, CEN, CHO, COA, GUA, ITA, MIE, ÑEE, PAI, PHA, SPE) / URY(COL)
Dicranopteris discolor	BRA(RGS)
Dicranopteris flexuosa	ARG(MIS) / BRA(PAR, RGS, SCA) / PRY(AMA, CAU, CAA, CAN)
Dicranopteris nervosa	BRA(PAR, RGS, SCA)
Dictyophragmus punensis	ARG(JUJ)
Dictyophyllaria dietschiana	BRA(SCA)
Dictyostega orobanchoides ssp. orobanchoides	BRA(PAR, SCA)
Dictyostega orobanchoides ssp. parviflora	BRA(SCA)
Didymochlaena truncatula	ARG(COS, MIS) / BRA(PAR, RGS, SCA) / PRY(APA, CAA, CAN, GUA) / URY(TAC)
Didymoglossum hymenoides	ARG(JUJ, MIS, TUC) / BRA(PAR, RGS, SCA) / PRY(CAA) / URY(TAC)
Didymoglossum krausii	ARG(MIS, SAL) / BRA(PAR, RGS, SCA) / PRY(PAI)
Didymoglossum reptans	ARG(JUJ, MIS, TUC) / BRA(PAR, RGS, SCA)
Dieffenbachia aglaonematifolia	ARG(COS, MIS) / BRA(PAR) / PRY(COA, GUA)
Dielsiochloa floribunda	ARG(JUJ, LRI) / CHL(TAR, ANT)
Digitalis purpurea	ARG(COR, JUJ, NEU, RNE, TDF) / BRA(SCA) / CHL(BIO, ARA, LLA, AIS, MAG) / URY(ROC)
Digitaria aequiglumis var. aequiglumis	ARG(BAI, CAT, CHA, COR, COS, ERI, FOR, JUJ, SAL, SLU, SFE, TUC) / BRA(PAR, RGS, SCA) / CHL(MAU, BIO, ARA) / PRY(APA, CEN, ITA, PHA) / URY(ART, CAS, CLA, COL, FLA, MAL, MON, RIV, SJO, SOR, TAC, TYT)
Digitaria aequiglumis var. laetevirens	ARG(BAI, CAT, COR, JUJ, SAL, SFE, TUC) / BRA(RGS) / PRY(PHA) / URY(CAS, CLA, MON, ROC, SJO)
Digitaria balansae	ARG(CHA, COS, MIS, SAL) / BRA(PAR, RGS) / PRY(APA, CAU, CAA, COA, GUA, ITA, MIE, PAI)
Digitaria bicornis	ARG(COS, FOR, JUJ, MEN, MIS, SAL, SFE, TUC) / BRA(PAR, RGS, SCA) / PRY(APY, APA, AMA, CEN, CON, COA, PHA) / URY(MON)
Digitaria bonplandii	BRA(PAR, RGS) / PRY(AMA)
Digitaria californica var. californica	ARG(BAI, CAT, CHA, COR, COS, ERI, FOR, JUJ, LPA, LRI, MEN, RNE, SAL, SJU, SLU, SFE, SDE, TUC) / PRY(APY) / URY(MON, SAO, SOR)
Digitaria californica var. villosissima	ARG(CAT, CHA, COR, FOR, JUJ, LPA, LRI, SAL, SJU, SLU, SDE, TUC) / PRY(APY, BOQ, CHO, COA, NAS)
Digitaria catamarcensis	ARG(CAT)
Digitaria chacoensis	ARG(CHA)
Digitaria ciliaris	ARG(BAI, CAT, CHA, COR, COS, ERI, FOR, JUJ, LPA, LRI, MEN, MIS, SAL, SJU, SLU, SFE, TUC) / BRA(PAR, RGS, SCA) / CHL(TAR) / PRY(APA, APY, AMA, BOQ, CAU, CAN, CEN, CON, COA, GUA, ITA, MIE, PAI, PHA, SPE) / URY(ART, CAS, CLA, COL, DUR, LAV, MAL, MON, PAY, RNO, RIV, SOR, TAC)
Digitaria connivens var. connivens	BRA(PAR, RGS, SCA)
Digitaria connivens var. pilosa	BRA(RGS)
Digitaria corynotricha	BRA(PAR, RGS)
Digitaria cuyabensis	ARG(BAI, CHA, COS, ERI, FOR, SAL, SFE, SDE) / BRA(RGS, SCA) / PRY(APY, AMA, BOQ, CEN, COA, ÑEE, PAI, PHA) / URY(ART, CLA, RIV, SAO)
Digitaria enodis	BRA(SCA) / URY(CAS, CLA, COL, FLA, LAV, MAL, MON, RIV, ROC, SJO, SOR, TAC)
Digitaria eriantha	ARG(BAI, CHA, COS, JUJ, LPA, MIS, SDE) / BRA(PAR, RGS, SCA) / PRY(AMA, CEN, COA, MIE, PAI, PHA)
Digitaria eriostachya	ARG(CHA, COS, ERI, MIS, SFE) / BRA(RGS) / PRY(CAU, CAA, CEN, COA, GUA, MIE, ÑEE, PAI) / URY(ART, RIV, TAC)
Digitaria fiebrigii	PRY(CON, PAI)
Digitaria filiformis	ARG(JUJ, SAL) / BRA(Fuera del área del proyecto) / PRY(APA, AMA)
Digitaria fuscescens	BRA(PAR, SCA) / PRY(AMA, CEN, CON, COA)
Digitaria gerdesii	BRA(PAR, RGS) / PRY(AMA)
Digitaria horizontalis	ARG(COS, FOR, JUJ, MIS, SAL) / BRA(PAR, SCA) / PRY(APY, AMA, CEN, CON, COA, GUA, ITA, MIE, PHA, SPE)
Digitaria insularis	ARG(BAI, CAT, CHA, COR, COS, ERI, FOR, JUJ, LRI, MIS, SAL, SLU, SFE, SDE, TUC) / BRA(PAR, RGS, SCA) / PRY(APY, APA, AMA, CEN, COA, GUA, PAI, PHA, SPE) / URY(ART, RIV, SAO, TAC)
Digitaria ischaemum	BRA(PAR, SCA) / CHL(BIO, LLA)
Digitaria lanuginosa	BRA(RGS)
Digitaria laxa	ARG(CHA, MIS, SFE) / BRA(PAR) / PRY(CEN, CON, ÑEE, PHA)
Digitaria lehmanniana var. dasyantha	ARG(SAL, TUC) / BRA(Fuera del área del proyecto)
Digitaria leiantha	ARG(CHA, COS, MIS) / PRY(AMA, CON, PAI, PHA)
Digitaria longiflora	BRA(PAR, RGS)
Digitaria mattogrossensis	BRA(PAR, RGS) / PRY(AMA, COA, PAI)
Digitaria myriostachya	BRA(SCA)
Digitaria nuda	ARG(FOR, SAL) / BRA(PAR, RGS, SCA) / PRY(APA, CEN, COA, SPE)
Digitaria paraguayensis	ARG(COS) / PRY(COA, PAI)
Digitaria phaeotrix var. adusta	ARG(BAI, CHA, COS, FOR, SFE) / BRA(PAR) / PRY(AMA, CON, COA, ITA, PAI, SPE) / URY(RNO, RIV)
Digitaria phaeotrix var. hackelii	ARG(COS, ERI, FOR) / BRA(RGS, SCA) / URY(FLA, RIV, TAC)
Digitaria phaeotrix var. phaeotrix	ARG(BAI, COS, ERI, SFE) / BRA(PAR, RGS, SCA) / URY(CLA, FLA, LAV, ROC, SOR)
Digitaria phaeotrix var. saltensis	ARG(COS, ERI) / URY(ART, MON, PAY, SAO)
Digitaria purpurea	BRA(PAR, SCA)
Digitaria queenslandica	BRA(PAR) / PRY(APY)
Digitaria sacchariflora	ARG(BAI, CAT, CHA, COR, COS, ERI, FOR, JUJ, LRI, MIS, SAL, SLU, SFE, SDE) / BRA(RGS) / PRY(APA, AMA, CEN, GUA, MIE, SPE) / URY(ART, TAC)
Digitaria sanguinalis	ARG(BAI, CAT, CHA, COR, COS, DFE, ERI, FOR, JUJ, LPA, LRI, MEN, MIS, RNE, SAL, SJU, SLU, SFE, TUC) / BRA(RGS) / CHL(ATA, COQ, VAL, LBO, MAU, BIO, ARA, LLA, RME, JFE) / PRY(APY, APA) / URY(CAS, COL, DUR, FLO, FLA, LAV, MAL, MON, ROC, SJO, SOR)
Digitaria sellowii	BRA(PAR, RGS, SCA)
Digitaria similis	ARG(CHA, COS, FOR, MIS, SAL, SDE, SFE, TUC) / BRA(PAR, RGS, SCA) / PRY(APY, CON, COA, ÑEE)
Digitaria singularis	ARG(MIS) / PRY(COA)
Digitaria swalleniana	ARG(BAI, CAT, CHA, COR, COS, ERI, FOR, JUJ, SAL, SLU, SFE, SDE, TUC) / BRA(PAR, RGS) / PRY(CEN, COA, PHA) / URY(CAS, COL, FLA, PAY, RNO, RIV, SAO, SOR, TAC, TYT)
Digitaria ternata	ARG(CAT, COR, ERI, JUJ, LPA, SAL, SFE, TUC) / BRA(RGS)
Digitaria violascens	ARG(FOR, JUJ, MIS) / BRA(PAR, RGS, SCA) / PRY(COA)
Dilodendron bipinnatum	BRA(Fuera del área del proyecto) / PRY(APY, AMA, CON)
Dimerostemma annuum	BRA(Fuera del área del proyecto) / PRY(APA)
Dimerostemma apense	ARG(JUJ, MIS, SAL) / BRA(Fuera del área del proyecto) / PRY(AMA, COA)
Dimerostemma arnottii	ARG(CHA, COS, ERI, FOR, MIS) / BRA(PAR, RGS, SCA) / PRY(APA, AMA, CAU, CAA, CAN, CEN, CON, COA, ITA, MIE, PAI, SPE) / URY(ART, RNO, RIV)
Dimerostemma aspilioides	ARG(CAT, CHA, COR, FOR, JUJ, MIS, SAL, SLU, SDE, TUC) / BRA(PAR) / PRY(APY, AMA, BOQ, CAU, CAA, CAN, CEN, CON)
Dimerostemma grisebachii	ARG(COS, ERI, FOR) / BRA(PAR, RGS) / PRY(APY, AMA, CAN, CEN, PAI, PHA)
Dimerostemma hieronymi	ARG(COS, ERI)
Dimerostemma myrtifolium	BRA(SCA) / PRY(AMA, CAN)
Dimerostemma pseudosilphioides	BRA(Fuera del área del proyecto) / PRY(APY, CAU, CAA, CEN, CON, COA, GUA, PAI, PHA, SPE)
Dimerostemma reitzii	ARG(MIS) / BRA(PAR, SCA) / PRY(AMA)
Dimerostemma tenuifolium	ARG(JUJ, SAL) / BRA(RGS) / PRY(PHA)
Dimorphandra mollis	BRA(Fuera del área del proyecto) / PRY(AMA)
Dinemagonum gayanum	CHL(ATA, COQ, VAL)
Dinemandra ericoides	CHL(AYP, TAR, ANT, ATA)
Dioclea burkartii	ARG(CHA, COS, SFE) / BRA(PAR) / PRY(APY)
Dioclea violacea	ARG(CHA, COS, MIS) / BRA(PAR, RGS, SCA) / PRY(APY, COA, GUA)
Dioclea virgata	ARG(MIS) / BRA(PAR)
Diodia kuntzei	ARG(COS, ERI) / BRA(Fuera del área del proyecto) / PRY(CEN, CON, COA, MIE, ÑEE, SPE)
Diodia saponariifolia	ARG(MIS) / BRA(PAR, RGS, SCA) / PRY(AMA, COA)
Dioscorea acanthogene	PRY(APY, CON)
Dioscorea acerifolia	CHL(LLA)
Dioscorea altissima	BRA(PAR, SCA)
Dioscorea amaranthoides	ARG(MIS) / BRA(Fuera del área del proyecto) / PRY(APA, CON)
Dioscorea andina	ARG(NEU) / CHL(MAU, BIO, ARA)
Dioscorea antucoana	CHL(BIO)
Dioscorea araucana	CHL(BIO, ARA)
Dioscorea aristolochiifolia	CHL(VAL, RME)
Dioscorea aspera	BRA(SCA)
Dioscorea auriculata	CHL(VAL, MAU, BIO, ARA, LLA)
Dioscorea axilliflora	CHL(ATA)
Dioscorea beecheyi	BRA(SCA)
Dioscorea bermejensis	ARG(SAL)
Dioscorea besseriana var. berteroi	CHL(RME)
Dioscorea besseriana var. besseriana	CHL(ANT, COQ, VAL, LBO, MAU, RME)
Dioscorea biloba ssp. biloba	CHL(ANT, COQ)
Dioscorea biloba ssp. coquimbana	CHL(COQ)
Dioscorea brachybotrya var. brachybotrya	ARG(NEU) / CHL(MAU, BIO, ARA, LLA)
Dioscorea brachybotrya var. germainii	CHL(LBO, MAU)
Dioscorea brachystachya	CHL(BIO)
Dioscorea bridgesii	CHL(COQ, VAL, LBO, MAU, BIO, RME)
Dioscorea bryoniifolia	CHL(COQ, VAL, RME)
Dioscorea campestris	ARG(CHA, COS, ERI, FOR, MIS, SAL, TUC) / BRA(PAR, RGS, SCA) / PRY(APY, CEN, COA, PAI) / URY(ART, PAY, RNO, SOR, TAC)
Dioscorea castilloniana	ARG(JUJ)
Dioscorea ceratandra	ARG(COS, JUJ, MIS) / BRA(PAR, RGS, SCA) / PRY(CON)
Dioscorea cienegensis	ARG(CHA, JUJ, SAL, TUC)
Dioscorea cinnamomifolia	ARG(MIS) / BRA(SCA)
Dioscorea cissophylla	CHL(LLA)
Dioscorea commutata	BRA(SCA)
Dioscorea coronata	ARG(CHA, COS, FOR, MIS) / BRA(PAR) / PRY(APY, PHA) / URY(CLA, TAC, TYT)
Dioscorea curitybensis	BRA(PAR)
Dioscorea demourae	ARG(CHA, COS, MIS) / BRA(PAR, RGS, SCA)
Dioscorea dodecaneura	ARG(CHA, COS, JUJ, MIS, SAL) / BRA(PAR, RGS) / PRY(AMA, CAU, PAI, SPE)
Dioscorea entomophila	ARG(JUJ, TUC)
Dioscorea fastigiata	CHL(ANT, ATA, COQ)
Dioscorea fractiflexa	BRA(PAR)
Dioscorea furcata	ARG(COS, ERI, MIS) / BRA(PAR, RGS, SCA) / PRY(Desconocida) / URY(SAO)
Dioscorea gayi	CHL(ATA)
Dioscorea geissei	CHL(ATA)
Dioscorea glandulosa	ARG(CHA, MIS) / BRA(PAR, SCA) / PRY(CAA, CON, GUA)
Dioscorea glomerulata	ARG(CAT, JUJ, SAL, TUC)
Dioscorea gouanioides	BRA(Fuera del área del proyecto) / PRY(CON)
Dioscorea gracilis	CHL(VAL)
Dioscorea grandiflora	BRA(Fuera del área del proyecto) / PRY(APA)
Dioscorea hassleriana	ARG(JUJ, SAL) / PRY(AMA, CEN, CON, COA, GUA, PAI)
Dioscorea haumanii	ARG(JUJ, SAL) / PRY(APY)
Dioscorea hieronymi	ARG(CAT, JUJ, SAL, TUC)
Dioscorea humifusa var. gracilis	CHL(VAL, BIO, RME)
Dioscorea humifusa var. humifusa	CHL(COQ, VAL, MAU, BIO, ARA, RME)
Dioscorea humilis ssp. humilis	CHL(VAL, LBO, MAU, BIO, RME)
Dioscorea humilis ssp. polyanthes	CHL(MAU)
Dioscorea laxiflora	BRA(PAR, SCA)
Dioscorea litoralis	CHL(VAL, BIO)
Dioscorea longipes	CHL(MAU, ARA)
Dioscorea macrantha	BRA(SCA)
Dioscorea megalantha	ARG(CAT, SAL, SDE, TUC)
Dioscorea microbotrya	ARG(CAT, CHA, COS, ERI, FOR, MIS, SAL, SDE, SFE, TUC) / BRA(PAR) / URY(PAY, RNO, SOR, TAC)
Dioscorea microcephala	BRA(RGS)
Dioscorea modesta	CHL(VAL, MAU, RME)
Dioscorea monadelpha	ARG(Desconocida) / BRA(PAR, RGS, SCA) / URY(RIV, TAC)
Dioscorea monandra	ARG(JUJ, TUC)
Dioscorea multiflora	ARG(COS, MIS) / BRA(PAR, RGS, SCA) / PRY(APA, CAU, CEN, CON, COA, GUA, ITA, PAI) / URY(ART, SAO)
Dioscorea multispicata	ARG(JUJ, SAL, TUC) / PRY(AMA)
Dioscorea nana	CHL(VAL, MAU, BIO, ARA, LLA)
Dioscorea nitida	PRY(CON)
Dioscorea obtusifolia var. obtusifolia	CHL(RME)
Dioscorea obtusifolia var. philippii	CHL(BIO, RME)
Dioscorea olfersiana	BRA(PAR, SCA)
Dioscorea oligophylla	CHL(VAL, RME)
Dioscorea ovata	BRA(PAR, RGS) / PRY(APA, CEN, CON, COA, PAI)
Dioscorea paupera	CHL(ATA, COQ)
Dioscorea pedicellata	CHL(COQ, LBO, MAU, BIO, ARA, RME)
Dioscorea pencana	CHL(BIO)
Dioscorea pilcomayensis	ARG(CHA, FOR, JUJ, SAL) / PRY(APY, AMA, CON, PHA)
Dioscorea piperifolia	BRA(PAR, RGS, SCA)
Dioscorea reticulata	ARG(NEU) / CHL(LBO, MAU, BIO, ARA, LLA)
Dioscorea saxatilis	CHL(COQ, VAL, LBO, MAU, RME)
Dioscorea sinuata	ARG(BAI, CHA, COS, MIS, SAL) / BRA(PAR, RGS, SCA) / PRY(APY, CEN, COA, GUA, PHA) / URY(Desconocida)
Dioscorea spectabilis	ARG(JUJ)
Dioscorea spicata	BRA(PAR, SCA)
Dioscorea stenocolpus	CHL(MAU, BIO)
Dioscorea stenopetala	ARG(SAL, TUC)
Dioscorea subhastata	ARG(CHA, COS, MIS) / BRA(PAR, RGS, SCA) / PRY(APY, CEN, COA, GUA, PAI, PHA)
Dioscorea tenella	CHL(ANT)
Dioscorea tenuis	CHL(LLA)
Dioscorea toldosensis	ARG(JUJ, SAL)
Dioscorea trifurcata	ARG(CAT)
Dioscorea uliginosa	CHL(BIO, ARA)
Dioscorea valdiviensis	CHL(ARA, LLA)
Dioscorea variifolia	CHL(COQ, VAL, LBO, BIO, ARA, RME)
Dioscorea volckmannii	ARG(MEN) / CHL(LBO, MAU)
Diospyros hassleri	PRY(APA, CAU, CAN)
Diospyros hispida	BRA(PAR) / PRY(AMA, CAN)
Diospyros inconstans	ARG(CHA, COS, ERI, MIS) / BRA(PAR, RGS, SCA) / PRY(APA, CEN, GUA, MIE, ÑEE, PAI, SPE) / URY(RNO, SAO)
Diostea juncea	ARG(CHU, MEN, NEU, RNE) / CHL(COQ, VAL, LBO, MAU, BIO, ARA, LLA, RME)
Diphasiastrum falcatum	BRA(PAR)
Diphasiastrum thyoides	ARG(COR, JUJ, SAL) / BRA(PAR, RGS, SCA) / URY(CLA, MAL)
Diphasium gayanum	ARG(SCR) / CHL(BIO, ARA, LLA, AIS, JFE)
Diplazium ambiguum	ARG(MIS) / BRA(PAR, RGS, SCA) / PRY(CAU, COA, PAI)
Diplazium asplenioides	BRA(RGS)
Diplazium brachycarpum	BRA(SCA)
Diplazium celtidifolium	BRA(SCA) / PRY(CAN)
Diplazium cristatum	ARG(CHA, COS, JUJ, MIS, SAL, TUC) / BRA(PAR, RGS, SCA) / PRY(CAN)
Diplazium divergens	ARG(JUJ)
Diplazium herbaceum	ARG(MIS) / BRA(PAR, RGS)
Diplazium hians	BRA(Desconocida) / PRY(CAN)
Diplazium leptocarpon	BRA(PAR)
Diplazium lilloi	ARG(JUJ, SAL, TUC)
Diplazium lindbergii	ARG(MIS) / BRA(PAR, RGS)
Diplazium moccennianum	ARG(MIS)
Diplazium plantaginifolium	BRA(PAR, RGS) / PRY(CAN)
Diplazium riedelianum	BRA(SCA) / PRY(CAN)
Diplazium rostratum	BRA(PAR, RGS, SCA)
Diplazium striatum	BRA(PAR, SCA) / URY(CLA, TAC)
Diplazium turgidum	ARG(MIS) / BRA(PAR, RGS, SCA)
Diplazium urticifolium	PRY(CAN)
Diplokeleba floribunda	ARG(CHA, COS, FOR, MIS, SFE) / BRA(Fuera del área del proyecto) / PRY(APY, AMA, CEN, CON, COA, GUA, ÑEE, PAI, PHA, SPE)
Diplolepis australis	ARG(CHU, MEN, NEU, RNE, SCR)
Diplolepis biflora	ARG(NEU, RNE) / CHL(VAL, BIO, ARA, RME)
Diplolepis boerhaviifolia	CHL(ANT, ATA, COQ, VAL, RME)
Diplolepis bulligera	ARG(CHU)
Diplolepis descolei	ARG(CHU, NEU, RNE) / CHL(RME)
Diplolepis diemii	ARG(CHU, NEU, RNE)
Diplolepis geminiflora	CHL(ATA, COQ, VAL, RME)
Diplolepis hieronymi	ARG(MEN, NEU, RNE) / CHL(MAU)
Diplolepis menziesii	CHL(COQ, VAL, LBO, MAU, RME)
Diplolepis mucronata	ARG(CHU, NEU, RNE) / CHL(COQ, VAL, LBO, BIO, RME)
Diplolepis myrtifolia	CHL(ARA, LLA)
Diplolepis nummulariifolia	ARG(MEN, NEU, RNE) / CHL(COQ, VAL, LBO, MAU, BIO, ARA, LLA, RME)
Diplolepis pachyphylla	ARG(CHU, NEU) / CHL(MAU, BIO, ARA, LLA, AIS)
Diplolepis viridis	CHL(ANT, ATA, COQ)
Diploön cuspidatum	BRA(PAR)
Diplopterys lutea	ARG(JUJ, SAL, TUC) / BRA(Fuera del área del proyecto) / PRY(CEN, CON, PAI)
Diplopterys pubipetala	BRA(PAR) / PRY(AMA)
Diplostephium cinereum	CHL(TAR)
Diplostephium meyenii	CHL(TAR, ANT)
Diplotaxis erucoides	ARG(MEN, SJU)
Diplotaxis muralis	ARG(BAI, CAT, CHU, COR, LPA, MEN, NEU, RNE, SJU) / CHL(ATA, COQ, RME)
Diplotaxis tenuifolia	ARG(BAI, CAT, CHU, COR, DFE, LPA, LRI, MEN, NEU, RNE, SJU, SLU, SCR, SFE) / URY(MON)
Dipogon lignosus	CHL(TAR)
Diposis bulbocastanum	CHL(COQ, VAL, LBO, RME)
Diposis patagonica	ARG(CHU, NEU, RNE)
Diposis saniculaefolia	URY(CAS, DUR, MAL, MON, SOR)
Dipsacus fullonum	ARG(BAI, COR, DFE, ERI, RNE, SAL, SFE) / URY(CAS, MON, ROC, SJO, SOR)
Dipsacus sativus	ARG(BAI, CAT, COR, JUJ, LRI, MEN, NEU, RNE, SAL, SFE, SJU, SLU, TUC) / CHL(VAL, MAU, BIO, ARA, LLA, RME, JFE)
Dipteranthus pellucidus	BRA(RGS, SCA)
Dipteranthus pustulatus	BRA(PAR, SCA)
Dipteryx alata	BRA(Fuera del área del proyecto) / PRY(AMA, CON)
Diptychandra aurantiaca	BRA(Fuera del área del proyecto) / PRY(AMA)
Dipyrena glaberrima	ARG(LRI, MEN, SJU)
Dirhamphis balansae	PRY(CEN, CON)
Disakisperma dubium	ARG(BAI, CAT, CHA, COR, COS, DFE, FOR, JUJ, LPA, LRI, MEN, SAL, SJU, SLU, SDE, TUC)
Discaria americana	ARG(BAI, CHU, COR, COS, ERI, LPA, MEN, RNE, SFE, SLU) / BRA(PAR, RGS, SCA) / URY(LAV, MAL, MON, RIV, TAC)
Discaria articulata	ARG(CHU, NEU, RNE) / CHL(LBO, MAU, BIO, ARA, RME)
Discaria chacaye	ARG(CHU, NEU, RNE, SCR, TDF) / CHL(VAL, LBO, MAU, BIO, ARA, LLA, AIS, MAG)
Disciphania contraversa	BRA(PAR, RGS, SCA)
Disciphania ernstii var. glaziovii	BRA(Fuera del área del proyecto) / PRY(AMA)
Discocactus hartmanii	BRA(Fuera del área del proyecto) / PRY(AMA, CON)
Discolobium leptophyllum	ARG(COS, FOR) / BRA(Fuera del área del proyecto) / PRY(MIE, PHA)
Discolobium pauciyugum	ARG(FOR) / PRY(MIE)
Discolobium psoraleaefolium	ARG(COS, ERI, MIS) / BRA(RGS) / URY(ART)
Discolobium pulchellum var. pulchellum	ARG(FOR, SFE) / BRA(Fuera del área del proyecto) / PRY(APY, CEN, ÑEE)
Discolobium pulchellum var. viscosissimum	PRY(APA, CEN)
Diskyphogyne scabrilingua	BRA(SCA)
Dissanthelium macusaniense	ARG(SAL) / CHL(TAR)
Dissanthelium peruvianum	ARG(JUJ, SAL) / CHL(TAR)
Distichia filamentosa	CHL(TAR)
Distichia muscoides	ARG(CAT, JUJ, SAL, TUC) / CHL(TAR, ANT)
Distichlis acerosa	ARG(CAT, COR, LRI, SLU, SDE)
Distichlis australis	ARG(CHU, RNE, SCR)
Distichlis humilis	ARG(CAT, COR, JUJ, LRI, SAL, SJU) / CHL(TAR, ANT, ATA)
Distichlis laxiflora	ARG(BAI, COR, LPA, MEN, SAL, SLU, SFE)
Distichlis scoparia var. erinacea	ARG(BAI, CHU, MEN, NEU, RNE, SJU, SCR)
Distichlis scoparia var. scoparia	ARG(BAI, CAT, CHA, CHU, COR, DFE, ERI, LPA, LRI, MEN, NEU, RNE, SAL, SCR, SFE, SJU, SLU, TUC) / CHL(TAR, ANT, ATA, COQ, VAL, BIO, ARA, LLA, RME) / URY(CAS, COL, FLA, MAL, MON, RNO, ROC, SJO, SOR)
Distichlis spicata var. spicata	ARG(BAI, CAT, CHA, CHU, COR, COS, DFE, ERI, JUJ, LPA, LRI, MEN, NEU, RNE, SAL, SJU, SLU, SCR, SFE, TUC) / CHL(TAR, ANT, ATA, COQ, VAL, MAU, BIO, ARA, LLA, RME) / URY(CAS, COL, MON, ROC, SJO)
Distichlis spicata var. stricta	ARG(BAI, ERI, JUJ, SCR, SFE) / CHL(ANT)
Disynaphia calyculata	ARG(ERI) / BRA(RGS, SCA) / URY(CAS, MON, RNO, RIV, SJO, TAC)
Disynaphia filifolia	ARG(MIS) / BRA(PAR) / PRY(APA, AMA, CAU, CON, SPE)
Disynaphia multicrenulata	ARG(COS, FOR, MIS) / BRA(PAR, RGS, SCA) / PRY(AMA, CAU, CAN, CEN, COA, GUA, MIE, PAI, SPE) / URY(TAC)
Disynaphia radula	ARG(COS, MIS) / BRA(PAR) / PRY(APA, AMA, CAU, SPE)
Ditassa burchellii	ARG(BAI, CAT, CHA, COR, COS, FOR, JUJ, LRI, MIS, SAL, SDE, TUC) / BRA(PAR, RGS, SCA) / PRY(APA, CON, PAI)
Ditassa edmundoi	BRA(PAR)
Ditassa hispida	ARG(MIS) / BRA(PAR, RGS)
Ditassa megapotamica	ARG(MIS) / BRA(PAR, RGS, SCA) / URY(SJO, SOR)
Ditassa obcordata	BRA(PAR)
Ditassa racemosa	ARG(SAL)
Ditassa tomentosa	BRA(PAR)
Ditaxis acaulis	ARG(COS, ERI, MIS) / BRA(RGS) / PRY(GUA) / URY(TAC)
Ditaxis breviramea	ARG(JUJ, LRI, SAL, SDE, TUC) / PRY(APY)
Ditaxis catamarcensis	ARG(CAT, COR, LPA, LRI, SAL, SFE, SLU, TUC)
Ditaxis jablonszkyana	ARG(CAT, LRI, SJU)
Ditaxis malpighipila	ARG(LPA, MEN, RNE, SAL, SJU)
Ditaxis montevidensis	ARG(CHA, COR, COS, ERI, FOR, SFE) / PRY(APY, APA, PHA) / URY(PAY, RNO, SOR)
Ditaxis rhizantha	URY(ART, PAY, RIV, TAC)
Ditaxis rosularis	ARG(MIS) / URY(TAC)
Ditaxis salina	ARG(FOR) / PRY(PAI)
Dodonaea viscosa	ARG(BAI, ERI, JUJ, SAL, SFE, TUC) / BRA(PAR, RGS, SCA) / CHL(COQ) / URY(CAS, LAV, MAL, MON, PAY, ROC, SJO, TYT)
Dolichandra chodatii	ARG(JUJ, MIS, SAL) / BRA(PAR) / PRY(AMA, CON, SPE)
Dolichandra cynanchoides	ARG(BAI, CAT, CHA, COR, COS, ERI, FOR, JUJ, LRI, MIS, SAL, SDE, SFE, TUC) / BRA(PAR, RGS, SCA) / PRY(APY, AMA, CEN, CON, COA, GUA, MIE, ÑEE, PAI, PHA, SPE) / URY(COL, MON, RNO, RIV, SAO)
Dolichandra dentata	ARG(BAI, CHA, COR, COS, ERI, MIS) / BRA(PAR, RGS, SCA) / PRY(AMA, GUA, PAI) / URY(ART, CAS, FLA, MON, SAO)
Dolichandra hispida	ARG(MIS) / BRA(PAR, RGS, SCA) / PRY(APA, APY, ITA)
Dolichandra quadrivalvis	ARG(CHA, COS, ERI, FOR, JUJ, MIS, SAL) / BRA(PAR, RGS, SCA) / PRY(APY, APA, AMA, CAA, CAN, CEN, CON, COA, GUA, ITA, MIE, PAI, PHA)
Dolichandra uncata	ARG(BAI, CHA, COS, ERI, FOR, JUJ, MIS, SFE) / BRA(PAR, RGS, SCA) / PRY(APY, APA, AMA, CAU, CAA, CAN, CEN, CON, COA, GUA, ITA, MIE, ÑEE, PAI, PHA) / URY(CAS)
Dolichandra unguiculata	BRA(PAR)
Dolichandra unguis-cati	ARG(BAI, CAT, CHA, COR, COS, ERI, FOR, JUJ, LPA, MIS, SAL, SFE, TUC) / BRA(PAR, RGS, SCA) / PRY(APA, APY, AMA, CAU, CAA, CAN, CEN, CON, COA, GUA, ITA, MIE, ÑEE, NAS, PAI, PHA, SPE) / URY(ART, COL, FLA, MON, RNO, RIV, SJO)
Dolichlasium lagascae	ARG(LPA, LRI, MEN, NEU, SJU, SCR)
Dolichopsis ligulata	PRY(COA, SPE)
Dolichopsis paraguariensis	ARG(CHA, COS, ERI, FOR, SAL, SFE) / BRA(Fuera del área del proyecto) / PRY(APY, BOQ, CAA, ÑEE, PHA)
Doliocarpus dentatus	BRA(Fuera del área del proyecto) / PRY(APA, AMA, SPE)
Doliocarpus glomeratus	BRA(PAR)
Doliocarpus schottianus	BRA(PAR, SCA)
Domeykoa oppositifolia	CHL(ANT, ATA)
Domeykoa perennis	CHL(ANT, ATA)
Donatia fascicularis	ARG(TDF) / CHL(BIO, ARA, LLA, AIS, MAG)
Doniophyton anomalum	ARG(CAT, CHU, JUJ, LPA, MEN, NEU, RNE, SAL, SCR, SJU) / CHL(ARA)
Doniophyton weddellii	ARG(CAT, JUJ, LRI, MEN, NEU, SAL, SJU) / CHL(ANT, ATA, COQ, RME)
Dorstenia brasiliensis	ARG(BAI, CHA, COS, ERI, FOR, MIS) / BRA(PAR, RGS) / PRY(APY, AMA, CAU, CEN, CHO, COA, GUA, ÑEE, PHA, SPE) / URY(ART, COL, FLA, MAL, MON, RIV, SAO, TAC)
Dorstenia carautae	BRA(PAR, SCA)
Dorstenia cayapia ssp. paraguariensis	BRA(Fuera del área del proyecto) / PRY(AMA, CON, COA, SPE)
Dorstenia cayapia ssp. vitifolia	BRA(PAR)
Dorstenia hirta	BRA(PAR)
Dorstenia tenuis	ARG(CHA, COS, MIS) / BRA(PAR, RGS, SCA) / PRY(AMA)
Dorstenia urceolata	BRA(PAR)
Doryopteris acutiloba	BRA(PAR, SCA)
Doryopteris adornata	ARG(JUJ, SAL) / BRA(Fuera del área del proyecto) / PRY(APY)
Doryopteris angustata	BRA(RGS)
Doryopteris arifolia	ARG(CHA, COS, ERI, JUJ, MIS, SAL, TUC) / BRA(PAR, RGS, SCA) / PRY(APA, APY, CAA, CAN, ITA)
Doryopteris collina	ARG(MIS) / BRA(PAR, SCA) / PRY(COA, GUA, PAI)
Doryopteris concolor	ARG(BAI, CAT, CHA, COR, COS, ERI, FOR, JUJ, MIS, SAL, SJU, SLU, SFE, SDE, TUC) / BRA(PAR, RGS, SCA) / PRY(AMA, CAU, CAA, CAN, COA, ÑEE, PAI, SPE) / URY(ART, DUR, FLA, RNO, SAO)
Doryopteris lorentzii	ARG(CHA, COR, COS, MIS, SAL, SFE, TUC) / BRA(PAR, RGS, SCA) / PRY(COA, ITA) / URY(ART, CLA, PAY, RNO)
Doryopteris nobilis	ARG(CHA, COS, FOR, JUJ, MIS, SAL, TUC) / BRA(PAR, RGS, SCA) / PRY(APA, AMA, CAU, CAA, CAN, ITA, PAI, SPE) / URY(RIV)
Doryopteris ornithopus	BRA(PAR)
Doryopteris pentagona	ARG(CHA, COS, FOR, JUJ, MIS, SAL, TUC) / BRA(PAR, RGS, SCA) / PRY(CAN, ÑEE, PAI, SPE)
Doryopteris rediviva	BRA(PAR, SCA)
Doryopteris rivalis	BRA(RGS, SCA)
Doryopteris sagittifolia	BRA(PAR, SCA)
Doryopteris stierii	BRA(RGS, SCA)
Doryopteris triphylla	ARG(BAI, CAT, COR, COS, MIS, SAL, TUC) / BRA(PAR, RGS, SCA) / PRY(APY, AMA, CEN, COA, PAI) / URY(MAL, MON)
Downingia pusilla	ARG(CHU, NEU, RNE, SCR) / CHL(COQ, VAL, LBO, MAU, BIO, ARA, RME)
Draba burkartiana	ARG(CAT, SAL, TUC)
Draba funiculosa	ARG(SCR, TDF) / CHL(MAG)
Draba gilliesii	ARG(CHU, LRI, MEN, NEU, RNE, SJU, SCR) / CHL(COQ, VAL, LBO, MAU, BIO, ARA, LLA, AIS, MAG, RME)
Draba lapaziana	ARG(SAL, TUC)
Draba loayzana	ARG(CAT, JUJ, SAL, TUC)
Draba macleanii	ARG(CAT, JUJ, LRI, SAL, TUC) / CHL(TAR)
Draba magellanica	ARG(CAT, CHU, LRI, MEN, NEU, SCR, TDF) / CHL(AIS, MAG)
Draba pusilla	ARG(MEN, NEU, RNE, SCR, SJU) / CHL(COQ, LBO, MAU, MAG, RME)
Draba thlaspiformis	CHL(RME)
Draba tucumanensis	ARG(CAT, JUJ, LRI, MEN, SAL, TUC)
Draba verna	ARG(CHU, COS, ERI, MEN, NEU, RNE, SCR, TDF) / CHL(BIO, MAG, RME)
Dracontium margaretae	BRA(Fuera del área del proyecto) / PRY(APY)
Drapetes muscosus	ARG(SCR, TDF) / CHL(MAG)
Drimys andina	CHL(BIO, ARA, LLA)
Drimys angustifolia	BRA(PAR, RGS, SCA)
Drimys brasiliensis ssp. brasiliensis	BRA(PAR, RGS)
Drimys brasiliensis ssp. sylvatica	BRA(PAR, RGS, SCA) / PRY(GUA)
Drimys confertifolia	CHL(JFE)
Drimys winteri var. winteri	ARG(CHU, NEU, RNE, SCR, TDF) / CHL(MAU, ARA, LLA, AIS, MAG)
Drimys winteri var. chilensis	CHL(COQ, VAL, LBO, MAU, BIO, ARA, LLA, AIS, RME)
Drosera brevifolia	ARG(COS, ERI, MIS) / BRA(PAR, RGS, SCA) / PRY(COA) / URY(CAS, MAL)
Drosera capillaris	BRA(RGS, SCA) / PRY(PAI)
Drosera communis	ARG(COS, MIS) / BRA(PAR, RGS, SCA) / PRY(APA, AMA, CAU, CAN, PAI)
Drosera latifolia	BRA(PAR, SCA)
Drosera montana	BRA(PAR, SCA)
Drosera uniflora	ARG(SCR, TDF) / CHL(BIO, ARA, LLA, AIS, MAG)
Dryadella aviceps	BRA(PAR)
Dryadella edwallii	BRA(PAR, SCA)
Dryadella liliputiana	BRA(PAR, RGS, SCA)
Dryadella zebrina	BRA(RGS, SCA)
Drymaria cordata	ARG(CAT, COR, COS, JUJ, LRI, MIS, SAL, SDE, TUC) / BRA(PAR, RGS) / CHL(ANT) / PRY(CEN, COA, GUA, PAI) / URY(ROC)
Drymaria engleriana var. devia	CHL(TAR)
Drymaria glandulosa	ARG(CAT, COR, JUJ, LRI, SAL, SDE, TUC)
Drymaria ovata	ARG(TUC)
Drymaria paposana	CHL(ANT)
Drymaria villosa	ARG(JUJ, SAL)
Dryopteris dilatata	ARG(TDF)
Dryopteris filix-mas	ARG(NEU, RNE) / CHL(LLA)
Dryopteris patula	ARG(JUJ, SAL, TUC) / BRA(Fuera del área del proyecto)
Dryopteris wallichiana	ARG(CAT, JUJ, SAL, TUC)
Duchesnea indica	ARG(BAI, ERI, JUJ, SAL, TUC) / BRA(PAR, RGS, SCA) / CHL(VAL, MAU, ARA, LLA, RME) / URY(MON)
Duguetia furfuracea	BRA(PAR) / PRY(AMA, CAU, CAN, CON, PHA, SPE)
Duguetia lanceolata	BRA(PAR, RGS, SCA)
Duguetia phaeoclados	BRA(Fuera del área del proyecto) / PRY(AMA, CON)
Dunalia brachyacantha	ARG(CAT, COR, JUJ, SAL, TUC)
Dunalia spinosa	CHL(TAR)
Duranta erecta var. erecta	BRA(PAR) / PRY(GUA)
Duranta erecta var. grandiflora	ARG(MIS)
Duranta serratifolia	ARG(CAT, JUJ, SAL, TUC)
Duranta vestita var. glabrescens	ARG(COS, MIS) / BRA(RGS)
Duseniella patagonica	ARG(CHU, LPA, MEN, NEU, RNE, SCR)
Dyckia affinis	PRY(PAI)
Dyckia agudensis	BRA(RGS)
Dyckia alba	BRA(RGS)
Dyckia bracteata	BRA(PAR)
Dyckia brevifolia	BRA(SCA)
Dyckia cabrerae	BRA(SCA)
Dyckia choristaminea	BRA(RGS)
Dyckia commixta	BRA(PAR) / PRY(COA)
Dyckia crocea	BRA(PAR)
Dyckia delicata	BRA(RGS)
Dyckia deltoidea	BRA(PAR)
Dyckia distachya	ARG(MIS) / BRA(RGS, SCA) / PRY(APA)
Dyckia domfelicianensis	BRA(RGS)
Dyckia dusenii	BRA(PAR, SCA)
Dyckia elisabethae	BRA(RGS)
Dyckia encholirioides var. encholirioides	BRA(PAR, RGS, SCA)
Dyckia encholirioides var. rubra	BRA(SCA)
Dyckia exserta	BRA(RGS) / PRY(AMA)
Dyckia ferox	ARG(CHA, COS, ERI, FOR, MIS, SAL, SFE) / BRA(PAR) / PRY(COA, PAI)
Dyckia floribunda var. floribunda	ARG(CAT, COR, JUJ, LRI, SAL, SJU, SLU) / PRY(PAI)
Dyckia fosteriana var. fosteriana	BRA(PAR)
Dyckia fosteriana var. robustior	BRA(PAR)
Dyckia frigida	BRA(PAR)
Dyckia gracilis	ARG(CHA)
Dyckia hatschbachii	BRA(PAR)
Dyckia hebdingii	BRA(RGS)
Dyckia ibicuiensis	BRA(RGS)
Dyckia ibiramensis	BRA(SCA)
Dyckia insignis	PRY(CON)
Dyckia irmgardiae	BRA(RGS)
Dyckia julianae	BRA(RGS)
Dyckia leptostachya	ARG(CHA, COS, ERI) / BRA(PAR, RGS, SCA) / PRY(CAU, CEN, COA)
Dyckia lutziana	BRA(PAR)
Dyckia maritima	BRA(RGS, SCA)
Dyckia microcalyx var. ostenii	ARG(MIS) / BRA(PAR)
Dyckia microcalyx var. microcalyx	BRA(PAR) / PRY(APA, GUA, PAI)
Dyckia minarum	BRA(SCA)
Dyckia mitis	ARG(MIS)
Dyckia monticola	BRA(SCA)
Dyckia niederleinii	ARG(MIS)
Dyckia polycladus	BRA(RGS)
Dyckia pseudococcinea	BRA(PAR)
Dyckia racinae	BRA(RGS)
Dyckia ragonesei	ARG(CHA, COR, COS, ERI, FOR, SDE, SFE)
Dyckia reitzii	BRA(PAR, RGS, SCA)
Dyckia remotiflora var. montevidensis	ARG(BAI, COS, ERI, MIS) / BRA(RGS) / URY(CAS, CLA, COL, LAV, RNO, RIV)
Dyckia remotiflora var. tandilensis	ARG(BAI)
Dyckia remotiflora var. remotiflora	BRA(PAR, RGS) / URY(CAS, CLA, LAV, MAL, MON, PAY, RIV, ROC)
Dyckia remotiflora var. angustior	BRA(RGS)
Dyckia retardata	BRA(RGS)
Dyckia retroflexa	BRA(RGS)
Dyckia rigida	BRA(RGS)
Dyckia selloa	BRA(PAR, RGS) / URY(Desconocida)
Dyckia strehliana	BRA(RGS)
Dyckia subinermis	ARG(MIS)
Dyckia tobatiensis	PRY(COA)
Dyckia tomentella	PRY(AMA)
Dyckia tuberosa	BRA(PAR, SCA)
Dyckia tweediei	ARG(SAL, SDE)
Dyckia velascana	ARG(CAT, COR, JUJ, LRI, SAL, SJU, SLU, TUC)
Dyckia velloziifolia	PRY(CAU)
Dyckia vestita	PRY(CON)
Dyckia virgata	PRY(PHA)
Dyckia walteriana	BRA(PAR)
Dyschoriste axillaris	ARG(SAL)
Dyschoriste humilis	ARG(BAI, CHA, COR, COS, ERI, SFE) / BRA(RGS) / URY(PAY)
Dyschoriste hygrophiloides	ARG(COS, ERI) / BRA(PAR, RGS) / URY(PAY, SAO)
Dyschoriste lavandulacea	ARG(COS, MIS) / BRA(PAR) / PRY(AMA, CAU, CAA, CAN)
Dyschoriste maranhonis	BRA(RGS)
Dyschoriste paraguariensis	BRA(Fuera del área del proyecto) / PRY(AMA, CAU, CAA, CAN, SPE)
Dyschoriste sagittata	PRY(APA)
Dyschoriste smithii	BRA(RGS, SCA)
Dyschoriste trichanthera	ARG(JUJ, SAL) / PRY(AMA, CAU, CAA, CAN, CON, GUA, ITA, PAI, SPE)
Dyschoriste tweediana	BRA(RGS)
Dyschoriste venturii	ARG(CHA, FOR, SAL, SDE, TUC) / PRY(APY)
Dysopsis glechomoides	ARG(CHU, NEU, RNE, SCR, TDF) / CHL(COQ, BIO, ARA, LLA, AIS, MAG)
Dysopsis hirsuta	CHL(JFE)
Dysphania ambrosioides	ARG(BAI, CAT, CHA, CHU, COR, COS, DFE, ERI, FOR, JUJ, LPA, LRI, MEN, MIS, NEU, RNE, SAL, SJU, SLU, SFE, SDE, TUC) / BRA(RGS) / CHL(TAR, ANT, ATA, COQ, VAL, LBO, MAU, BIO, ARA, LLA, RME, IDE, JFE) / PRY(APY, AMA, BOQ, CAU, CAA, CEN, CON, COA, GUA, ITA, PAI, PHA) / URY(FLA, MON)
Dysphania bonariensis	ARG(COS, ERI) / URY(PAY, SAO)
Dysphania burkartii	ARG(CHA, COR, COS, ERI, LPA, SFE) / PRY(ITA) / URY(ART, RIV)
Dysphania carinata	ARG(BAI, COR, COS, LRI, MIS, SAL, SDE, TUC)
Dysphania chilensis	ARG(BAI, CAT, COR, JUJ, LPA, LRI, MEN, NEU, RNE, SJU, SLU) / CHL(ANT, COQ, VAL, LBO, BIO, LLA, RME)
Dysphania microcarpa	CHL(VAL, RME)
Dysphania multifida	ARG(BAI, CHA, CHU, COR, ERI, JUJ, LPA, MEN, NEU, RNE, SAL, SJU, SFE) / CHL(TAR, ANT, ATA, COQ, VAL, LBO, MAU, BIO, ARA, LLA, RME, JFE) / URY(PAY, ROC)
Dysphania oblanceolata	ARG(CHU, MEN, NEU, RNE, SCR, TDF)
Dysphania pumilio	ARG(BAI, COR, LPA, MIS, SDE, TUC) / PRY(APA)
Dysphania retusa	ARG(BAI, COS, ERI, LPA) / BRA(RGS) / URY(COL, ROC)
Dysphania venturii	ARG(JUJ, SAL, TUC)
Dyssochroma longipes	BRA(PAR, RGS, SCA)
Dyssochroma viridiflorum	BRA(SCA)
Dyssodia papposa	ARG(JUJ)
