Racinaea aeris-incola	BRA(PAR, SCA)
Racinaea spiculosa var. ustulata	BRA(PAR, SCA)
Radiovittaria stipitata	BRA(PAR, SCA)
Ramorinoa girolae	ARG(LRI, SJU, SLU)
Randia calycina	ARG(CHA, FOR) / BRA(Fuera del área del proyecto) / PRY(AMA, CON, PHA)
Randia ferox	ARG(COS, MIS) / BRA(PAR, RGS, SCA) / PRY(ITA)
Randia micracantha	ARG(JUJ, SAL, TUC)
Ranunculus acaulis	ARG(TDF) / CHL(LLA, AIS, MAG)
Ranunculus apiifolius	ARG(BAI, CHA, COS, ERI, LPA, SFE, SDE, TUC) / BRA(RGS, SCA) / CHL(VAL, LBO, MAU, BIO, ARA, LLA) / PRY(CEN) / URY(CAS, MON, ROC)
Ranunculus aquatilis	CHL(TAR, MAG)
Ranunculus arvensis	CHL(MAU, BIO)
Ranunculus biternatus	ARG(CHU, SCR, TDF) / CHL(LLA, AIS, MAG)
Ranunculus bonariensis var. bonariensis	ARG(BAI, CHA, COS, ERI, FOR, MIS, SFE, TUC) / BRA(RGS, SCA) / PRY(CAU, CAA, COA, GUA, PAI, PHA, SPE) / URY(CAS, FLA, MON, PAY, RIV, ROC, SJO, SOR)
Ranunculus bonariensis var. phyteumifolius	ARG(BAI, CHA, COS, ERI, FOR, MIS, SFE, SJU) / BRA(PAR) / PRY(CAN, CEN, CON, COA, GUA, MIE, PAI, PHA, SPE) / URY(CLA)
Ranunculus bonariensis var. trisepalus	ARG(BAI, COR, DFE, ERI, LPA, MIS, SFE) / BRA(RGS, SCA) / CHL(COQ, VAL, LBO, MAU, BIO, ARA, LLA, RME) / URY(CAS)
Ranunculus bonariensis var. januarii	BRA(RGS, SCA)
Ranunculus caprarum	CHL(JFE)
Ranunculus catharinensis	BRA(SCA)
Ranunculus chilensis	ARG(RNE) / CHL(COQ, VAL, LBO, MAU, BIO, ARA, LLA, AIS, MAG, RME)
Ranunculus filamentosus	ARG(SAL)
Ranunculus flagelliformis	ARG(BAI, CAT, COR, COS, DFE, ERI, JUJ, MIS, NEU, SAL, SJU, SFE, TUC) / BRA(PAR, RGS, SCA) / CHL(COQ, VAL, MAU, BIO, ARA, LLA, RME) / PRY(CEN, COA, PAI) / URY(CAS, COL, MAL, MON, RIV, ROC, SOR)
Ranunculus fuegianus	ARG(SAL, SJU, SCR, TDF) / CHL(COQ, AIS, MAG)
Ranunculus hilii	ARG(CAT, TUC)
Ranunculus hydrophilus	ARG(CHU, NEU, RNE, SCR, TDF) / CHL(BIO, ARA, LLA, AIS, MAG)
Ranunculus lancipetalus	ARG(CAT, LRI, SAL, TUC)
Ranunculus maclovianus	ARG(TDF) / CHL(LLA, MAG)
Ranunculus minutiflorus	ARG(CHU, NEU, RNE, TDF) / CHL(COQ, LBO, MAU, BIO, ARA, LLA, AIS, MAG, RME)
Ranunculus muricatus	ARG(BAI, COR, COS, DFE, ERI, FOR, MIS, RNE, SJU) / BRA(PAR, RGS, SCA) / CHL(COQ, VAL, LBO, MAU, BIO, ARA, LLA, MAG, RME, JFE) / PRY(CEN) / URY(CAS, MON)
Ranunculus parviflorus	ARG(TUC) / BRA(PAR, SCA) / CHL(BIO, ARA)
Ranunculus peduncularis var. erodiifolius	ARG(CHU, MEN, NEU, RNE, SCR, TDF) / CHL(COQ, LBO, MAU, BIO, ARA, LLA, AIS, MAG, RME)
Ranunculus peduncularis var. peduncularis	ARG(CHU, MEN, NEU, RNE, SCR, TDF) / CHL(COQ, VAL, LBO, MAU, BIO, ARA, LLA, AIS, MAG, RME)
Ranunculus platensis	ARG(BAI, CHA, COR, COS, DFE, ERI, RNE, SFE, SLU, TUC) / URY(ART, DUR, FLO, MON, SAO)
Ranunculus praemorsus	ARG(CAT, COR, JUJ, SAL, TUC)
Ranunculus pseudotrullifolius	ARG(SCR, TDF) / CHL(LLA, MAG)
Ranunculus psychrophilus	ARG(JUJ, SAL, TUC)
Ranunculus repens var. repens	ARG(BAI, CHU, NEU, RNE, TDF) / BRA(PAR, RGS) / CHL(COQ, VAL, MAU, BIO, ARA, LLA, AIS, MAG, RME)
Ranunculus repens var. flore-pleno	ARG(BAI, CAT, COR, LRI, MEN, NEU) / CHL(COQ, VAL, BIO, ARA, LLA)
Ranunculus sarmentosus	ARG(CAT, COR, TUC)
Ranunculus sceleratus	CHL(VAL, LBO, RME)
Ranunculus sericocephalus	ARG(TDF) / CHL(MAG)
Ranunculus spegazzinii	ARG(CHU, NEU, RNE) / CHL(ARA, MAG)
Ranunculus trichophyllus	ARG(CHU, NEU, SCR, SJU, TDF) / CHL(LLA, MAG)
Ranunculus trullifolius	ARG(CHU, NEU, RNE, SCR, TDF) / CHL(COQ, ARA, LLA, AIS, MAG)
Ranunculus uniflorus f. bolivianus	CHL(TAR, ANT)
Raphanus raphanistrum	ARG(BAI, CHA, ERI, MIS, SFE) / BRA(RGS) / CHL(ANT, ATA, COQ, VAL, LBO, MAU, BIO, ARA, LLA, RME) / PRY(COA, ITA) / URY(MAL)
Raphanus sativus	ARG(BAI, CAT, CHU, COR, COS, DFE, ERI, JUJ, LPA, LRI, MEN, MIS, NEU, RNE, SAL, SJU, SLU, SCR, SFE, TDF, TUC) / BRA(PAR, RGS) / CHL(ATA, COQ, VAL, LBO, MAU, BIO, LLA, MAG, RME, JFE) / PRY(MIE) / URY(MON, RNO, SAO, SOR)
Rapistrum rugosum	ARG(BAI, COR, COS, DFE, ERI, FOR, JUJ, LPA, LRI, MEN, MIS, NEU, RNE, SAL, SJU, SLU, SCR, SFE, SDE, TDF, TUC) / BRA(Fuera del área del proyecto) / CHL(ATA, COQ, VAL, LBO, MAU, BIO, ARA, LLA, RME, IPA) / PRY(CEN) / URY(MAL, MON)
Ratibida columnifera f. pulcherrima	ARG(SLU)
Ratibida columnifera f. columnifera	ARG(SFE)
Raukaua laetevirens	ARG(CHU, NEU, RNE, SCR) / CHL(MAU, BIO, ARA, LLA, AIS, MAG)
Raukaua valdiviensis	CHL(MAU, BIO, ARA, LLA)
Raulinoa echinata	BRA(SCA)
Raulinoreitzia crenulata	ARG(CHA, COS, ERI, FOR, JUJ, MEN, MIS, SAL, SFE, TUC) / BRA(PAR, RGS, SCA) / PRY(AMA, CAU, CAA, CAN, CEN, CON, COA, GUA, PHA, SPE) / URY(PAY)
Raulinoreitzia tremula	ARG(BAI, ERI) / BRA(PAR, RGS, SCA) / URY(CAS, MAL, RNO, SJO)
Rauvolfia mollis	ARG(FOR) / BRA(Fuera del área del proyecto) / PRY(APY, CON)
Rauvolfia schuelii	ARG(CAT, JUJ, SAL, TUC)
Rauvolfia sellowii	ARG(MIS) / BRA(PAR, SCA) / PRY(APA, CAA)
Rauvolfia weddelliana	BRA(Fuera del área del proyecto) / PRY(AMA, CAN, SPE)
Rebutia deminuta	ARG(SAL, TUC)
Rebutia fiebrigii	ARG(JUJ, SAL)
Rebutia margarethae	ARG(SAL)
Rebutia marsoneri	ARG(JUJ)
Rebutia minuscula ssp. minuscula	ARG(CAT, JUJ, SAL, TUC)
Rebutia minuscula ssp. wessneriana	ARG(JUJ)
Recordia reitzii	BRA(RGS, SCA)
Regnellidium diphyllum	ARG(COS) / BRA(RGS, SCA) / URY(CLA, PAY, ROC, TYT)
Reicheella andicola	CHL(TAR, ANT)
Reichenbachia paraguayensis	ARG(MIS) / BRA(Fuera del área del proyecto) / PRY(APY, CEN)
Reitzia smithii	BRA(SCA)
Relbunium humilioides	BRA(RGS, SCA)
Relbunium longipedunculatum	BRA(PAR, RGS, SCA)
Relchela panicoides	ARG(CHU, NEU, RNE, SCR) / CHL(VAL, MAU, BIO, ARA, LLA)
Remirea maritima	BRA(PAR, SCA)
Reseda decursiva	CHL(VAL)
Reseda luteola	ARG(BAI, NEU, SCR) / CHL(BIO)
Reseda odorata	CHL(ATA)
Reseda phyteuma	CHL(ATA, BIO)
Retanilla ephedra	CHL(VAL, LBO, MAU, BIO, ARA, RME)
Retanilla patagonica	ARG(CHU, MEN, NEU, RNE)
Retanilla stricta	CHL(COQ, VAL, LBO, MAU, RME)
Retanilla trinervia	CHL(COQ, VAL, LBO, MAU, RME)
Reyesia cactorum	CHL(ANT, ATA)
Reyesia chilensis	CHL(TAR, ANT, ATA, COQ)
Reyesia juniperoides	CHL(TAR)
Reyesia parviflora	ARG(MEN, SJU) / CHL(TAR, ANT, ATA, COQ, RME)
Rhabdadenia madida	ARG(COS, FOR, MIS) / BRA(PAR, RGS, SCA) / PRY(APA, APY, AMA, BOQ, CAU, CAA, CAN, CEN, CON, COA, MIE, ÑEE, PAI, PHA, SPE) / URY(COL)
Rhabdadenia ragonesei	ARG(CHA, COS, FOR, SAL, SFE) / BRA(Fuera del área del proyecto) / PRY(CAU, CAN, CEN, COA, GUA, ITA, MIE, ÑEE, PAI, PHA, SPE)
Rhabdocaulon denudatum	BRA(PAR)
Rhabdocaulon erythrostachys	BRA(PAR, RGS, SCA)
Rhabdocaulon gracilis	BRA(PAR, RGS)
Rhabdocaulon lavanduloides	BRA(PAR, SCA)
Rhabdocaulon stenodontus	BRA(RGS, SCA) / PRY(AMA, CAN, CON)
Rhabdocaulon strictus	ARG(BAI, COS, ERI, MIS) / BRA(RGS) / PRY(ÑEE) / URY(CLA, PAY)
Rhamnidium elaeocarpum	BRA(PAR, SCA) / PRY(AMA, CAA, CAN, CEN, CON, COA, GUA, PAI, SPE)
Rhamnidium glabrum	BRA(PAR) / PRY(CEN)
Rhamnidium hasslerianum	PRY(APA, CAU, SPE)
Rhamnus catharticus	ARG(BAI, ERI)
Rhamnus diffusus	CHL(ARA, LLA)
Rhamnus sphaerosperma var. pubescens	ARG(JUJ, MIS, SAL, TUC) / BRA(PAR, RGS, SCA) / PRY(APA, CAU, CAN, CEN, ITA)
Rhaphithamnus spinosus	ARG(CHU, NEU, RNE) / CHL(COQ, VAL, LBO, MAU, BIO, ARA, LLA, RME)
Rhaphithamnus venustus	CHL(JFE)
Rhaponticum repens	ARG(BAI, CHU, COR, LPA, RNE, SCR)
Rheedia brasiliensis	ARG(CHA, COS, FOR, MIS) / BRA(SCA) / PRY(AMA, CAN, COA, GUA, PAI)
Rhinocidium fuchsii	ARG(CAT, JUJ, SAL, TUC) / PRY(CEN)
Rhipidocladum neumannii	ARG(SAL, TUC)
Rhipidocladum racemiflorum	ARG(SAL, TUC)
Rhipsalis aculeata	ARG(CAT, CHA, COS, ERI, FOR, SAL, SDE, SFE, TUC) / PRY(PHA) / URY(ART)
Rhipsalis agudoensis	BRA(RGS)
Rhipsalis baccifera ssp. baccifera	ARG(CHA, COS, FOR, JUJ, MIS, SAL) / BRA(RGS, SCA) / PRY(APY, APA, CAA, CAN, CEN, CON, COA, GUA, PAI, PHA)
Rhipsalis baccifera ssp. shaferi	PRY(APY, APA, CAA, CAN, CEN, CON, COA, PAI, PHA)
Rhipsalis burchellii	BRA(PAR, SCA)
Rhipsalis campos-portoana	BRA(PAR, RGS, SCA)
Rhipsalis cereuscula	ARG(COS, ERI, MIS) / BRA(PAR, RGS, SCA) / PRY(APA, APY, AMA, CAU, CAA, CAN, CON, COA, GUA, ITA, ÑEE, PAI, SPE) / URY(ART)
Rhipsalis clavata	BRA(PAR)
Rhipsalis cruciforme	ARG(CHA, COS, FOR, MIS) / BRA(PAR, RGS, SCA) / PRY(APA, CAU, CAA, CAN, CEN, COA, GUA, MIE, PAI) / URY(ART, CLA)
Rhipsalis dissimilis f. dissimilis	BRA(PAR, SCA)
Rhipsalis dissimilis f. epiphyllanthoides	BRA(PAR)
Rhipsalis elliptica	BRA(PAR, SCA)
Rhipsalis floccosa ssp. hohenauensis	ARG(MIS) / BRA(PAR, SCA) / PRY(APA, CAU, CAA, CAN, CEN, GUA, PHA, SPE) / URY(RIV)
Rhipsalis floccosa ssp. tucumanensis	ARG(JUJ, SAL, TUC)
Rhipsalis floccosa ssp. pulvinigera	BRA(PAR, RGS, SCA)
Rhipsalis grandiflora	BRA(PAR, SCA)
Rhipsalis houlletiana	ARG(MIS) / BRA(PAR, RGS, SCA)
Rhipsalis lorentziana	ARG(JUJ, SAL, TUC)
Rhipsalis lumbricoides	ARG(BAI, CHA, COS, ERI, FOR, JUJ, MIS, SAL, TUC) / BRA(PAR, RGS, SCA) / PRY(APA, AMA, CAU, CAA, CEN, COA, GUA, ITA, PAI, PHA, SPE) / URY(ART, FLA, MAL, SAO, SOR, TAC, TYT)
Rhipsalis monacantha	ARG(JUJ, SAL, TUC)
Rhipsalis neves-armondii	BRA(PAR)
Rhipsalis pachyptera	BRA(PAR, RGS, SCA)
Rhipsalis paradoxa	BRA(PAR, RGS, SCA)
Rhipsalis pilocarpa	BRA(PAR)
Rhipsalis puniceo-discus	BRA(PAR, SCA)
Rhipsalis teres f. heteroclada	BRA(PAR, RGS, SCA)
Rhipsalis teres f. capilliformis	BRA(PAR, SCA)
Rhipsalis teres f. prismatica	BRA(SCA)
Rhipsalis teres f. teres	BRA(PAR, RGS, SCA)
Rhipsalis trigona	BRA(PAR, SCA)
Rhizophora mangle	BRA(PAR, SCA)
Rhodophiala advena	CHL(COQ, VAL, RME)
Rhodophiala ananuca	CHL(ANT, ATA, COQ)
Rhodophiala andicola	ARG(NEU) / CHL(MAU, BIO, ARA, LLA)
Rhodophiala araucana	ARG(NEU, RNE) / CHL(MAU, BIO, ARA)
Rhodophiala bagnoldii	CHL(ANT, ATA, COQ)
Rhodophiala bakeri	CHL(MAU, ARA)
Rhodophiala berteroana	CHL(LBO)
Rhodophiala bifida	ARG(BAI, COS, ERI, MIS) / BRA(RGS) / PRY(ITA) / URY(CAS, COL, DUR, MAL, MON, PAY, RNO, ROC, SOR, TAC)
Rhodophiala biflora	CHL(LLA)
Rhodophiala chilensis	CHL(BIO)
Rhodophiala colona	CHL(ARA)
Rhodophiala consobrina	CHL(RME)
Rhodophiala flava	CHL(MAU, BIO)
Rhodophiala fulgens	CHL(LLA)
Rhodophiala laeta	CHL(ANT, ATA)
Rhodophiala lineata	CHL(RME)
Rhodophiala maculata	CHL(ARA)
Rhodophiala mendocina	ARG(CHU, LPA, MEN, NEU, RNE, SJU)
Rhodophiala moelleri	CHL(ARA)
Rhodophiala montana	CHL(MAU, ARA)
Rhodophiala phycelloides	CHL(ATA, COQ, RME)
Rhodophiala popetana	CHL(VAL, LBO)
Rhodophiala pratensis	CHL(ANT, ATA, COQ, MAU, BIO, LLA)
Rhodophiala rhodolirion	ARG(MEN) / CHL(LBO, MAU, RME)
Rhodophiala rosea	CHL(LBO, MAU, BIO, ARA)
Rhodophiala splendens	CHL(MAU)
Rhodophiala tenuiflora	CHL(RME)
Rhodophiala tiltilensis	CHL(VAL, RME)
Rhodophiala uniflora	CHL(COQ)
Rhodoscirpus asper	ARG(CAT, COR, JUJ, LRI, MEN, NEU, RNE, SAL, SJU, SLU, TUC) / CHL(TAR, ANT, ATA, COQ, VAL, LBO, MAU, BIO, ARA, RME)
Rhodostemonodaphne macrocalyx	BRA(PAR)
Rhynchanthera brachyrhyncha	BRA(PAR, RGS, SCA)
Rhynchanthera cordata	BRA(PAR, SCA) / PRY(COA)
Rhynchanthera dichotoma	BRA(SCA)
Rhynchanthera hassleriana	PRY(AMA)
Rhynchanthera novemnervia	BRA(Fuera del área del proyecto) / PRY(AMA, COA, PAI)
Rhynchanthera rosea	PRY(CAA, CEN, COA, MIE)
Rhynchanthera secundiflora	BRA(Fuera del área del proyecto) / PRY(Desconocida)
Rhynchanthera ternata	PRY(CAU)
Rhynchanthera verbenoides	ARG(COS, MIS) / BRA(Fuera del área del proyecto) / PRY(CAA, CAN, CEN, COA, GUA, MIE, PAI)
Rhynchoryza subulata	ARG(BAI, CHA, COS, ERI, SFE) / BRA(RGS) / PRY(CEN, COA, PAI) / URY(RIV)
Rhynchosia arenicola	ARG(COS, MIS) / BRA(PAR) / PRY(CAU, ITA)
Rhynchosia balansae var. balansae	ARG(COS, MIS) / BRA(Fuera del área del proyecto) / PRY(AMA, CEN, CON, COA, GUA, PAI, SPE) / URY(MON)
Rhynchosia balansae var. psilantha	ARG(COS) / PRY(CEN, ITA)
Rhynchosia bicentrica	ARG(BAI, CAT, CHA, COR, COS, ERI, LPA, SLU, SFE) / BRA(RGS) / URY(ART, CLA, COL, FLO, FLA, MAL, MON, PAY, RNO, RIV, ROC, SAO, SJO, SJO, TAC)
Rhynchosia burkartii	ARG(CHA, COS, FOR, SAL) / PRY(APY, PHA)
Rhynchosia caaguazuensis	PRY(AMA, CAU)
Rhynchosia clausseni	BRA(Fuera del área del proyecto) / PRY(CAN, SPE)
Rhynchosia corylifolia	ARG(CHA, COS, FOR, JUJ, MIS, SFE, TUC) / BRA(PAR, RGS, SCA) / PRY(APA, CAU, CAA, CAN, CEN, CON, COA, GUA, ITA, MIE, ÑEE, PAI, PHA, SPE) / URY(ART, CLA, MAL, MON, RIV, TAC, TYT)
Rhynchosia diversifolia	ARG(CHA, COR, COS, ERI, FOR, JUJ, MIS, SAL, SFE, TUC) / BRA(PAR, RGS, SCA) / PRY(COA, MIE, PAI) / URY(ART, CAS, CLA, COL, FLA, LAV, MAL, MON, PAY, RNO, RIV, ROC, SAO, SJO, SOR, TAC, TYT)
Rhynchosia edensis	URY(MAL, TAC)
Rhynchosia edulis	ARG(CHA, COR, COS, ERI, FOR, JUJ, MIS, SAL, SFE, SLU) / BRA(PAR, RGS, SCA) / PRY(APY, CAU, CAA, CEN, CON, COA, GUA, MIE, PAI)
Rhynchosia hauthalii	ARG(COS, MIS, SFE) / BRA(PAR, RGS) / PRY(APA, CAU, CAN, COA, GUA, MIE, PAI) / URY(RIV, TAC)
Rhynchosia lateritia	ARG(COS, MIS) / BRA(RGS) / PRY(PAI) / URY(CLA)
Rhynchosia leucophylla	BRA(Fuera del área del proyecto) / PRY(APA, AMA, CAU, CAA, CAN, CON)
Rhynchosia lineata	ARG(COS, ERI, MIS) / BRA(RGS, SCA) / PRY(APA) / URY(ART, CLA, DUR, PAY, RNO, RIV, TAC)
Rhynchosia melanocarpa	ARG(MIS) / BRA(PAR, RGS, SCA) / PRY(APA, CAU, COA, GUA, PAI, SPE)
Rhynchosia minima	ARG(CHA, COS, FOR, JUJ, MIS, SAL, SFE, TUC) / BRA(Fuera del área del proyecto) / CHL(TAR) / PRY(APY, CON, PHA)
Rhynchosia naineckensis	ARG(COS, FOR, JUJ, SAL) / PRY(AMA, CEN, PAI, SPE)
Rhynchosia pallida	PRY(PAI)
Rhynchosia phaseoloides	BRA(PAR, RGS, SCA) / PRY(CAN, PAI, SPE)
Rhynchosia reticulata var. reticulata	BRA(Fuera del área del proyecto) / URY(MON)
Rhynchosia reticulata var. kuntzei	BRA(PAR)
Rhynchosia rojasii	ARG(COS, MIS) / BRA(PAR, RGS) / PRY(APA, AMA, CAU, GUA, ÑEE)
Rhynchosia senna var. senna	ARG(BAI, CHA, COR, COS, ERI, JUJ, LPA, MIS, SAL, SDE, SFE, SLU, TUC) / BRA(RGS) / URY(ART, CLA, LAV, MAL, MON, PAY, RNO, RIV, SJO, SOR, TAC)
Rhynchosia senna var. texana	ARG(BAI, CAT, CHA, COR, COS, ERI, LPA, LRI, SDE, SFE, SJU, SLU, TUC) / BRA(RGS) / PRY(APY) / URY(CLA, COL, DUR, FLA, LAV, MAL, MON, PAY, RNO, RIV, ROC, SAO, TAC, TYT)
Rhynchosida physocalyx	ARG(BAI, CAT, CHA, COR, COS, ERI, FOR, JUJ, LPA, LRI, MEN, SAL, SFE, SJU, SLU, TUC) / BRA(RGS) / PRY(APY, BOQ, CON, PHA) / URY(COL, DUR, MAL, PAY, SOR)
Rhynchospora albiceps	ARG(MIS) / BRA(PAR) / PRY(AMA, CAU, CAN, GUA)
Rhynchospora asperula	ARG(BAI, COS, ERI, MIS) / BRA(PAR, RGS, SCA) / PRY(APA, AMA, CAU, CAA, CAN, CEN, COA, GUA, ITA, MIE, ÑEE, PAI, SPE) / URY(RIV)
Rhynchospora barrosiana	ARG(COS, ERI, FOR, MIS) / BRA(PAR, RGS, SCA) / PRY(AMA, CAU, CAA, CAN, CEN, COA, GUA, MIE, PAI, SPE) / URY(CAS, CLA, MAL, MON, PAY, RNO, RIV, ROC, TAC, TYT)
Rhynchospora biflora	BRA(PAR, RGS, SCA)
Rhynchospora brasiliensis	BRA(PAR, RGS, SCA)
Rhynchospora breviuscula	BRA(PAR, SCA)
Rhynchospora brittonii	ARG(COS) / BRA(RGS, SCA) / URY(CAS, DUR, MON, PAY, SJO)
Rhynchospora brownii ssp. americana	ARG(CHA, COR, COS, ERI, MIS) / BRA(PAR, RGS, SCA) / CHL(ARA) / PRY(AMA, CEN, MIE) / URY(CLA, FLA, LAV, MON, RNO, SJO, TYT)
Rhynchospora caduciglumis	BRA(RGS, SCA)
Rhynchospora catharinensis	BRA(SCA)
Rhynchospora ciliata	BRA(PAR, SCA)
Rhynchospora conferta	BRA(PAR, RGS, SCA)
Rhynchospora confinis	ARG(COS, LRI, MIS) / BRA(PAR, RGS, SCA) / PRY(APA, CAU, CAA, COA, GUA, ITA)
Rhynchospora consanguinea	BRA(PAR, SCA) / PRY(CAU, CAN)
Rhynchospora contracta	BRA(PAR) / PRY(APY)
Rhynchospora coriifolia	BRA(SCA)
Rhynchospora corymbosa var. corymbosa	ARG(BAI, CHA, COS, DFE, ERI, FOR, JUJ, MIS, RNE, SAL, SFE, TUC) / BRA(PAR, RGS, SCA) / PRY(APA, APY, AMA, CAU, CAA, CAN, CEN, CON, COA, GUA, ITA, MIE, ÑEE, PAI, PHA, SPE) / URY(ART, CAS, CLA, DUR, FLA, LAV, MON, PAY, RNO, ROC, SAO, SJO, SOR)
Rhynchospora corymbosa var. angustirostris	ARG(MIS) / BRA(PAR, RGS, SCA) / PRY(AMA)
Rhynchospora corymbosa var. bonariensis	ARG(BAI, COS, DFE, ERI, MIS, SFE) / BRA(RGS) / URY(CAS, LAV, MON, RNO, RIV, ROC, SOR)
Rhynchospora corymbosa var. chacoensis	ARG(CHA, COS, ERI, FOR, JUJ, MIS, SAL, SFE, TUC) / PRY(AMA, CEN, CON, GUA, PHA) / URY(RNO)
Rhynchospora corymbosa var. legrandii	ARG(BAI, COS, ERI) / BRA(PAR, SCA) / URY(MON, SJO)
Rhynchospora crinigera	BRA(PAR, RGS) / URY(MON, SJO)
Rhynchospora elatior var. elatior	BRA(PAR)
Rhynchospora elatior var. brevispiculosa	BRA(Fuera del área del proyecto) / PRY(CON)
Rhynchospora emaciata	ARG(COS, ERI, MIS) / BRA(PAR, RGS, SCA) / PRY(AMA, CAU, COA, GUA, MIE, PAI, SPE) / URY(CAS, RIV)
Rhynchospora exaltata	BRA(PAR, RGS, SCA) / PRY(AMA, CAN, SPE)
Rhynchospora flexuosa	BRA(SCA)
Rhynchospora gigantea	BRA(SCA)
Rhynchospora glaziovii	ARG(MIS) / BRA(PAR, RGS, SCA)
Rhynchospora globosa	ARG(COS, FOR, MIS) / BRA(PAR, RGS, SCA) / PRY(AMA, CAU, CAN, COA, SPE) / URY(RIV, TAC)
Rhynchospora gollmeri	BRA(PAR, RGS, SCA)
Rhynchospora hassleri	PRY(AMA)
Rhynchospora hatschbachii	BRA(PAR, SCA)
Rhynchospora hieronymi ssp. montevidensis	ARG(COS, ERI, MIS) / BRA(RGS, SCA) / URY(CAS, MAL, MON, RNO, SJO)
Rhynchospora hieronymi ssp. hieronymi	ARG(JUJ, SAL, TUC) / BRA(SCA)
Rhynchospora holoschoenoides	ARG(COS) / BRA(PAR, RGS, SCA) / PRY(APY, AMA, CAN, ITA) / URY(CAS, MON, ROC)
Rhynchospora iberae	ARG(COS) / PRY(SPE)
Rhynchospora junciformis	BRA(SCA)
Rhynchospora latibracteata	BRA(RGS) / URY(RNO)
Rhynchospora loefgrenii	ARG(MIS) / BRA(PAR, RGS, SCA) / PRY(AMA, CAU, GUA, SPE) / URY(TAC)
Rhynchospora marisculus	ARG(CHA, COS, ERI, FOR, MIS, SAL) / BRA(PAR, RGS, SCA) / PRY(AMA, CAA, CEN, COA, GUA, MIE, PAI, SPE) / URY(CAS, CLA, MAL, MON, RNO, RIV, SJO)
Rhynchospora megapotamica var. megapotamica	ARG(BAI, CHA, COS, ERI, JUJ, MIS, SFE, TUC) / BRA(RGS, SCA) / PRY(CEN) / URY(ART, DUR, FLA, LAV, MAL, MON, RNO, ROC, SAO, SOR, TYT)
Rhynchospora megapotamica var. spicata	BRA(SCA)
Rhynchospora nardifolia	BRA(PAR)
Rhynchospora nervosa	ARG(FOR, MIS) / BRA(PAR, SCA) / PRY(COA, GUA, PAI, SPE)
Rhynchospora organensis	ARG(BAI, COS, DFE, ERI, MIS) / BRA(PAR, RGS) / PRY(CAA, SPE) / URY(DUR, FLA, RNO, SOR)
Rhynchospora paranaënsis	BRA(PAR)
Rhynchospora pedersenii	BRA(PAR, SCA) / PRY(SPE)
Rhynchospora pilosa	BRA(PAR)
Rhynchospora polyantha	BRA(PAR, RGS, SCA)
Rhynchospora praecincta	ARG(COS, ERI, MIS, SFE) / PRY(ÑEE, PAI) / URY(ART, FLA, PAY, SAO)
Rhynchospora pseudomacrostachya	BRA(RGS, SCA)
Rhynchospora pungens	ARG(CHA, COS, MIS, TUC) / BRA(PAR, SCA) / PRY(CAU) / URY(PAY)
Rhynchospora radicans ssp. radicans	BRA(Fuera del área del proyecto) / PRY(APA)
Rhynchospora radicans ssp. microcephala	BRA(SCA)
Rhynchospora rigida	BRA(PAR, SCA)
Rhynchospora riparia	BRA(Fuera del área del proyecto) / PRY(AMA)
Rhynchospora robusta	ARG(COS, ERI, MIS) / BRA(PAR, RGS, SCA) / PRY(APA, CAA, COA) / URY(RIV)
Rhynchospora rugosa	ARG(COS, MIS) / BRA(PAR, RGS, SCA) / PRY(AMA, CAN, ÑEE) / URY(TYT)
Rhynchospora rupestris	BRA(Fuera del área del proyecto) / PRY(AMA)
Rhynchospora scutellata	ARG(BAI, CHA, COS, ERI, FOR, MIS, SFE) / BRA(RGS, SCA) / PRY(APY, AMA, CEN, ITA, PAI, PHA, SPE) / URY(ART, CLA, DUR, PAY, RIV, SAO, TAC)
Rhynchospora setigera	ARG(COS, MIS) / BRA(PAR, RGS, SCA) / PRY(AMA, CAU, GUA, SPE) / URY(CLA, RIV, ROC, TAC, TYT)
Rhynchospora smithii	BRA(SCA)
Rhynchospora splendens f. composita	BRA(PAR, RGS, SCA)
Rhynchospora splendens	BRA(PAR, RGS, SCA)
Rhynchospora subsetosa	BRA(PAR, SCA)
Rhynchospora subtilis	BRA(PAR, SCA)
Rhynchospora tenella	BRA(PAR, SCA)
Rhynchospora tenuis ssp. tenuis	ARG(COS, ERI, JUJ, MIS) / BRA(PAR, RGS, SCA) / PRY(APA, AMA, COA, GUA, ITA, PAI, SPE) / URY(CAS, MAL, MON, PAY, RNO, RIV, ROC, SJO, TAC, TYT)
Rhynchospora tenuis ssp. austro-brasiliensis	ARG(MIS) / BRA(PAR, RGS) / PRY(CAN)
Rhynchospora terminalis var. crassipes	BRA(PAR) / PRY(CON, GUA)
Rhynchospora triflora	BRA(PAR) / PRY(AMA, CAN, CON)
Rhynchospora trispicata	BRA(Fuera del área del proyecto) / PRY(APA, AMA, CAN, CON)
Rhynchospora velutina	ARG(COS, ERI, MIS) / BRA(PAR) / PRY(CAN, COA, ITA, ÑEE) / URY(CLA, RNO, RIV, TAC)
Rhytachne rottboellioides	BRA(RGS, SCA)
Rhytachne subgibbosa	ARG(COS) / BRA(PAR, RGS) / PRY(AMA, CAU, ITA)
Ribes bicolor	CHL(BIO)
Ribes catamarcanum	ARG(CAT, SAL, TUC)
Ribes cucullatum	ARG(CHU, MEN, NEU, RNE, SCR, TDF) / CHL(VAL, LBO, BIO, ARA, LLA, AIS, MAG, RME)
Ribes densiflorum	ARG(CHU, NEU) / CHL(BIO, ARA, LLA)
Ribes integrifolium	CHL(BIO, ARA)
Ribes magellanicum ssp. magellanicum	ARG(RNE, SCR, TDF) / CHL(LBO, MAU, BIO, ARA, LLA, AIS, MAG, RME)
Ribes magellanicum ssp. parviflorum	ARG(CHU, NEU, RNE, SCR) / CHL(MAU, BIO, ARA, LLA, RME)
Ribes parvifolium	CHL(RME)
Ribes polyanthes	CHL(BIO, RME)
Ribes punctatum	ARG(MEN, RNE) / CHL(COQ, VAL, LBO, MAU, BIO, ARA, LLA, RME)
Ribes ruizii	CHL(VAL)
Ribes trilobum	CHL(COQ, VAL, MAU, BIO, ARA, RME)
Ribes valdivianum	ARG(NEU) / CHL(LLA)
Richardia brasiliensis	ARG(BAI, CAT, CHA, COR, COS, ERI, FOR, JUJ, MIS, SAL, SDE, SFE, TUC) / BRA(PAR, RGS, SCA) / PRY(APY, BOQ, CAU, CAA, CAN, CEN, CON, COA, GUA, ITA, ÑEE, PAI, SPE) / URY(MON, ROC)
Richardia coldenioides	ARG(COR)
Richardia grandiflora	ARG(COS, MIS, SAL) / BRA(PAR, RGS) / PRY(AMA, CAA, CON, GUA, ITA, MIE, PAI)
Richardia humistrata	ARG(BAI, COS, ERI) / BRA(PAR, RGS, SCA) / URY(ART, CAS, CLA, COL, FLA, LAV, MAL, MON, SAO, SJO, SJO)
Richardia pedicellata	BRA(PAR, SCA) / PRY(GUA, SPE)
Richardia scabra var. chacoensis	PRY(APY)
Richardia schumannii	BRA(PAR)
Richardia stellaris	ARG(BAI, CHA, COR, COS, ERI, FOR, JUJ, MIS, SAL, SDE, SFE, TUC) / BRA(RGS) / PRY(CEN, CON, COA, ÑEE, PAI) / URY(CLA, FLO, FLA, LAV, MAL, MON, SAO)
Richeria australis	BRA(PAR, SCA)
Ricinus communis	ARG(BAI, CAT, COR, COS, DFE, ERI, FOR, MIS, SAL, SFE, SJU, TUC) / BRA(PAR, RGS, SCA) / CHL(TAR, ANT, ATA, COQ, VAL, BIO, RME, JFE) / PRY(APY, CEN, COA, GUA, PAI) / URY(MON)
Riedeliella graciliflora	BRA(Fuera del área del proyecto) / PRY(AMA, CAN)
Rivina humilis	ARG(BAI, CAT, CHA, COR, COS, DFE, ERI, FOR, JUJ, LRI, MIS, SAL, SDE, SFE, SLU, TUC) / BRA(Fuera del área del proyecto) / PRY(APY, AMA, BOQ, CAN, CEN, CHO, CON, COA, GUA, ITA, ÑEE, PAI, PHA, SPE) / URY(Desconocida)
Robinia pseudoacacia	CHL(VAL, LBO, BIO, RME) / URY(CAS, MAL, MON)
Rodriguezia bracteata	BRA(PAR, SCA)
Rodriguezia decora	ARG(MIS) / BRA(PAR, RGS, SCA) / PRY(APA)
Rodriguezia pubescens	BRA(PAR)
Rodrigueziella gomezoides	BRA(PAR, RGS, SCA)
Rodrigueziella handroi	BRA(SCA)
Rodrigueziopsis eleutherosepala	BRA(PAR, SCA)
Rojasia bornmuelleri 	ARG(COS, MIS) / BRA(PAR, RGS) / PRY(MIE)
Rojasia gracilis	ARG(CHA, FOR) / PRY(APY, PHA)
Rollinia laurifolia	BRA(PAR)
Rollinia maritima	BRA(RGS, SCA) / URY(ROC)
Rollinia mucosa	BRA(PAR, RGS)
Rollinia sericea	BRA(PAR, RGS, SCA)
Rollinia sylvatica	BRA(PAR, RGS, SCA)
Romanoa tamnoides	BRA(Fuera del área del proyecto) / PRY(AMA, CAN)
Romulea rosea	CHL(VAL, MAU)
Rorippa austroamericana	ARG(CHU, MEN, NEU, RNE, SCR, SJU, TDF) / CHL(VAL, LLA, RME)
Rorippa bonariensis var. bonariensis	ARG(BAI, CHA, COR, COS, DFE, ERI, FOR, LPA, MIS, SAL, SFE) / CHL(RME) / URY(COL, FLA, MON)
Rorippa bonariensis var. chacoensis	ARG(CHA, COS, FOR, SFE) / PRY(COA)
Rorippa burkartii	ARG(COS, ERI, MIS)
Rorippa clandestina	ARG(CHA, FOR, JUJ, MIS) / PRY(APA)
Rorippa coxii	ARG(BAI, COR) / CHL(RME)
Rorippa dubia	ARG(BAI, MIS, TUC) / BRA(PAR)
Rorippa hilariana	ARG(BAI, CHA, CHU, COR, COS, DFE, ERI, FOR, JUJ, LPA, MEN, RNE, SFE, SDE, TUC) / BRA(PAR, RGS, SCA) / PRY(PHA) / URY(CAS, MON, PAY, ROC)
Rorippa mandonii	ARG(CAT, COR, JUJ, SAL, SDE, TUC) / CHL(LBO)
Rorippa nana	ARG(CAT, JUJ, SAL)
Rorippa palustris	ARG(BAI, CHA, CHU, COS, DFE, ERI, FOR, JUJ, MIS, NEU, RNE, SAL, SFE) / BRA(Fuera del área del proyecto) / CHL(BIO, ARA, LLA)
Rorippa philippiana	ARG(BAI, CHU, LPA, MEN, NEU, RNE, SJU, SLU, SCR, TDF) / CHL(COQ, VAL, MAU, BIO, ARA, LLA, AIS, RME)
Rorippa sylvestris	ARG(CHU) / CHL(MAU, BIO, ARA, LLA, RME)
Rosa canina	ARG(NEU, RNE) / CHL(MAU, BIO, LLA, RME)
Rosa micrantha	ARG(RNE, TDF)
Rosa multiflora	ARG(NEU, RNE)
Rosa rubiginosa	ARG(CHU, LPA, NEU, RNE) / CHL(ARA)
Rosa sicula	ARG(CHU, MEN)
Rosenbergiodendron longiflorum	BRA(PAR)
Rostkovia magellanica	ARG(CHU, SCR, TDF) / CHL(LLA, AIS, MAG)
Rostraria cristata	ARG(BAI, COS, DFE, ERI, LPA, SJU, SFE, TUC) / BRA(RGS) / CHL(TAR, COQ, VAL, LBO, MAU, MAG, RME) / URY(MAL)
Rostraria trachyantha	CHL(TAR, ANT, ATA, COQ, VAL)
Rotala mexicana	ARG(COS, FOR, MIS) / BRA(Fuera del área del proyecto) / PRY(CON, COA, PHA)
Rotala ramosior	ARG(COS, FOR) / BRA(Fuera del área del proyecto) / PRY(APY, COA)
Rottboellia cochinchinensis	ARG(JUJ)
Roupala asplenioides	BRA(RGS, SCA)
Roupala consimilis	BRA(PAR, SCA)
Roupala meisneri	ARG(JUJ, MIS, SAL) / BRA(PAR, RGS, SCA) / PRY(APA, CAU, CAN, GUA)
Roupala montana var. brasiliensis	ARG(MIS, SAL) / BRA(PAR, RGS, SCA)
Roupala montana var. montana	BRA(PAR, RGS, SCA) / PRY(APA)
Roupala montana var. paraensis	BRA(PAR, SCA)
Roupala pallida	BRA(SCA)
Rourea gracilis	BRA(PAR, SCA)
Rubia tinctorum	ARG(MEN) / CHL(RME)
Rubus brasiliensis	ARG(MIS) / BRA(PAR, RGS, SCA)
Rubus caesius	ARG(ERI)
Rubus constrictus	CHL(COQ, BIO, ARA, LLA)
Rubus erythroclados	ARG(MIS) / BRA(PAR, RGS, SCA)
Rubus flagellaris	ARG(COR)
Rubus geoides	ARG(NEU, RNE, SCR, TDF) / CHL(BIO, ARA, LLA, AIS, MAG, JFE)
Rubus hassleri	PRY(CAA)
Rubus imperialis	ARG(CAT, COR, JUJ, MIS, SAL, TUC) / BRA(PAR, RGS, SCA)
Rubus nitidus	ARG(BAI, JUJ)
Rubus paraguariensis	PRY(CAA, SPE)
Rubus phoenicolasius	ARG(COR)
Rubus radicans	ARG(NEU) / CHL(ARA, LLA, AIS, MAG)
Rubus rosaefolius var. rosaefolius	BRA(PAR, RGS, SCA)
Rubus rosaefolius var. coronarius	BRA(PAR, RGS, SCA)
Rubus rosifolius	ARG(MIS, TUC) / BRA(PAR, RGS, SCA)
Rubus schottii	ARG(MIS)
Rubus sellowii	ARG(COS, MIS) / BRA(RGS, SCA) / PRY(CAA, ITA)
Rubus ulmifolius	ARG(BAI, ERI, LPA, MIS, NEU, RNE, SJU) / BRA(SCA) / CHL(COQ, VAL, LBO, MAU, BIO, ARA, LLA, RME, JFE) / URY(LAV)
Rubus urticifolius	ARG(COS, MIS, SAL) / BRA(PAR, RGS, SCA) / PRY(GUA, PAI)
Rudgea coriacea	BRA(PAR, SCA)
Rudgea coronata	BRA(PAR)
Rudgea gardenioides	BRA(PAR, SCA)
Rudgea jasminoides ssp. jasminoides	ARG(MIS) / BRA(PAR, RGS, SCA) / PRY(APA, AMA, CAN, COA, PAI, SPE)
Rudgea jasminoides ssp. corniculata	BRA(PAR, SCA)
Rudgea myrsinifolia	BRA(PAR)
Rudgea parquioides ssp. parquioides	ARG(MIS) / BRA(PAR, RGS, SCA) / PRY(APA, CAA, ITA)
Rudgea parquioides ssp. caprifolium	BRA(SCA)
Rudgea parquioides ssp. hirsutissima	BRA(PAR, SCA)
Rudgea recurva	BRA(PAR, SCA)
Rudolfiella lindmaniana	BRA(PAR)
Ruellia angustiflora	ARG(COS, ERI, FOR, MIS) / BRA(PAR, RGS, SCA) / PRY(APA, AMA, CAU, CAA, CAN, CEN, CON, COA, GUA, ITA, MIE, ÑEE, PAI, SPE) / URY(ART, RIV)
Ruellia bahiensis	BRA(RGS)
Ruellia brachysiphon	ARG(COS, MIS) / BRA(PAR, RGS) / PRY(APA, CAU, CAN)
Ruellia brevicaulis	ARG(COS, MIS) / BRA(PAR, RGS, SCA) / PRY(APA, AMA, CAU, CAA, CAN, COA, MIE)
Ruellia brevifolia	ARG(ERI, JUJ, MIS, SAL, SFE, TUC) / BRA(PAR, RGS, SCA) / PRY(APA, CAA, CAN, ÑEE, SPE)
Ruellia bulbifera	ARG(COS, MIS) / BRA(PAR, RGS, SCA) / PRY(APY, BOQ, CAU, CAA, CEN, CON, COA, GUA, ITA, MIE, ÑEE, PAI, PHA, SPE)
Ruellia ciliatiflora	ARG(CAT, CHA, COR, COS, FOR, JUJ, LRI, SAL, SDE, TUC) / PRY(APY, AMA, CAN, CON, PHA)
Ruellia elegans	BRA(PAR)
Ruellia epallocaulos	ARG(MIS) / BRA(PAR) / PRY(APA)
Ruellia erythropus	ARG(CAT, CHA, COS, ERI, FOR, JUJ, MIS, SAL, SFE, TUC) / BRA(PAR, RGS, SCA) / PRY(APY, CAN, CEN, CON, COA, ITA, PAI, PHA, SPE)
Ruellia filicalyx	ARG(FOR, JUJ, SAL) / PRY(APY)
Ruellia geminiflora	ARG(CHA, COS, FOR, MIS, SFE) / BRA(PAR, RGS, SCA) / PRY(AMA, CAU, CAA, CAN, CEN, CON, COA, GUA, ITA, MIE, ÑEE, PAI, PHA, SPE)
Ruellia hygrophila	ARG(CHA, COS, FOR, MIS, SAL, SDE, SFE) / BRA(Fuera del área del proyecto) / PRY(APY, AMA, CEN, CON, COA, GUA, PAI, PHA, SPE) / URY(ART)
Ruellia hypericoides	ARG(COS, MIS) / BRA(RGS) / PRY(MIE) / URY(ART)
Ruellia kleinii	BRA(SCA)
Ruellia longipedunculata	ARG(JUJ, SAL)
Ruellia macrosolen	ARG(CHA, FOR, JUJ, SAL, SDE, TUC) / PRY(APY, AMA, PHA)
Ruellia magniflora	ARG(COS) / BRA(Fuera del área del proyecto) / PRY(AMA, CAN, CEN, CON, COA, MIE)
Ruellia morongii	ARG(COS, ERI, MIS, SAL, SFE) / BRA(RGS) / PRY(CEN, CON, PAI, SPE) / URY(ART, PAY, SAO, TAC)
Ruellia multifolia var. multifolia	ARG(MIS) / BRA(PAR, RGS, SCA) / PRY(APA, AMA, CAU, CAA, CAN, CON, COA, GUA, PAI, SPE)
Ruellia multifolia var. viscosissima	ARG(COS, MIS) / BRA(RGS, SCA) / PRY(APA, CAU, CAA, CON, COA)
Ruellia nobilis	BRA(Fuera del área del proyecto) / PRY(APY, CON)
Ruellia reitzii	BRA(SCA)
Ruellia sanguinea	ARG(JUJ, MIS, SAL, SFE) / BRA(RGS)
Ruellia simplex	ARG(CHA, COR, COS, ERI, FOR, JUJ, MIS, SAL, SDE, SFE, TUC) / BRA(RGS) / PRY(APY, AMA, CAN, CEN, CON, COA, GUA, MIE, ÑEE, PAI, PHA, SPE) / URY(ART, CAS, FLA, MON, RIV, TAC, TYT)
Ruellia solitaria	BRA(PAR)
Ruellia woolstonii	PRY(CAN, CON, SPE)
Rugoloa hylaeica	ARG(CHA, COS, FOR, MIS) / BRA(PAR) / PRY(CEN, CON, COA, ÑEE, PHA) / URY(ART, SAO, SJO)
Rugoloa pilosa	ARG(COS, MIS) / BRA(PAR, RGS, SCA) / PRY(APA, AMA, CAU, CAA, CAN, GUA, PAI)
Rugoloa polygonata	ARG(MIS) / BRA(PAR, RGS, SCA) / PRY(APA, CAU, CAN, CEN, COA, GUA, PAI, SPE)
Rumex acetosa	ARG(BAI, CHU, NEU, RNE, TDF) / CHL(MAG)
Rumex acetosella	ARG(BAI, CHA, COR, JUJ, MEN, NEU, RNE, SCR, SFE, SJU, TDF, TUC) / CHL(TAR, ANT, COQ, VAL, LBO, MAU, BIO, ARA, LLA, AIS, MAG, RME, JFE) / URY(DUR)
Rumex aquaticiformis	CHL(AIS)
Rumex argentinus	ARG(BAI, COS, ERI, FOR, MEN, SFE) / PRY(CEN) / URY(CAS, CLA, MAL, MON, SJO, SOR)
Rumex brasiliensis	ARG(COS) / BRA(RGS, SCA)
Rumex conglomeratus var. vulgaris	ARG(BAI, CAT, ERI, JUJ, LRI, MEN, SAL, SJU, SLU, SCR, SFE, TUC) / CHL(ATA, COQ, VAL, LBO, MAU, BIO, ARA, LLA, AIS, RME, JFE) / URY(CLA, MAL, MON, PAY, RNO, SOR)
Rumex conglomeratus var. borreri	ARG(ERI)
Rumex crispissimus	ARG(CHU, MEN, SCR, SJU, TDF) / CHL(VAL, MAG)
Rumex crispus	ARG(BAI, CAT, CHU, COR, COS, ERI, JUJ, LRI, MEN, MIS, NEU, RNE, SJU, SLU, SCR, SFE, TDF, TUC) / BRA(RGS) / CHL(ANT, ATA, COQ, VAL, LBO, MAU, BIO, ARA, LLA, AIS, MAG, RME, JFE, IPA) / URY(CAS, CLA, FLA, MON, PAY, RNO, ROC, SAO, SOR, TAC)
Rumex cristatus	CHL(RME)
Rumex cuneifolius	ARG(BAI, CAT, CHU, COR, JUJ, NEU, RNE, SAL, SFE, SLU) / BRA(RGS) / CHL(ATA, VAL, BIO, ARA, LLA, AIS, RME) / URY(MON, ROC)
Rumex darwinianus	ARG(CHU, NEU, SCR) / CHL(LLA)
Rumex longifolius	ARG(TDF) / CHL(LBO, MAU, ARA, LLA, MAG, RME)
Rumex lorentzianus	ARG(CAT, SAL, TUC)
Rumex magellanicus	ARG(CHU, MEN, NEU, SCR, SJU, TDF) / CHL(COQ, BIO, AIS, MAG)
Rumex maricola	CHL(COQ, VAL, LBO, MAU, BIO, ARA, LLA, AIS, RME)
Rumex maritimus	ARG(BAI, CHU, NEU, RNE, SCR, TDF) / CHL(MAG)
Rumex obovatus	ARG(BAI, COS, ERI, FOR, MIS, SFE, TUC) / PRY(CEN, GUA, PHA)
Rumex obtusifolius	ARG(BAI, CAT, CHU, COR, JUJ, LRI, MEN, MIS, NEU, RNE, SCR, SFE, SJU, SLU, TDF, TUC) / BRA(PAR, RGS) / CHL(LBO, BIO, ARA, LLA, AIS, RME)
Rumex paraguayensis	ARG(BAI, CHA, CHU, COS, ERI, FOR, SFE, TUC) / PRY(APY, CEN, COA, PHA)
Rumex patagonicus	CHL(ARA, LLA, AIS)
Rumex polycarpus	ARG(ERI)
Rumex pulcher	ARG(BAI, CAT, COR, COS, ERI, RNE, SDE, SFE, TUC) / CHL(COQ, VAL, LBO, MAU, BIO, LLA, RME, JFE) / PRY(APA, CEN, COA, MIE) / URY(CAS, CLA, FLO, FLA, MON, PAY, RNO, SAO)
Rumex romassa	ARG(NEU, RNE, SAL) / CHL(ARA, LLA)
Rumex sanguineus	CHL(ARA)
Rumex sellowianus	BRA(PAR)
Rumex uruguayensis	URY(FLA)
Rumohra adiantiformis	ARG(BAI, CHU, COS, ERI, NEU, RNE, SCR, TDF) / BRA(PAR, RGS, SCA) / CHL(COQ, BIO, ARA, LLA, AIS, MAG) / URY(FLA, MAL, ROC)
Rumohra berteroana	CHL(JFE)
Rumohra quadrangularis	BRA(PAR, RGS, SCA)
Ruppia cirrhosa	ARG(CAT, COR, COS, LPA, SLU)
Ruppia filifolia	ARG(CAT, JUJ, NEU, SAL, SCR, SJU, TDF, TUC) / CHL(TAR, ANT, ATA, MAG)
Ruppia maritima var. maritima	ARG(BAI, COR, COS, FOR, JUJ, LPA, LRI, MIS, SDE, SJU) / BRA(RGS, SCA) / CHL(ANT, ATA, COQ, VAL, ARA) / PRY(APY)
Ruppia maritima var. longipes	ARG(COR)
Ruprechtia apetala	ARG(CAT, CHA, COR, FOR, JUJ, LRI, SAL, SDE, SFE, SLU, TUC) / PRY(APY)
Ruprechtia brachysepala	ARG(CHA, COS, FOR, MIS) / BRA(Fuera del área del proyecto) / PRY(CEN, COA, PAI)
Ruprechtia exploraticis	BRA(Fuera del área del proyecto) / PRY(APY, CON)
Ruprechtia laxiflora	ARG(CAT, CHA, COR, COS, ERI, FOR, JUJ, MIS, SAL, SDE, SFE, TUC) / BRA(PAR, RGS, SCA) / PRY(APA, CAA, CAN, CEN, CON, COA, GUA, ITA, MIE, ÑEE, PAI, PHA, SPE) / URY(ART, DUR, PAY, RIV, SAO, SOR)
Ruprechtia paranensis	BRA(PAR, SCA)
Ruprechtia salicifolia	ARG(COS, ERI, MIS) / BRA(RGS) / URY(ART, DUR, PAY, SAO, SOR, TAC)
Ruta chalepensis	ARG(BAI, COR, ERI, LPA, MEN, SAL, SJU, SLU, SFE) / CHL(ANT, COQ, VAL, LBO, MAU, BIO, ARA, RME, JFE)
Rytidosperma lechleri	ARG(CHU, MEN, NEU, RNE) / CHL(COQ, VAL, MAU, BIO, ARA, LLA, MAG, RME)
Rytidosperma pictum var. bimucronata	ARG(NEU) / CHL(BIO)
Rytidosperma pictum var. pictum	ARG(COR, MEN, NEU, RNE) / CHL(COQ, VAL, LBO, MAU, BIO, ARA, LLA, AIS, MAG, RME)
Rytidosperma quirihuense	CHL(BIO)
Rytidosperma sorianoi	ARG(CHU, RNE)
Rytidosperma violaceum	ARG(CHU, NEU, RNE) / CHL(VAL, LBO, MAU, BIO, ARA, RME)
Rytidosperma virescens var. parvispiculum	ARG(NEU, RNE, SCR, TDF)
Rytidosperma virescens var. virescens	ARG(CHU, MEN, NEU, RNE, SCR, TDF) / CHL(COQ, VAL, LBO, MAU, BIO, ARA, LLA, AIS, MAG, RME)
