Xanthium ambrosioides	ARG(BAI, CAT, COR, LPA, MEN, NEU, RNE, SLU)
Xanthium argenteum	CHL(MAU, RME)
Xanthium spinosum var. spinosum	ARG(BAI, CAT, CHA, CHU, COR, COS, ERI, FOR, JUJ, LPA, LRI, MEN, NEU, RNE, SAL, SCR, SDE, SFE, SJU, SLU, TUC) / BRA(RGS, SCA) / CHL(ANT, ATA, COQ, VAL, MAU, BIO, ARA, RME, JFE) / PRY(APY, CEN, PAI) / URY(CAS, FLA, MAL, MON, PAY, RNO, SJO, SOR)
Xanthium spinosum var. pseudinerme	ARG(COR, DFE)
Xanthium strumarium	ARG(BAI, CAT, CHA, COR, COS, ERI, FOR, LPA, LRI, MEN, MIS, NEU, RNE, SAL, SJU, SFE) / BRA(PAR, RGS, SCA) / CHL(ATA, COQ, MAU, BIO, RME) / PRY(CEN, PAI) / URY(CAS, CLA, MON, PAY, RNO, SJO)
Xanthosoma sagittifolium	BRA(PAR, SCA)
Xanthosoma striatipes	BRA(Fuera del área del proyecto) / PRY(APA, CAU, CAA, CAN, CEN, COA, GUA, PAI, SPE)
Xanthosoma syngoniifolia	ARG(SAL)
Xanthosoma violaceum	PRY(APA)
Xenophyllum ciliolatum	CHL(TAR)
Xenophyllum incisum var. incisum	ARG(CAT, JUJ, SAL) / CHL(TAR, ANT)
Xenophyllum incisum var. pubescens	ARG(CAT, LRI, SAL)
Xenophyllum poposum	ARG(CAT, JUJ, SAL, TUC) / CHL(TAR, ANT)
Xenophyllum pseudodigitatum	ARG(JUJ, SAL) / CHL(TAR, ANT)
Xenophyllum rosenii	ARG(JUJ)
Xenophyllum weddellii	CHL(TAR, ANT)
Xerochrysum bracteatum 	BRA(RGS)
Xerodraba colobanthoides	ARG(CHU)
Xerodraba glebaria	ARG(CHU, SCR)
Xerodraba lycopodioides	ARG(SCR) / CHL(MAG)
Xerodraba monantha	ARG(SCR)
Xerodraba patagonica	ARG(CHU, SCR) / CHL(MAG)
Xerodraba patagonica ssp. pycnophylloides	ARG(CHU, SCR)
Ximenia americana var. americana	ARG(CAT, CHA, COR, COS, FOR, JUJ, LRI, MEN, SAL, SDE, SFE, SJU, SLU, TUC) / BRA(PAR, SCA)
Ximenia americana var. argentiniensis	ARG(BAI, CAT, COS, ERI, JUJ, LRI, MEN, SAL, SDE, SFE, SJU, SLU, TUC) / PRY(APY, PHA)
Ximenia intermedia	BRA(Fuera del área del proyecto) / PRY(AMA)
Xylobium colleyi	BRA(PAR, RGS, SCA)
Xylobium dusenii	BRA(PAR)
Xylobium variegatum	BRA(PAR, SCA)
Xylophragma myrianthum	BRA(PAR)
Xylophragma pratense	BRA(PAR) / PRY(AMA)
Xylopia aromatica	BRA(PAR) / PRY(AMA, CAN, CON, PHA, SPE)
Xylopia brasiliensis	ARG(MIS) / BRA(PAR, RGS, SCA) / PRY(APA, AMA, CAU, CAN, PAI)
Xylopia langsdorfiana	BRA(PAR)
Xylosma ciliatifolia	BRA(PAR, RGS, SCA) / PRY(APA)
Xylosma glaberrima	BRA(PAR)
Xylosma longipetiolata	ARG(JUJ, SAL)
Xylosma prockia	BRA(PAR, SCA)
Xylosma pseudosalzmanii	ARG(MIS) / BRA(PAR, RGS, SCA) / URY(CLA)
Xylosma pubescens	ARG(CAT, JUJ, MIS, SAL, TUC)
Xylosma schroederi	URY(ART, CLA, RIV, SJO, TAC, TYT)
Xylosma tweediana	ARG(CHA, COS, ERI, MIS) / BRA(RGS, SCA) / URY(ART, CAS, CLA, COL, DUR, FLO, FLA, LAV, MAL, MON, PAY, RNO, RIV, ROC, SAO, SJO, SOR, TAC, TYT)
Xylosma venosa	ARG(CHA, COS, ERI, FOR, MIS, SFE) / BRA(PAR, RGS) / PRY(APY, APA, AMA, CAA, CAN, CEN, CON, COA, GUA, ITA, MIE, ÑEE, PAI, PHA, SPE) / URY(ART, CLA, DUR, RIV, TYT)
Xyris asperula	BRA(PAR)
Xyris capensis	BRA(PAR, RGS, SCA)
Xyris dissitifolia	BRA(PAR)
Xyris filifolia	BRA(PAR, RGS, SCA)
Xyris guaranitica	ARG(COS) / BRA(PAR, RGS, SCA) / PRY(AMA, COA, ITA, MIE, PAI, SPE)
Xyris hatschbachii	BRA(PAR)
Xyris hymenachne	BRA(PAR, RGS, SCA)
Xyris jupicai	ARG(CHA, COS, ERI, FOR, MIS) / BRA(PAR, RGS, SCA) / PRY(AMA, CAU, CAA, CAN, CON, COA, GUA, MIE, ÑEE, PAI) / URY(CAS, CLA, MAL, MON, RIV, ROC, TAC)
Xyris lacerata	ARG(MIS) / BRA(Fuera del área del proyecto)
Xyris laxifolia	ARG(CHA, COS, ERI, MIS) / BRA(PAR, RGS, SCA) / PRY(AMA, CAA, CAN, CEN, COA, GUA, PAI, SPE) / URY(CAS)
Xyris lucida	BRA(PAR, SCA)
Xyris neglecta	BRA(PAR, SCA)
Xyris piraquarae	BRA(PAR)
Xyris regnellii	ARG(COS, MIS) / BRA(PAR, RGS, SCA) / PRY(APA, CAA, CAN) / URY(RIV, TAC)
Xyris reitzii	BRA(PAR, SCA)
Xyris rigida	BRA(PAR, RGS, SCA)
Xyris savanensis	ARG(COS, MIS) / BRA(PAR, RGS, SCA) / PRY(CAN, COA, PAI, SPE)
Xyris schizachne	ARG(COS, MIS) / BRA(PAR, RGS, SCA) / PRY(AMA, CAU, CAN, COA)
Xyris sororia	BRA(PAR, SCA)
Xyris stenophylla	BRA(PAR, RGS, SCA)
Xyris tenella	BRA(PAR) / PRY(AMA, CAU, CAN, SPE)
Xyris teres	BRA(PAR, RGS, SCA)
Xyris tortula	BRA(PAR, RGS, SCA) / PRY(CAU)
Xyris vacillans	BRA(PAR, RGS, SCA)
 	
