Gaga marginata	ARG(CAT, COR, JUJ, LRI, SAL, SDE, TUC)
Gaillardia aristata	ARG(BAI) / BRA(SCA) / CHL(TAR)
Gaillardia cabrerae	ARG(LPA)
Gaillardia megapotamica var. megapotamica	ARG(BAI, CAT, COR, COS, ERI, LPA, MEN, NEU, RNE, SFE, SLU) / BRA(RGS) / URY(RNO, SOR)
Gaillardia megapotamica var. radiata	ARG(BAI, CAT, CHA, COR, COS, ERI, LPA, LRI, SAL, SJU, SLU, SFE, SDE, TUC) / URY(MON)
Gaillardia megapotamica var. scabiosoides	ARG(BAI, CAT, COR, COS, ERI, LPA, LRI, MEN, NEU, RNE, SAL, SJU, SLU, SFE, SDE, TUC) / URY(RNO)
Gaillardia tontalensis	ARG(MEN, SJU)
Gaimardia australis	ARG(SCR, TDF) / CHL(LLA, AIS, MAG)
Galactia australis	ARG(COS, MIS) / BRA(PAR, RGS, SCA) / PRY(CAU) / URY(CLA, LAV, MAL, PAY, RIV, TAC, TYT)
Galactia benthamiana	ARG(CHA, COR, COS, ERI, FOR, MIS, SDE, SFE) / BRA(PAR, RGS, SCA) / PRY(AMA, CAA, COA, GUA, PAI) / URY(RNO, RIV, SAO, SJO, SOR, TAC)
Galactia boavista	ARG(COS, MIS) / BRA(PAR, SCA) / PRY(AMA, CAN)
Galactia burkartii	PRY(AMA, CAA)
Galactia dimorphophylla	ARG(COS, MIS) / BRA(RGS) / URY(RIV, TAC)
Galactia dubia	ARG(JUJ, SAL) / BRA(Fuera del área del proyecto) / PRY(APY)
Galactia eriosematoides	BRA(Fuera del área del proyecto) / PRY(AMA) / URY(RIV, TAC)
Galactia fiebrigiana var. corrrentina	ARG(COS, ERI)
Galactia fiebrigiana var. fiebrigiana	ARG(SAL, TUC)
Galactia fiebrigiana var. sericophylla	ARG(SAL)
Galactia glaucescens	BRA(Fuera del área del proyecto) / PRY(AMA, CON, ITA)
Galactia glaucophylla	ARG(COR, SDE, SFE, SLU)
Galactia gracillima	ARG(COS, ERI, MIS) / BRA(PAR, RGS, SCA) / PRY(PAI) / URY(CLA, FLA, MON, PAY, TAC)
Galactia grewiaefolia	BRA(Fuera del área del proyecto) / PRY(AMA, CON, SPE)
Galactia latisiliqua	ARG(CAT, CHA, COR, COS, ERI, FOR, JUJ, SAL, SFE, SDE, TUC) / BRA(PAR, RGS) / PRY(APY, CEN, CON, PHA) / URY(ART, PAY, RNO, RIV, SAO, SJO)
Galactia longifolia	ARG(CHA, ERI, FOR, SDE, SFE) / PRY(APY, BOQ, CON, PHA)
Galactia marginalis	ARG(BAI, CAT, CHA, COR, COS, ERI, FOR, LPA, MEN, MIS, SAL, SDE, SFE, SLU, TUC) / BRA(PAR, RGS, SCA) / PRY(ÑEE, PAI) / URY(CAS, CLA, COL, DUR, FLO, FLA, MAL, MON, PAY, RNO, RIV, ROC, SAO, SJO, TAC, TYT)
Galactia marginalis var. colombiana	BRA(RGS) / URY(CLA, LAV, ROC)
Galactia martioides	ARG(MIS) / BRA(RGS) / URY(RIV)
Galactia neesii	ARG(MIS) / BRA(PAR, SCA) / PRY(AMA, CAN, COA, MIE, PAI)
Galactia pretiosa	ARG(MIS) / BRA(PAR, RGS, SCA) / PRY(CAN, GUA) / URY(RIV, SJO)
Galactia pretiosa var. trifoliolata	BRA(PAR) / PRY(COA, SPE)
Galactia striata var. striata	ARG(CHA, COS, ERI, JUJ, MIS, SAL, SFE, TUC) / BRA(PAR) / PRY(APA, APY, AMA, CEN, COA, GUA, PAI, SPE) / URY(ART, PAY, RIV, SAO)
Galactia striata var. crassirachis	ARG(TUC)
Galactia texana var. texana	ARG(CAT, COR, LRI, SAL, SDE, SFE, SLU, TUC)
Galactia texana var. degasperii	ARG(CHA, FOR)
Galeandra beyrichii	ARG(COS, JUJ, MIS, SAL) / BRA(PAR, RGS, SCA) / PRY(COA, PAI, SPE) / URY(ART, RIV)
Galeandra junceoides	BRA(PAR) / PRY(CON)
Galeandra paraguayensis	BRA(PAR) / PRY(CAN)
Galeandra stylomisantha	BRA(PAR, RGS, SCA) / PRY(AMA, CAN, CON, ÑEE, PHA)
Galeandra xerophila	ARG(SAL, TUC)
Galega officinalis	ARG(BAI, COR, ERI, MEN, NEU, RNE) / CHL(VAL, RME) / URY(CAS, FLA, MON)
Galenia pubescens	CHL(COQ)
Galeopsis tetrahit	CHL(LLA)
Galianthe aurelii	PRY(AMA, CEN, COA, GUA, PAI)
Galianthe bisepala	ARG(SAL)
Galianthe brasiliensis	ARG(BAI, COS, ERI, MIS) / BRA(PAR, RGS, SCA) / PRY(APA, ITA, ÑEE) / URY(RNO)
Galianthe canindeyuensis	PRY(AMA, CAU, CAN, SPE)
Galianthe centranthoides	ARG(COS, ERI, FOR, MIS, SFE) / BRA(PAR, RGS, SCA) / PRY(APY, AMA, CAU, CAA, COA, GUA, ITA, MIE, PAI, SPE) / URY(ART, COL, FLA, LAV, MAL, RIV)
Galianthe chodatiana	BRA(PAR, SCA) / PRY(CAN)
Galianthe cymosa	BRA(PAR, SCA)
Galianthe cyperoides	PRY(CAU, CAN, GUA, SPE)
Galianthe dichasia	ARG(MIS) / BRA(PAR, RGS, SCA) / PRY(APA, GUA, SPE) / URY(RIV)
Galianthe elegans	BRA(PAR)
Galianthe equisetoides	ARG(COS) / BRA(PAR, RGS)
Galianthe eupatorioides	ARG(COS, MIS) / BRA(PAR, SCA) / PRY(APA, APY, AMA, BOQ, CAU, CEN, CHO, CON, GUA, ITA, MIE, NAS) / URY(ROC)
Galianthe fastigiata	ARG(COS, ERI, MIS) / BRA(RGS, SCA) / PRY(APA, AMA, CAU, CAA, COA, MIE, PAI) / URY(CAS, CLA, FLA, LAV, MAL, RIV, ROC, TAC, TYT)
Galianthe gertii	BRA(PAR, SCA)
Galianthe guaranitica	BRA(Fuera del área del proyecto) / PRY(AMA, CAN)
Galianthe hassleriana	PRY(SPE)
Galianthe hispidula	ARG(COS, MIS) / BRA(PAR, RGS, SCA) / PRY(APA)
Galianthe krausei	PRY(COA, PAI)
Galianthe latistipula	BRA(RGS, SCA)
Galianthe laxa ssp. laxa	ARG(BAI, COS, ERI, MIS, SAL) / BRA(PAR, RGS, SCA) / PRY(APA, AMA, CAU, CAA, CAN, CEN, CON, GUA) / URY(COL, CLA, MON, SJO, SJO)
Galianthe laxa ssp. paraguariensis	PRY(APY, AMA, CEN, COA, PAI, PHA)
Galianthe linearifolia	ARG(MIS) / PRY(APA)
Galianthe longifolia	BRA(PAR)
Galianthe montesii	ARG(MIS) / PRY(APA)
Galianthe parvula	BRA(Fuera del área del proyecto) / PRY(AMA, SPE)
Galianthe pseudopeciolata	BRA(PAR) / PRY(AMA, CAU)
Galianthe reitzii	BRA(SCA)
Galianthe thalictroides	ARG(COS, MIS) / BRA(PAR, RGS, SCA) / PRY(AMA, CAU) / URY(Desconocida)
Galianthe valerianoides	ARG(COS, MIS) / BRA(PAR, RGS, SCA) / PRY(APA, AMA, CAU, CAA, CAN, CEN, COA)
Galianthe verbenoides	BRA(PAR, RGS, SCA)
Galinsoga mandonii	ARG(CAT, JUJ, LRI, SAL, SFE, TUC)
Galinsoga parviflora	ARG(BAI, CAT, CHA, COR, COS, DFE, ERI, FOR, JUJ, LPA, LRI, MEN, MIS, NEU, RNE, SAL, SDE, SFE, SJU, SLU, TUC) / BRA(PAR, RGS, SCA) / CHL(TAR, ANT, ATA, COQ, VAL, LBO, MAU, BIO, ARA, LLA, RME, JFE, IPA) / PRY(CEN, GUA)
Galinsoga quadriradiata	ARG(CAT, COR, JUJ, SAL, TUC) / BRA(RGS, SCA)
Galium antarcticum	ARG(SCR, TDF) / CHL(AIS, MAG)
Galium aparine	ARG(BAI, CHU, ERI, JUJ, MEN, NEU, RNE, SAL, SCR, SFE, SJU, TDF, TUC) / CHL(TAR, ANT, ATA, COQ, VAL, LBO, MAU, BIO, ARA, LLA, AIS, MAG, RME, JFE) / URY(CAS, MON)
Galium araucanum	CHL(COQ, VAL, LBO, MAU, BIO, ARA, LLA, AIS, MAG, RME)
Galium arequipicum	CHL(TAR)
Galium atherodes	ARG(MIS, SFE) / BRA(RGS, SCA) / PRY(COA, GUA, PAI) / URY(RIV)
Galium bigeminum	ARG(BAI, COR, COS, ERI, SLU) / BRA(RGS, SCA) / URY(ART, CAS, COL, DUR, MAL, MON, PAY, RNO, SAO, SJO, SOR)
Galium comberi	ARG(NEU)
Galium corymbosum	ARG(CAT, JUJ, SAL, TUC) / CHL(TAR, ANT, COQ)
Galium cotinoides	CHL(MAU, BIO)
Galium diffusoramosum	CHL(ANT, ATA, COQ, MAU)
Galium divaricatum	
Galium equisetoides	ARG(COS) / BRA(PAR, RGS, SCA) / PRY(CAU, CEN, COA, GUA, SPE) / URY(Desconocida)
Galium ericoides	BRA(RGS) / URY(CAS, CLA, COL, FLA, LAV, MAL, MON, RIV, ROC, SOR)
Galium eriocarpum	ARG(MEN, NEU) / CHL(COQ, VAL, LBO, MAU, BIO, RME)
Galium fuegianum	ARG(CHU, LPA, NEU, RNE, SCR, TDF) / CHL(LBO, MAU, BIO, ARA, AIS, MAG)
Galium gilliesii ssp. gilliesii	ARG(MEN, SJU) / CHL(ATA, COQ, VAL, LBO, RME)
Galium gilliesii ssp. telanthos	ARG(MEN, NEU) / CHL(COQ, LBO, MAU, RME)
Galium gracilicaule	ARG(JUJ, TUC)
Galium hatschbachii	BRA(PAR, SCA)
Galium hirtum	ARG(BAI, COS, ERI, MIS) / BRA(RGS, SCA) / URY(CLA, FLO, LAV, MAL, MON, RIV, ROC, SOR, TYT)
Galium humile	ARG(COS, ERI) / BRA(PAR, RGS, SCA) / PRY(CAU, COA, ITA, MIE, PAI) / URY(SJO)
Galium hypocarpium ssp. alluviale	ARG(BAI, ERI, SFE)
Galium hypocarpium ssp. hypocarpium	ARG(BAI, CAT, CHU, COR, COS, DFE, ERI, JUJ, MIS, NEU, RNE, SAL, TUC) / BRA(PAR, RGS, SCA) / CHL(ANT, COQ, VAL, LBO, MAU, BIO, ARA, LLA, AIS, RME) / PRY(APA, CAA, CEN, COA, GUA, ÑEE, PAI) / URY(ART, CLA, MAL, MON, RIV, ROC, TYT)
Galium inconspicuum	ARG(MEN, NEU) / CHL(MAU, BIO, ARA)
Galium latoramosum	ARG(BAI, COR, COS, ERI, JUJ, MIS, SFE, SLU, TUC) / BRA(RGS, SCA) / PRY(APA, GUA) / URY(CAS, COL, DUR, FLA, LAV, MAL, MON, RNO, SJO, SOR)
Galium leptum	CHL(COQ, RME)
Galium lilloi	ARG(CAT, JUJ, SAL, SDE, TUC)
Galium magellanicum	ARG(CHU, NEU, RNE, SCR) / CHL(VAL, MAU, BIO, ARA, LLA, AIS, MAG)
Galium masafueranum	CHL(JFE)
Galium megapotamicum	ARG(BAI, COS, MIS) / BRA(PAR, RGS, SCA) / PRY(APA, AMA, CAU, CAA, CAN, COA, GUA, ÑEE, PAI, SPE) / URY(MON)
Galium mollugo	ARG(BAI, DFE, NEU) / URY(RIV)
Galium muelleri	BRA(PAR, RGS, SCA)
Galium murale	CHL(COQ, VAL, LBO, MAU, BIO, RME)
Galium nigroramosum	ARG(CAT, COS, MIS, TUC) / BRA(PAR, RGS, SCA) / PRY(AMA, CAA, ITA, SPE) / URY(DUR)
Galium noxium ssp. valantioides	ARG(BAI, CHA, COS, ERI, FOR, MIS) / BRA(PAR, RGS, SCA) / PRY(CAU, CAN, CEN, CON, COA, GUA, ITA, MIE, PAI, PHA, SPE) / URY(CLA, FLA, MAL, MON, PAY, RNO, RIV, ROC, SAO, SJO)
Galium noxium ssp. noxium	BRA(PAR, RGS)
Galium ostenianum	BRA(RGS) / URY(CLA, TYT)
Galium ovalleanum	CHL(COQ)
Galium palustre	ARG(BAI, RNE)
Galium parisiense	CHL(RME)
Galium philippianum	CHL(COQ, VAL, LBO, RME)
Galium plumosum ssp. flossdorfii	ARG(JUJ, LRI, SAL, TUC)
Galium ramboi	BRA(SCA)
Galium richardianum ssp. richardianum	ARG(BAI, CAT, CHA, CHU, COR, COS, DFE, ERI, JUJ, MEN, MIS, NEU, RNE, SAL, SJU, SLU, SCR, SFE, SDE, TDF, TUC) / BRA(RGS, SCA) / PRY(CAU, ÑEE) / URY(COL, MON, SJO)
Galium richardianum ssp. haenkeanum	ARG(MEN)
Galium richardianum ssp. pusillum	ARG(CAT, COR, JUJ, LRI, MEN, SAL, SLU, TUC)
Galium rubidiflorum	BRA(PAR)
Galium saxatile	ARG(TDF)
Galium sellowianum	BRA(PAR, SCA)
Galium smithreitzii	BRA(SCA)
Galium suffruticosum	ARG(MEN, NEU) / CHL(ATA, COQ, VAL, LBO, MAU, RME)
Galium trichocarpum	CHL(VAL, LBO, MAU, BIO, RME)
Galium tricornutum	ARG(CHA) / BRA(Fuera del área del proyecto) / CHL(BIO)
Galium uruguayense var. uruguayense	ARG(COS) / BRA(RGS) / URY(LAV, MAL, TAC)
Galium uruguayense var. echinulatus	ARG(MIS) / URY(MAL, TAC)
Galium verum	ARG(RNE)
Galium vile	ARG(BAI, COS, ERI, MIS, TUC) / URY(CLA, COL, FLO, FLA, LAV, MAL, MON, PAY, ROC, SOR)
Galium werdermannii	CHL(BIO, ARA)
Gallardoa fischeri	ARG(MEN, NEU, RNE, SLU)
Gallesia integrifolia	BRA(PAR)
Galphimia amambayensis	PRY(AMA)
Galphimia australis	ARG(COS, ERI, MIS) / BRA(PAR, RGS, SCA) / PRY(APA, APY, AMA, CAU, CAN, CON, COA, GUA, ITA, MIE, ÑEE, PAI, PHA) / URY(PAY)
Galphimia platyphylla	BRA(Fuera del área del proyecto) / PRY(AMA, CAU, CAN)
Gamocarpha alpina	ARG(MEN, NEU) / CHL(LBO, MAU, BIO, ARA)
Gamocarpha dentata	ARG(NEU) / CHL(BIO, ARA)
Gamocarpha gilliesii var. gilliesii	ARG(MEN) / CHL(TAR, VAL, LBO)
Gamocarpha gilliesii var. gerthi	ARG(MEN)
Gamocarpha polycephala	CHL(BIO)
Gamocarpha pumila	CHL(MAU)
Gamocarpha selliana	ARG(CHU, NEU, RNE, SCR, TDF) / CHL(LLA, AIS, MAG)
Gamochaeta affinis	ARG(TDF)
Gamochaeta aliena	CHL(COQ, MAU, BIO, ARA, LLA, RME)
Gamochaeta alpina	ARG(NEU, RNE) / CHL(BIO, ARA, LLA, MAG)
Gamochaeta ambatensis	ARG(CAT, JUJ)
Gamochaeta americana	ARG(BAI, CAT, CHA, CHU, COR, COS, DFE, ERI, JUJ, LPA, LRI, MEN, MIS, NEU, RNE, SAL, SJU, SLU, SCR, SFE, SDE, TDF, TUC) / BRA(PAR, RGS, SCA) / CHL(LBO, BIO, LLA, AIS, MAG) / PRY(APA, APY, CAA, CEN, COA, ITA, SPE) / URY(CAS, CLA, COL, FLO, FLA, LAV, MAL, MON, PAY, RNO, ROC, SJO, SJO, TYT)
Gamochaeta andina	CHL(MAU, BIO, RME)
Gamochaeta antarctica	ARG(TDF)
Gamochaeta antillana	ARG(Desconocida) / BRA(RGS)
Gamochaeta argentina	ARG(BAI, CAT, COR, COS, LPA, LRI, MEN, SLU, SFE) / BRA(RGS) / URY(LAV, MAL, MON, SJO)
Gamochaeta axillaris	CHL(LRI, RME)
Gamochaeta calviceps	ARG(BAI, CAT, CHA, COR, COS, ERI, FOR, JUJ, LPA, LRI, MEN, MIS, SAL, SJU, SLU, SFE, SDE, TUC) / BRA(PAR, SCA) / PRY(APY, CEN, COA, PAI) / URY(MON)
Gamochaeta camaquaensis	BRA(RGS)
Gamochaeta chamissonis	ARG(CHU, MEN, NEU, RNE, SCR, TDF) / CHL(VAL, BIO, ARA, LLA, RME, JFE)
Gamochaeta chilensis	CHL(LBO)
Gamochaeta depilata	ARG(NEU, RNE) / CHL(MAU, BIO, ARA, LRI, AIS)
Gamochaeta deserticola	ARG(JUJ, SAL) / CHL(AYP, TAR, ANT, COQ, VAL, LBO, MAU, BIO, ARA, RME)
Gamochaeta diffusa	BRA(RGS)
Gamochaeta erecta	BRA(RGS)
Gamochaeta erythractis	ARG(CAT, JUJ, SAL)
Gamochaeta falcata	ARG(BAI, CAT, COR, COS, ERI, LPA, LRI, SAL, SJU, SLU, SFE) / BRA(RGS, SCA) / CHL(MAU, BIO, ARA) / PRY(CAN, PAI) / URY(CAS, COL, MON, ROC, SJO, SOR)
Gamochaeta filaginea	ARG(BAI, CAT, CHA, COR, COS, ERI, FOR, LPA, LRI, MEN, MIS, RNE, SJU, SLU, SFE, SDE) / BRA(RGS) / CHL(COQ, VAL, LBO, MAU, BIO, ARA, LRI, LLA, RME) / URY(FLO, FLA, MON, RNO, SJO, SJO)
Gamochaeta girardiana	BRA(RGS)
Gamochaeta hiemalis	BRA(PAR, SCA)
Gamochaeta humilis	CHL(AYP, ANT)
Gamochaeta longipedicellata	ARG(CAT, JUJ) / CHL(TAR)
Gamochaeta neuquensis	ARG(NEU, RNE) / CHL(LLA, MAG)
Gamochaeta nigrevestis	BRA(RGS, SCA)
Gamochaeta nivalis	ARG(CHU, MEN, NEU, RNE, SCR, TDF) / CHL(MAU, BIO, ARA, LLA, AIS, MAG)
Gamochaeta oligantha	ARG(NEU) / CHL(ANT, COQ, VAL, MAU, BIO, ARA, LRI, MAG, RME)
Gamochaeta pensylvanica	ARG(BAI, CAT, CHA, COR, COS, ERI, FOR, JUJ, LPA, LRI, MIS, SAL, SJU, SLU, SFE, SDE, TUC) / BRA(RGS, SCA) / PRY(APA, APY, BOQ, CEN, GUA, PAI, PHA) / URY(ART, CAS, CLA, COL, FLO, LAV, MON, PAY, SAO, SJO, SJO)
Gamochaeta procumbens	CHL(LBO, MAU, BIO, LRI, RME)
Gamochaeta purpurea	BRA(RGS, SCA) / PRY(CAU, PHA) / URY(MON)
Gamochaeta ramosa	CHL(COQ, VAL, LBO, MAU, BIO, RME)
Gamochaeta serpyllifolia	ARG(MEN, NEU) / CHL(LBO, MAU, BIO, ARA, LRI, AIS, RME)
Gamochaeta simplicicaulis	ARG(BAI, CAT, COR, COS, DFE, JUJ, LRI, MIS, SAL, SFE, TUC) / BRA(PAR, RGS, SCA) / CHL(VAL, MAU, BIO, ARA, LLA, RME) / PRY(APA, AMA) / URY(CAS, CLA, LAV, MON, RNO, ROC, SJO, TAC, TYT)
Gamochaeta sphacelata	ARG(JUJ) / BRA(RGS) / URY(Desconocida)
Gamochaeta spiciformis	ARG(CHU, NEU, RNE, SCR, TDF) / CHL(COQ, VAL, MAU, BIO, ARA, LRI, LLA, AIS, MAG, RME)
Gamochaeta stachydifolia	ARG(BAI, CHU, COR, LPA, LRI, MEN, RNE, SCR, TDF) / BRA(PAR, RGS, SCA) / CHL(VAL, BIO, LRI, JFE) / URY(CAS, LAV, MAL, MON, ROC, SJO)
Gamochaeta subfalcata	ARG(BAI, CAT, CHA, COR, COS, ERI, FOR, JUJ, LPA, SAL, SJU, SLU, SFE, SDE, TUC) / BRA(RGS, SCA) / CHL(COQ, VAL, MAU, RME) / PRY(COA) / URY(CAS, MAL, MON, ROC, SJO, SOR)
Gamochaeta valparadisea	CHL(COQ, VAL, MAU, BIO, RME)
Gamochaeta villaroelii	CHL(COQ, BIO, RME)
Garaya atroviridis	BRA(SCA)
Garcinia gardneriana	BRA(RGS, SCA)
Gastridium phleoides	ARG(CHU) / CHL(ATA, COQ, VAL, LBO, MAU, BIO, ARA, LLA, RME, JFE, IPA)
Gaudinia fragilis	ARG(BAI) / URY(MAL)
Gaultheria antarctica	ARG(CHU, NEU, RNE, SCR, TDF) / CHL(ARA, LLA, AIS, MAG)
Gaultheria arassatubensis	BRA(PAR, SCA)
Gaultheria bradeana	BRA(SCA)
Gaultheria caespitosa	ARG(CHU, MEN, NEU, RNE, SCR) / CHL(MAU, BIO, ARA, LLA, AIS)
Gaultheria corvensis	BRA(SCA)
Gaultheria erecta	ARG(JUJ, SAL) / BRA(SCA)
Gaultheria insana	ARG(CHU) / CHL(TAR, MAU, BIO, ARA, LLA, AIS, MAG)
Gaultheria itatiaiae	BRA(PAR, RGS, SCA)
Gaultheria linifolia	ARG(NEU, RNE) / CHL(BIO, ARA, LLA, RME)
Gaultheria marticorenae	ARG(CHU, NEU, RNE) / CHL(COQ, MAU, BIO, ARA, LLA, MAG)
Gaultheria mucronata	ARG(CHU, NEU, RNE, SCR, TDF) / CHL(BIO, ARA, LLA, AIS, MAG)
Gaultheria nubigena	ARG(NEU, RNE) / CHL(LLA)
Gaultheria phillyreifolia	ARG(BAI, CHU, NEU, RNE) / CHL(MAU, ARA, LLA, AIS, MAG)
Gaultheria poeppigii	ARG(CHU, COR, NEU, RNE, SLU, SCR) / CHL(MAU, BIO, ARA, LLA, AIS)
Gaultheria pumila var. pumila	ARG(CHU, MEN, NEU, RNE, SCR, TDF) / CHL(ARA, MAG)
Gaultheria pumila var. leucocarpa	ARG(CHU, MEN, NEU, RNE, SCR) / CHL(LBO, MAU, BIO, ARA, LLA, AIS, MAG, RME)
Gaultheria racemulosa	CHL(JFE)
Gaultheria renjifoana	CHL(BIO)
Gaultheria serrata var. organensis	BRA(PAR, SCA)
Gaultheria tenuifolia	ARG(NEU, RNE) / CHL(MAU, BIO, ARA, LLA)
Gaultheria ulei	BRA(PAR, RGS, SCA)
Gavilea araucana	ARG(CHU, NEU, RNE, SCR) / CHL(MAU, BIO, ARA, LLA, AIS, MAG, RME)
Gavilea australis	ARG(TDF) / CHL(MAG)
Gavilea cardioglossa	CHL(LLA)
Gavilea chica	ARG(NEU, RNE, SCR, TDF) / CHL(COQ, BIO, ARA, LLA, MAG, RME)
Gavilea gladysiae	ARG(SCR) / CHL(MAG)
Gavilea glandulifera	ARG(CHU, NEU, RNE, SCR) / CHL(COQ, VAL, LBO, MAU, BIO, ARA, LLA, RME)
Gavilea insularis	CHL(JFE)
Gavilea kingii	CHL(LLA, MAG)
Gavilea litoralis	ARG(SCR, TDF) / CHL(ARA, LLA, AIS, MAG)
Gavilea longibracteata	CHL(COQ, VAL, LBO, MAU, BIO, ARA, RME)
Gavilea lutea	ARG(CHU, NEU, RNE, SCR, TDF) / CHL(BIO, ARA, LLA, AIS, MAG)
Gavilea odoratissima	ARG(BAI, CHU, NEU, RNE) / CHL(MAU, BIO, ARA, LLA, AIS)
Gavilea platyantha	ARG(NEU) / CHL(COQ, VAL, BIO, ARA, LLA, RME)
Gavilea supralabellata	ARG(SCR, TDF) / CHL(MAG)
Gavilea trullata	ARG(NEU, RNE) / CHL(LLA)
Gavilea venosa	CHL(LBO, MAU, BIO, LLA, RME)
Gavilea wittei	ARG(SCR) / CHL(AIS, MAG)
Gaya albiflora	ARG(SAL)
Gaya bordasii	BRA(Fuera del área del proyecto) / PRY(APY)
Gaya gracilipes	ARG(COS, MIS, SAL) / BRA(PAR) / PRY(APA, AMA)
Gaya kelleri	ARG(MIS)
Gaya matutina	PRY(APY, PHA)
Gaya meridionalis	BRA(Fuera del área del proyecto) / PRY(APY)
Gaya parviflora	ARG(CAT, CHA, COR, ERI, FOR, JUJ, LPA, LRI, MEN, SAL, SDE, SFE, SJU, SLU, TUC) / PRY(APY) / URY(SOR)
Gaya pilosa	ARG(COS, MIS) / BRA(RGS) / PRY(APA, AMA)
Gaya purpurea	ARG(JUJ, SAL)
Gaya tarijensis	ARG(FOR, JUJ, SAL, TUC) / PRY(APY, CON, PHA)
Gaylussacia amoena	BRA(PAR, RGS)
Gaylussacia angustifolia	BRA(PAR, RGS, SCA)
Gaylussacia arassatubensis	BRA(PAR)
Gaylussacia brasiliensis	BRA(PAR, RGS, SCA) / PRY(APA, CAU, CAN)
Gaylussacia caratuvensis	BRA(PAR)
Gaylussacia cardenasii	ARG(SAL)
Gaylussacia densa	BRA(PAR)
Gaylussacia paranaensis	BRA(PAR)
Gaylussacia pseudogaultheria	BRA(PAR, RGS, SCA)
Gaylussacia rhododendron	BRA(PAR)
Gayophytum humile	ARG(MEN) / CHL(ATA, COQ, LBO, MAU, RME)
Gayophytum micranthum	ARG(CHU, MEN, NEU, SCR, SJU, SLU) / CHL(ANT, ATA, COQ, VAL, RME)
Gazania rigens	ARG(LPA)
Gelasine caerulea	ARG(MIS) / BRA(PAR, RGS, SCA) / PRY(APA, CAU)
Gelasine elongata	ARG(BAI, COR, ERI) / BRA(RGS) / URY(PAY)
Gelasine paranaënsis	BRA(PAR)
Gelasine uruguaiensis ssp. uruguaiensis	URY(DUR)
Gelasine uruguaiensis ssp. orientalis	URY(CLA)
Genipa americana	ARG(CHA, FOR) / BRA(PAR) / PRY(APY, AMA, CAN, CEN, CON, PAI, PHA)
Genista monspessulana	ARG(BAI, LPA) / CHL(VAL, MAU, BIO, ARA, LLA, RME, JFE) / URY(MAL, RIV, ROC)
Genista tinctorea	ARG(NEU, RNE)
Genlisea aurea	BRA(PAR, SCA)
Genlisea repens	BRA(PAR) / PRY(CAU, SPE)
Gentiana prostrata	ARG(CAT, CHU, COR, JUJ, LRI, MEN, NEU, RNE, SAL, SCR, SJU, TDF, TUC) / CHL(TAR, ANT, ATA, COQ, LBO, MAU, BIO, ARA, MAG, RME)
Gentianella benedictae	ARG(SAL)
Gentianella bromifolia	ARG(CAT, SAL, TUC)
Gentianella cabrerae	ARG(JUJ, SAL)
Gentianella claytonioides	ARG(CAT, LRI)
Gentianella coquimbensis	CHL(ATA, COQ)
Gentianella cosmantha	ARG(CAT, JUJ, SAL, TUC)
Gentianella erythrochrysea	ARG(SAL)
Gentianella fabrisii	ARG(TUC)
Gentianella fiebrigii	ARG(JUJ, SAL, TUC)
Gentianella florida	ARG(CAT, JUJ, SAL, TUC)
Gentianella gageoides	ARG(JUJ, SAL)
Gentianella helianthemoides	ARG(JUJ, SAL)
Gentianella hieronymi	ARG(JUJ, SAL)
Gentianella imberbis	ARG(CAT)
Gentianella kurtzii	ARG(CAT, LRI, TUC)
Gentianella magellanica	ARG(CHU, MEN, NEU, RNE, SCR, TDF) / CHL(MAU, BIO, ARA, LLA, AIS, MAG)
Gentianella meyeniana	ARG(JUJ)
Gentianella multicaulis	ARG(CAT, COR, LRI, MEN, SJU, SLU) / CHL(ATA, COQ)
Gentianella multiflora	ARG(JUJ, SAL)
Gentianella myriantha	ARG(JUJ, SAL)
Gentianella oranensis	ARG(JUJ, SAL)
Gentianella ottonis	ARG(MEN) / CHL(COQ, MAU, RME)
Gentianella parviflora	ARG(COR)
Gentianella pseudocrassula	ARG(JUJ, LRI, SAL)
Gentianella pulla	ARG(CAT, SAL, TUC)
Gentianella punensis	ARG(JUJ, SAL)
Gentianella riojae	ARG(CAT, LRI)
Gentianella silenoides var. striaticalyx	ARG(SAL)
Gentianella silenoides var. silenoides	ARG(SAL)
Gentianella tarapacana	CHL(TAR, ANT)
Gentianella thiosphaera	ARG(SAL, TUC)
Gentianella tubulosa	ARG(JUJ, SAL)
Geoffroea decorticans	ARG(BAI, CAT, CHA, COR, COS, ERI, FOR, JUJ, LPA, LRI, MEN, RNE, SAL, SDE, SFE, SJU, SLU, TUC) / CHL(TAR, ANT, ATA, COQ) / PRY(APY, PHA) / URY(COL, MON, PAY, RNO, SOR)
Geoffroea spinosa	ARG(CHA, COS, FOR, SAL, SFE) / BRA(Fuera del área del proyecto) / PRY(APY, CEN, CON, ÑEE, PAI, PHA)
Geonoma elegans	BRA(SCA)
Geonoma gamiova	BRA(PAR, RGS, SCA)
Geonoma pohliana ssp. weddelliana	BRA(Fuera del área del proyecto) / PRY(APA, AMA, CAN)
Geonoma pohliana ssp. pohliana	BRA(RGS, SCA)
Geonoma schottiana	BRA(PAR, RGS, SCA)
Geophila macropoda	ARG(MIS) / BRA(PAR) / PRY(APA, CAN, CEN, PAI)
Geophila repens	ARG(COS, FOR, MIS) / BRA(PAR, RGS, SCA) / PRY(APA, CAA, CAN, ITA)
Geranium albicans	ARG(BAI, COR, ERI, LPA, RNE, SFE) / BRA(RGS, SCA) / URY(CLA, FLO, LAV, MAL, MON, SOR)
Geranium arachnoideum	BRA(PAR, RGS, SCA)
Geranium berteroanum	ARG(BAI, CHU, JUJ, MEN, NEU, RNE, SCR, TDF) / CHL(COQ, VAL, LBO, MAU, BIO, ARA, LLA, AIS, MAG, RME)
Geranium carolinianum	ARG(BAI, CAT, CHA, COR, COS, DFE, ERI, FOR, JUJ, LRI, MEN, MIS, SFE, SLU, TUC) / BRA(PAR, RGS) / PRY(CEN, COA, MIE, PAI) / URY(RIV)
Geranium core-core	ARG(BAI, CHU, COR, LPA, MEN, NEU, RNE, SCR, SJU, SLU, TDF) / BRA(RGS) / CHL(TAR, ANT, ATA, COQ, VAL, LBO, MAU, BIO, ARA, LLA, AIS, MAG, RME, JFE)
Geranium dissectum	ARG(BAI, COR, COS, ERI, SFE, SLU) / BRA(RGS) / CHL(VAL, MAU, BIO, ARA, LLA, RME, JFE) / URY(FLA, SJO, SOR)
Geranium fallax	ARG(CAT, COR, JUJ, LRI, SAL, SJU, SLU, TUC)
Geranium glanduligerum	ARG(FOR) / BRA(RGS, SCA)
Geranium leucanthum	ARG(CAT, SAL, TUC)
Geranium magellanicum	ARG(CHU, NEU, RNE, SCR, TDF) / CHL(ARA, LLA, AIS, MAG)
Geranium molle	ARG(BAI, CHU, DFE, ERI, LPA, NEU, RNE, SCR, SFE, TDF) / CHL(COQ, VAL, LBO, MAU, BIO, ARA, LLA, MAG, RME) / URY(MON)
Geranium parodii	ARG(COR, SLU)
Geranium planum	ARG(TUC)
Geranium purpureum	ARG(BAI, COR, COS, ERI, MIS) / BRA(RGS, SCA) / CHL(VAL, BIO, ARA, LLA) / URY(MON)
Geranium pusillum	ARG(BAI, COR, LPA, MEN) / CHL(MAU, MAG, RME)
Geranium robertianum	ARG(BAI, ERI) / BRA(RGS) / CHL(COQ, VAL, LBO, MAU, BIO, ARA, LLA, RME, JFE) / URY(FLO, FLA)
Geranium rotundifolium	ARG(BAI)
Geranium sessiliflorum	ARG(CAT, CHU, JUJ, LRI, MEN, NEU, RNE, SAL, SCR, SJU, SLU, TDF, TUC) / CHL(TAR, COQ, MAU, BIO, ARA, LLA, AIS, MAG, RME)
Geranium skottsbergii	CHL(COQ, VAL, LBO, MAU, ARA, AIS, RME)
Geranium tafiense	ARG(SAL, TUC)
Geranium venturianum	ARG(CAT, JUJ, SAL, TUC)
Gethyum atropurpureum	CHL(LBO, MAU, RME)
Gethyum cuspidatum	CHL(COQ, VAL)
Geum andicola	ARG(NEU, RNE) / CHL(LLA)
Geum boliviense	ARG(BAI, ERI, MIS, SAL, TUC) / BRA(RGS) / URY(PAY)
Geum brevicarpellatum	ARG(COR)
Geum involucratum	ARG(TDF) / CHL(LLA, MAG)
Geum lechlerianum	CHL(LLA)
Geum magellanicum	ARG(CHU, NEU, RNE, SCR, TDF) / CHL(LBO, ARA, LLA, AIS, MAG)
Geum quellyon	CHL(VAL, MAU, BIO, ARA, LLA, AIS, MAG)
Geum riojense	ARG(LRI)
Gevuina avellana	ARG(CHU, NEU, RNE) / CHL(MAU, BIO, ARA, LLA)
Gibasis geniculata	ARG(CHA, COS, FOR) / BRA(PAR, RGS, SCA) / PRY(AMA, CAN, CON, GUA, PHA, SPE)
Gilia crassifolia	ARG(CHU, LRI, MEN, NEU, RNE, SAL, SCR, SJU) / CHL(ANT, ATA, COQ, VAL, LBO, RME)
Gilia laciniata	ARG(BAI, CAT, CHU, JUJ, LPA, MEN, NEU, RNE, SAL, SJU, SCR, TUC) / CHL(TAR, ANT, ATA, COQ, VAL, LBO, MAU, BIO, ARA, LLA, AIS, RME, JFE) / URY(COL)
Gilia valdiviensis	ARG(MEN, RNE) / CHL(COQ, VAL, LLA, RME, JFE)
Giliastrum castellanosii	ARG(CAT)
Giliastrum foetidum	ARG(CAT, MEN, SAL, SJU)
Gilliesia dimera	CHL(MAU)
Gilliesia graminea	ARG(MEN) / CHL(COQ, VAL, MAU, RME)
Gilliesia isopetala	CHL(LBO)
Gilliesia montana	CHL(MAU, BIO, ARA)
Gilliesia nahuelbutae	CHL(ARA)
Gladiolus communis	ARG(BAI)
Gladiolus tristis	ARG(BAI)
Glandularia andalgalensis	ARG(CAT)
Glandularia andina	ARG(CAT, CHA, COR, FOR, JUJ, LRI, MEN, SAL, SLU, SDE, TUC) / PRY(PHA)
Glandularia araucana	ARG(CHU, MEN, NEU, RNE, SJU) / CHL(MAU, BIO, ARA, RME)
Glandularia aristigera	ARG(BAI, CHA, COR, COS, ERI, FOR, JUJ, MIS, SAL, SFE, SDE, TUC) / BRA(PAR, RGS, SCA) / PRY(APY, BOQ, CEN, CON, COA, GUA, ITA, MIE, ÑEE, PAI, PHA) / URY(Desconocida)
Glandularia atacamensis	CHL(TAR, ANT, ATA)
Glandularia aurantiaca var. aurantiaca	ARG(CHU, MEN, NEU, RNE, SCR)
Glandularia aurantiaca var. glabra	ARG(MEN, NEU)
Glandularia balansae	ARG(COS, MIS) / BRA(PAR, RGS, SCA) / PRY(AMA, CAU, CAA, CAN, COA, GUA, SPE)
Glandularia berteroi	CHL(ANT, COQ, VAL, LBO, MAU, BIO, ARA, LLA, RME)
Glandularia cabrerae	ARG(JUJ, LRI, SAL, SDE)
Glandularia catharinae	BRA(PAR, RGS, SCA)
Glandularia cheitmaniana	ARG(CAT, JUJ, SAL, SDE, TUC)
Glandularia corymbosa	BRA(PAR, RGS, SCA) / CHL(LBO, BIO, ARA, LLA) / URY(CAS)
Glandularia dissecta	ARG(BAI) / BRA(RGS) / URY(COL, MON, SJO)
Glandularia dusenii	BRA(PAR)
Glandularia flava	ARG(BAI, CHU, LPA, LRI, MEN, NEU, RNE, SJU, SLU)
Glandularia guaibensis	BRA(RGS)
Glandularia guaranitica	ARG(BAI, COS, ERI, MIS) / BRA(RGS) / PRY(APY, CAU, CAN, CEN, GUA, ITA, MIE, PAI, PHA)
Glandularia gynobasis	CHL(TAR)
Glandularia hasslerana	ARG(CHA, COS, MIS) / BRA(PAR, RGS, SCA) / PRY(APY, CAU, GUA, MIE, PAI) / URY(RIV)
Glandularia hatschbachi	BRA(PAR, SCA)
Glandularia herteri	BRA(RGS, SCA) / URY(ART, RIV)
Glandularia humifusa	BRA(PAR, RGS)
Glandularia jordanensis	BRA(PAR, SCA)
Glandularia kuntzeana	BRA(SCA) / PRY(APA, AMA, COA, PAI, PHA)
Glandularia laciniata	BRA(SCA) / CHL(VAL, LBO, MAU, BIO, ARA, RME)
Glandularia landbeckii	CHL(COQ, VAL, BIO)
Glandularia lilloana	ARG(CAT, JUJ, LRI, SAL, TUC)
Glandularia lipozygioides	CHL(COQ, RME)
Glandularia lobata var. lobata	ARG(MIS) / BRA(PAR, RGS, SCA) / PRY(APA)
Glandularia lobata var. glabrata	BRA(RGS)
Glandularia macrosperma	ARG(CHU, MEN, NEU, RNE, SJU)
Glandularia marrubioides	BRA(PAR, RGS, SCA)
Glandularia megapotamica	ARG(BAI, COS, ERI, MIS) / BRA(RGS, SCA) / PRY(APA, APY, AMA, BOQ, CAN, COA, GUA, ÑEE, PAI) / URY(RNO, SAO)
Glandularia mendocina	ARG(CAT, COR, LPA, LRI, MEN, SJU, SLU)
Glandularia microphylla	ARG(CAT, JUJ, LRI, MEN, SAL, SJU, TUC)
Glandularia multiglandulosa	CHL(COQ)
Glandularia nana	ARG(CHA, COS, ERI, FOR, MIS) / BRA(PAR, RGS, SCA) / PRY(APY, GUA, PHA)
Glandularia paraguariensis	PRY(AMA)
Glandularia parodii	ARG(BAI, CHU, COR, LPA, LRI, MEN, RNE, SJU, SLU)
Glandularia peruviana	ARG(BAI, CAT, CHA, COR, COS, ERI, FOR, JUJ, LPA, LRI, MEN, MIS, SAL, SLU, SFE, SDE, TUC) / BRA(RGS, SCA) / PRY(CAN, COA, PAI, PHA) / URY(ART, CLA, COL, FLO, FLA, LAV, MAL, MON, PAY, RNO, RIV, SAO, SJO, SOR, TYT)
Glandularia phlogiflora	ARG(BAI, COS, MIS) / BRA(PAR, RGS, SCA) / PRY(CAN, GUA, ITA)
Glandularia platensis	ARG(BAI, CAT, CHA, COR, COS, ERI, JUJ, LPA, LRI, RNE, SAL, SJU, TUC) / BRA(RGS) / PRY(COA) / URY(COL, FLO, MAL, MON, PAY, SAO, SOR, TAC)
Glandularia porrigens	CHL(ATA, COQ, VAL, RME)
Glandularia pulchra	BRA(PAR, RGS) / URY(RIV)
Glandularia radicata	ARG(CAT, COR, LRI, MEN, SAL, SLU, TUC)
Glandularia ribifolia	CHL(LBO, MAU, RME)
Glandularia scrobiculata	ARG(CAT, CHA, JUJ, MIS, SAL, TUC)
Glandularia selloi	ARG(BAI, ERI) / BRA(RGS) / URY(CAS, CLA, MON, PAY, ROC, SJO)
Glandularia sessilis	ARG(CHA, COS, ERI, FOR) / BRA(RGS) / PRY(APY, CAA, CON, ITA, ÑEE, PAI, PHA) / URY(CLA, RNO)
Glandularia stellarioides	ARG(CHA, COS, MIS) / BRA(RGS) / PRY(APY, CEN, COA, GUA, ITA)
Glandularia subincana	ARG(BAI, COS, ERI, LPA, LRI, MIS, SAL, SLU, SFE, SDE, TUC) / BRA(RGS) / URY(ART, SAO, SOR)
Glandularia sulphurea var. sulphurea	ARG(LRI, MEN, SJU) / CHL(ATA, COQ, VAL, ARA, RME)
Glandularia sulphurea var. pedunculata	CHL(COQ, VAL, RME)
Glandularia tecticaulis	PRY(APA)
Glandularia tenera	ARG(BAI, CHA, COR, COS, ERI, LPA, MIS, SLU, SFE, SDE) / BRA(PAR, RGS, SCA) / PRY(APY, BOQ, ITA, PHA) / URY(ART, PAY, ROC, SJO)
Glandularia tessmannii	BRA(PAR, SCA)
Glandularia thymoides	ARG(ERI) / BRA(PAR, RGS, SCA) / URY(CLA, MAL, RIV, TAC)
Glandularia tomophylla	ARG(CHA, COR, COS, ERI, FOR, MIS) / BRA(RGS) / PRY(APA, APY, CAU, CEN, GUA, ITA, MIE, ÑEE, PAI)
Glandularia tristachya	ARG(COS, ERI)
Glandularia tweedieana	ARG(BAI, CAT, CHA, COR, COS, ERI, FOR, LPA, LRI, MIS, SAL, SLU, SFE, SDE, TUC) / BRA(PAR, RGS, SCA) / PRY(APY, CAU, CEN, COA, GUA, ÑEE, PAI, PHA, SPE) / URY(PAY, RNO, SAO)
Glandularia venturii	ARG(CAT, COR, JUJ, LRI, MEN, SAL, SJU, SLU, SDE, TUC)
Glaucium corniculatum	ARG(COR, LPA, SLU)
Glaucium flavum	ARG(CHU)
Glechoma hederacea	ARG(COR, NEU, RNE, TDF) / CHL(LLA)
Glechon ciliata	ARG(COS, FOR, MIS) / BRA(PAR, RGS) / PRY(APA, CAU, CAA, CAN, CEN, COA, ITA, MIE, SPE) / URY(MON)
Glechon discolor	BRA(SCA)
Glechon elliptica	BRA(PAR)
Glechon marifolia	ARG(MIS) / BRA(PAR, RGS, SCA) / PRY(APA, AMA, GUA) / URY(FLA, LAV, MAL, MON, RIV, ROC)
Glechon spathulata	ARG(MIS) / BRA(PAR, RGS, SCA) / PRY(CAA) / URY(CLA, PAY)
Glechon thymoides	ARG(MIS) / BRA(PAR, RGS, SCA) / URY(CLA, TAC)
Gleditsia amorphoides var. amorphoides	ARG(CHA, COS, ERI, FOR, JUJ, MIS, SAL, SFE) / BRA(PAR, RGS, SCA) / PRY(CEN, COA, ÑEE, PAI) / URY(ART, PAY, SAO)
Gleditsia amorphoides var. anacantha	ARG(FOR, MIS) / URY(ART, MON)
Gleditsia triacanthos	ARG(BAI, ERI, LPA, SAL, SFE) / URY(CAS, MON, PAY, SAO)
Gleichenella pectinata	BRA(PAR, SCA) / URY(CLA)
Glinus lotoides	ARG(BAI)
Glinus radiatus	ARG(BAI, CHA, COR, COS, DFE, ERI, FOR, SFE) / BRA(Fuera del área del proyecto) / CHL(COQ, VAL, LBO, MAU, BIO, ARA, RME) / PRY(APY, CEN, COA) / URY(TAC)
Gloxinia erinoides	ARG(SAL) / BRA(Fuera del área del proyecto)
Gloxinia sylvatica	BRA(Fuera del área del proyecto) / PRY(AMA)
Glyceria fluitans	CHL(MAU, BIO, ARA, LLA, MAG)
Glyceria multiflora	ARG(BAI, CHU, COR, DFE, ERI, NEU, RNE, SCR, SFE) / BRA(RGS, SCA) / CHL(MAU, BIO, ARA, LLA, AIS, MAG, RME) / URY(MON, ROC)
Glyceria saltensis	ARG(SAL)
Glycyrrhiza astragalina	ARG(BAI, CHU, COR, LPA, LRI, MEN, NEU, RNE, SCR, SJU, TUC) / CHL(VAL, BIO)
Gnaphalium illapelinum var. lanatum	CHL(COQ)
Gnaphalium landbeckii	CHL(VAL, LBO, MAU, BIO, RME)
Gnaphalium polycaulon	PRY(PHA)
Gnaphalium remyanum	CHL(RME)
Gochnatia argentina	ARG(CAT, CHA, COR, COS, ERI, FOR, SFE, SDE, TUC) / PRY(PHA)
Gochnatia cardenasii	ARG(JUJ)
Gochnatia cordata	ARG(COS, ERI) / BRA(RGS)
Gochnatia curviflora	ARG(JUJ, SAL, TUC)
Gochnatia foliolosa var. fascicularis	CHL(VAL, LBO, MAU, BIO, ARA, RME)
Gochnatia foliolosa var. foliolosa	CHL(COQ, VAL, LBO, MAU, BIO, ARA, LLA, RME)
Gochnatia glutinosa	ARG(CAT, JUJ, LPA, LRI, MEN, NEU, SAL, SJU, SLU, TUC)
Gochnatia palosanto	ARG(JUJ, SAL, TUC) / PRY(APY)
Gochnatia polymorpha ssp. ceanothifolia	ARG(COS, MIS) / BRA(RGS, SCA) / PRY(APA, GUA, ITA, MIE, SPE) / URY(ART, CLA, LAV, MON, PAY, RNO, RIV, TAC, TYT)
Goeppertia eichleri 	ARG(MIS) / BRA(PAR, SCA) / PRY(CAN)
Goeppertia flavescens	BRA(PAR)
Goeppertia longibracteata	BRA(PAR, SCA)
Goeppertia monophylla 	BRA(PAR, RGS, SCA)
Goeppertia zebrina	BRA(SCA)
Gomesa albinoi	BRA(SCA)
Gomesa barbaceniae	BRA(PAR, SCA)
Gomesa barbata	URY(CLA)
Gomesa barkeri	BRA(PAR, SCA)
Gomesa bifolia	ARG(BAI, CAT, CHA, COS, ERI, FOR, JUJ, MIS, SAL, TUC) / BRA(PAR, RGS, SCA) / PRY(CAU) / URY(ART, CLA, COL, CLA, MAL, MON, RNO, ROC, SJO, SJO, TAC, TYT)
Gomesa blanchetii	BRA(PAR, SCA)
Gomesa cogniauxiana	BRA(PAR)
Gomesa concolor	ARG(CHA, MIS) / BRA(PAR, RGS, SCA)
Gomesa cornigera	BRA(PAR, RGS, SCA) / PRY(SPE)
Gomesa crispa	BRA(PAR, RGS, SCA) / PRY(APY)
Gomesa curta	BRA(PAR)
Gomesa divaricata	BRA(PAR, RGS, SCA)
Gomesa doniana	BRA(PAR, SCA)
Gomesa duseniana	BRA(PAR, RGS, SCA)
Gomesa fischeri	BRA(PAR, SCA)
Gomesa flexuosa	ARG(CHA, COS, MIS, SAL) / BRA(PAR, RGS, SCA) / PRY(APA)
Gomesa foliosa	BRA(PAR)
Gomesa fuscans	BRA(PAR, RGS, SCA)
Gomesa gardneri	BRA(PAR)
Gomesa glaziovii	BRA(PAR, SCA)
Gomesa gravesiana	BRA(PAR, RGS, SCA)
Gomesa hookeri	BRA(PAR, RGS)
Gomesa hydrophila	BRA(PAR, RGS, SCA) / PRY(CAN)
Gomesa laxiflora	BRA(PAR, SCA)
Gomesa leinigii	BRA(PAR)
Gomesa lietzei	BRA(PAR)
Gomesa loefgrenii	BRA(PAR, RGS, SCA)
Gomesa longicornu	ARG(COS, MIS) / BRA(PAR, RGS, SCA)
Gomesa longipes	ARG(CHA, MIS) / BRA(PAR, RGS, SCA) / PRY(APA, CAU) / URY(CLA, MON, TYT)
Gomesa macronyx	BRA(PAR, RGS, SCA)
Gomesa martiana	BRA(PAR)
Gomesa nitida	BRA(RGS)
Gomesa paranaensis	ARG(MIS) / BRA(PAR, RGS, SCA)
Gomesa pectoralis	BRA(SCA)
Gomesa pirarensis	BRA(PAR, SCA)
Gomesa planifolia	ARG(MIS) / BRA(PAR, RGS, SCA) / PRY(APA, CAN)
Gomesa praetexta	BRA(PAR)
Gomesa pubes	ARG(COS, MIS) / BRA(PAR) / PRY(APA)
Gomesa ranifera	BRA(PAR, RGS, SCA)
Gomesa recurva	ARG(MIS) / BRA(PAR, SCA)
Gomesa riograndensis	ARG(COS, FOR, MIS) / BRA(PAR, RGS, SCA)
Gomesa sarcodes	BRA(PAR, SCA)
Gomesa varicosa	ARG(CAT, COS, JUJ, SAL) / BRA(PAR) / PRY(COA)
Gomesa viperina	ARG(JUJ, SAL, TUC) / PRY(COA)
Gomesa widgreni	BRA(RGS, SCA)
Gomidesia affinis var. pohliana	BRA(PAR)
Gomidesia anacardiaefolia	BRA(PAR, RGS, SCA)
Gomidesia barituensis	ARG(SAL)
Gomidesia fenzliana	BRA(PAR, RGS, SCA)
Gomidesia flagellaris	BRA(PAR, SCA)
Gomidesia palustris	ARG(COS, MIS) / BRA(PAR, RGS, SCA) / PRY(APY, CAU, CAA, CAN, CEN, COA, GUA, MIE, PAI) / URY(RIV, TAC)
Gomidesia schaueriana	BRA(PAR, RGS, SCA)
Gomidesia sellowiana	BRA(PAR, RGS, SCA)
Gomidesia spectabilis	BRA(PAR, SCA)
Gomidesia squamata	BRA(PAR)
Gomidesia tijucensis	BRA(RGS, SCA)
Gomortega keule	CHL(LBO, MAU, BIO)
Gomphocarpus physocarpus	BRA(SCA)
Gomphrena arborescens	BRA(Fuera del área del proyecto) / PRY(APA, AMA, CAN)
Gomphrena boliviana f. boliviana	ARG(CAT, COR, JUJ, LRI, MEN, SAL, SJU, TUC) / PRY(APY)
Gomphrena boliviana f. leiantha	ARG(CAT, COR, LRI, MEN, SAL, SJU, TUC)
Gomphrena boliviana f. robusta	ARG(CAT, COR, LRI, MEN, SJU, SLU, TUC)
Gomphrena celosioides f. roseiflora	ARG(CHA, COS, ERI, FOR, MIS, SAL, SFE) / BRA(RGS) / PRY(APA, APY, CAU, CEN, COA, GUA, MIE, ÑEE, PAI, SPE)
Gomphrena celosioides var. celosioides	ARG(BAI, CHA, COS, ERI, FOR, JUJ, MIS, SAL, SFE, TUC) / BRA(PAR, RGS) / PRY(APA, APY, AMA, BOQ, CAU, CAA, CON, COA, GUA, ITA, MIE, ÑEE, PAI, PHA, SPE) / URY(TAC)
Gomphrena celosioides f. aureiflora	ARG(CHA, COS, ERI, MIS) / PRY(AMA, CEN, CON, COA, GUA, ÑEE, PAI, PHA, SPE)
Gomphrena celosioides var. hygrophila	PRY(APY, AMA, CEN, CON, PAI)
Gomphrena cladotrichoides	ARG(SJU)
Gomphrena colosacana var. colosacana	ARG(LRI)
Gomphrena colosacana var. andersonii	ARG(SLU)
Gomphrena discolor	PRY(APY)
Gomphrena elegans var. elegans	ARG(BAI, CAT, CHA, COS, ERI, FOR, MIS, SDE, SFE, TUC) / BRA(PAR, RGS, SCA) / PRY(APA, CAN, COA, GUA, PAI, SPE) / URY(ART, CAS, CLA, FLO, FLA, MON, PAY, RNO, SAO, SJO, TAC, TYT)
Gomphrena elegans var. claussenioides	ARG(TUC) / PRY(APY)
Gomphrena elegans var. mesopotamica	ARG(COS, ERI)
Gomphrena elegans var. orientalis	BRA(RGS) / URY(ART, SAO)
Gomphrena ferruginea var. ferruginea	ARG(CAT, JUJ, SAL, TUC)
Gomphrena ferruginea var. adusta	ARG(JUJ)
Gomphrena ferruginea var. rustica	ARG(CAT, JUJ, SAL, TUC)
Gomphrena globosa	BRA(PAR, RGS, SCA) / PRY(CAN, CEN)
Gomphrena graminea	ARG(COS, ERI, MIS) / BRA(PAR, RGS, SCA) / PRY(AMA, CAU, CAN, COA, ITA, MIE, PAI) / URY(RIV)
Gomphrena guaranitica	PRY(CEN, COA, PAI)
Gomphrena haenkeana	ARG(CAT, CHA, COR, FOR, JUJ, LPA, LRI, MEN, SAL, SDE, SLU, TUC) / PRY(APY)
Gomphrena holosericea	BRA(RGS, SCA)
Gomphrena macrocephala	BRA(PAR) / PRY(APA, AMA, CAU, CAN, CON, GUA, SPE)
Gomphrena mandonii	ARG(SAL, TUC)
Gomphrena martiana var. martiana	ARG(CAT, CHA, COR, FOR, JUJ, LPA, LRI, MEN, SAL, SDE, SFE, SJU, TUC) / PRY(APY)
Gomphrena martiana var. glutinosa	PRY(APY)
Gomphrena martiana f. austrina	ARG(CAT, COR, LPA, MEN, SDE, SLU, TUC) / PRY(APY)
Gomphrena mendocina ssp. mendocina	ARG(CHU, LRI, MEN, RNE, SJU)
Gomphrena mendocina ssp. australis	ARG(NEU)
Gomphrena meyeniana var. meyeniana	ARG(CAT, JUJ, SAL, TUC) / CHL(TAR, ANT)
Gomphrena meyeniana var. caulescens	ARG(JUJ)
Gomphrena meyeniana var. conwayi	ARG(CAT, JUJ, SAL, TUC)
Gomphrena meyeniana var. flaccida	ARG(JUJ, SAL)
Gomphrena meyeniana var. flaccida f. levitepala	ARG(JUJ, SAL, TUC)
Gomphrena meyeniana var. genuina	ARG(JUJ, TUC)
Gomphrena meyeniana var. tucumanensis	ARG(CAT, JUJ, TUC)
Gomphrena pallida ssp. pallida	ARG(CAT, SAL, TUC)
Gomphrena pallida ssp. munda	ARG(JUJ)
Gomphrena pallida f. calva	ARG(SAL)
Gomphrena pallida var. diffusa	ARG(JUJ)
Gomphrena paraguayensis ssp. paraguayensis	ARG(COS, MIS) / PRY(CAU, CAN, CEN, CON, COA, GUA, ITA, PAI, PHA, SPE)
Gomphrena paraguayensis ssp. chacoensis	PRY(APY)
Gomphrena paranensis ssp. paranensis	BRA(PAR) / PRY(AMA)
Gomphrena paranensis ssp. paraguariensis	PRY(AMA, CEN, MIE, PAI)
Gomphrena perennis var. perennis	ARG(BAI, CAT, CHA, COR, COS, ERI, FOR, JUJ, LRI, MIS, SAL, SFE, SDE, TUC) / BRA(PAR, RGS, SCA) / PRY(APY, AMA, BOQ, CAU, CEN, CON, ÑEE, PAI, PHA) / URY(ROC)
Gomphrena phaeotricha	ARG(CAT, JUJ, SAL, TUC)
Gomphrena platycephala	ARG(CAT, CHA, FOR, JUJ, SAL, SDE, TUC)
Gomphrena pohlii var. hasslerii	BRA(Fuera del área del proyecto) / PRY(AMA, CAU, CAN, CON, GUA, SPE)
Gomphrena pulchella ssp. pulchella	ARG(BAI, CHA, COR, COS, ERI, FOR, LPA, SAL, SDE, SFE, SLU) / BRA(RGS) / PRY(APA, APY, BOQ, CEN, CON, COA, MIE, ÑEE, PAI, PHA) / URY(CAS, MON, PAY, RNO, RIV, SAO, SOR)
Gomphrena pulchella ssp. albisericea	ARG(CAT, CHA, COR, FOR, LRI, MEN, SDE, SJU, SLU) / PRY(APY, PHA)
Gomphrena pulchella ssp. rosea	ARG(COR, SLU)
Gomphrena pulchella var. bonariensis	ARG(COR, SLU)
Gomphrena pumila	ARG(MEN, RNE, SJU)
Gomphrena radiata	ARG(CAT, JUJ, SAL, TUC)
Gomphrena regeliana	BRA(PAR) / PRY(APA, AMA, CAU, CAN, PAI)
Gomphrena riparia	BRA(PAR)
Gomphrena schlechtendaliana	BRA(RGS)
Gomphrena sellowiana	BRA(RGS) / URY(Desconocida)
Gomphrena tomentosa var. tomentosa	ARG(CAT, COR, JUJ, LRI, MEN, SAL, SJU, SLU, SDE, TUC) / PRY(APY)
Gomphrena tomentosa var. monticola	ARG(CAT, SAL, TUC)
Gomphrena tomentosa var. ruiz-lealii	ARG(COR, LPA, MEN, SJU, SLU)
Gomphrena triceps	URY(TAC)
Gomphrena umbellata	ARG(CAT, JUJ, SAL, TUC) / CHL(TAR)
Gomphrena uruguayensis	URY(SAO)
Gomphrena vaga	ARG(CAT, JUJ, SAL, SDE) / BRA(PAR, RGS, SCA) / PRY(SPE)
Gomphrena virgata	BRA(PAR) / PRY(AMA, CAN, CON, SPE)
Gomphrena vitellina	PRY(AMA)
Gongora bufonia	BRA(PAR, SCA)
Gongora quinquenervis	BRA(PAR)
Gonolobus parviflorus	ARG(CHA, COS, ERI, FOR, MIS, SFE) / BRA(PAR, RGS, SCA) / PRY(APA, CEN, COA) / URY(ART, PAY, SAO)
Gonolobus rostratus	ARG(CHA, COS, FOR, JUJ, MIS, SAL, TUC) / BRA(PAR, RGS, SCA) / PRY(CEN, COA, SPE)
Gordonia fruticosa	BRA(PAR, RGS, SCA)
Gorgonidium bulbostylum	ARG(CAT)
Gorgonidium vermicidum	ARG(CAT, CHA, JUJ, MIS, SAL, TUC)
Gossypium barbadense	CHL(TAR, ANT, COQ)
Gouania latifolia	ARG(COS, MIS) / BRA(PAR) / PRY(APA, APY, AMA, CAU, CAA, CAN, CEN, CON, COA, GUA, ÑEE, PAI, SPE)
Gouania lupuloides	ARG(MIS) / BRA(Fuera del área del proyecto) / PRY(APA)
Gouania polygama	ARG(JUJ, SAL, TUC) / PRY(APY)
Gouania ulmifolia	ARG(COS, ERI, MIS) / BRA(PAR, RGS, SCA) / PRY(APA, CAA, GUA, SPE) / URY(ART, RNO)
Gouinia brasiliensis	ARG(CHA, JUJ, SAL) / BRA(Fuera del área del proyecto)
Gouinia latifolia	ARG(BAI, CAT, CHA, COR, COS, FOR, JUJ, LRI, SAL, SJU, SLU, SFE, SDE, TUC) / PRY(CAN, CON, PAI)
Gouinia paraguayensis var. paraguayensis	ARG(CAT, CHA, COR, ERI, FOR, LRI, SAL, SJU, SLU, SFE, SDE, TUC) / PRY(APY)
Gouinia paraguayensis var. tortuosa	ARG(CAT, COR, FOR, LRI, SAL, SJU, SDE) / PRY(APY)
Govenia utriculata	ARG(JUJ, SAL, TUC) / BRA(PAR, RGS, SCA)
Grahamia bracteata	ARG(BAI, CAT, COR, LRI, MEN, NEU, SDE, SJU, SLU, TUC)
Grammitis fluminensis	BRA(PAR, SCA)
Grandiphyllum divaricatum	BRA(PAR)
Grandiphyllum edwallii	ARG(COS, MIS) / BRA(PAR, RGS, SCA) / PRY(GUA)
Grandiphyllum hians	ARG(MIS) / BRA(PAR, RGS)
Grandiphyllum pulvinatum	ARG(COS, MIS) / BRA(PAR, SCA) / PRY(APA, SPE)
Grandiphyllum sphegiferum	BRA(PAR, RGS)
Gratiola peruviana	ARG(BAI, COS, ERI, MIS, NEU, SFE) / BRA(PAR, RGS, SCA) / CHL(ATA, LBO, BIO, ARA, LLA) / PRY(PAI) / URY(CAS, CLA, COL, FLO, FLA, LAV, MAL, MON, RNO, RIV, SJO, SOR, TAC, TYT)
Grazielia serrata	ARG(MIS) / BRA(PAR, RGS, SCA) / PRY(AMA, CAU, CAA, CAN, COA, GUA) / URY(CAS, CLA, MAL, TAC, TYT)
Greigia berteroi	CHL(JFE)
Greigia landbeckii	CHL(BIO, LLA)
Greigia pearcei	CHL(BIO, LLA)
Greigia sphacelata	CHL(MAU, BIO, ARA, LLA)
Grevillea robusta	ARG(ERI)
Grindelia aegialitis	ARG(BAI)
Grindelia anethifolia var. anethifolia	ARG(CHU, NEU, RNE) / CHL(BIO)
Grindelia anethifolia var. eligulata	ARG(NEU)
Grindelia atlantica	BRA(RGS)
Grindelia boliviana	ARG(CAT, JUJ, SAL)
Grindelia brachystephana	ARG(BAI, CHA, CHU, COR, COS, DFE, ERI, LPA, RNE, SCR, SDE, SFE, SLU)
Grindelia buphthalmoides	ARG(BAI) / BRA(RGS) / URY(TYT)
Grindelia cabrerae var. cabrerae	ARG(BAI, CAT, COR, COS, ERI, FOR, SDE, SFE, TUC)
Grindelia cabrerae var. alatocarpa	ARG(COR)
Grindelia chacoënsis	ARG(CHA, COS, SFE)
Grindelia chiloensis	ARG(CAT, CHU, LPA, MEN, NEU, RNE, SCR) / CHL(VAL, LBO, MAU, BIO, ARA, LLA, RME)
Grindelia coronensis	ARG(CHU, MEN, RNE)
Grindelia covasii	ARG(LPA)
Grindelia gaucha	BRA(RGS)
Grindelia globularifolia	ARG(COR)
Grindelia glutinosa	CHL(TAR)
Grindelia linearifolia	URY(PAY, SOR)
Grindelia mendocina var. mendocina	ARG(MEN)
Grindelia mendocina var. radiata	ARG(MEN)
Grindelia orientalis	URY(MAL, ROC)
Grindelia patagonica	ARG(BAI, CHU, RNE)
Grindelia prostrata	ARG(CAT, JUJ, LRI, SLU)
Grindelia prunelloides var. discoides	ARG(MEN, NEU) / CHL(MAU)
Grindelia prunelloides var. prunelloides	ARG(CHU, NEU, RNE, SCR) / CHL(MAU, BIO, ARA, LLA)
Grindelia puberula	ARG(CAT, FOR, JUJ, SAL, SDE, TUC) / BRA(RGS) / PRY(APY)
Grindelia pulchella var. pulchella	ARG(BAI, CAT, CHA, CHU, COR, COS, DFE, ERI, JUJ, LRI, MEN, RNE, SAL, SDE, SFE, SJU, SLU, TUC) / BRA(RGS) / URY(LAV, RNO, SAO, TAC)
Grindelia pulchella var. discoidea	ARG(BAI, CHU, COR, DFE, ERI, LRI, MEN, SDE, SLU, TUC) / BRA(RGS) / URY(CAS, LAV, MON, PAY, RNO)
Grindelia pygmaea	ARG(RNE)
Grindelia ragonesei	ARG(CHA, COS, SFE)
Grindelia scorzonerifolia	ARG(BAI, CHA, COR, COS, DFE, ERI, LPA, MIS, SFE) / BRA(RGS) / PRY(PHA) / URY(DUR, TAC)
Grindelia tarapacana	CHL(TAR)
Grindelia ventanensis	ARG(BAI)
Griselinia carlomunozii	CHL(ANT)
Griselinia jodinifolia	CHL(MAU, BIO, ARA, LLA)
Griselinia racemosa	ARG(CHU) / CHL(ARA, LLA, AIS)
Griselinia ruscifolia var. ruscifolia	ARG(CHU, RNE) / CHL(LLA, AIS, MAG)
Griselinia ruscifolia var. itatiaiae	BRA(PAR, RGS, SCA)
Griselinia scandens	CHL(COQ, VAL, MAU, BIO, LLA, AIS)
Grobya amherstiae	BRA(PAR, SCA)
Grobya fascifera	BRA(PAR, RGS, SCA)
Grobya galeata	BRA(PAR, SCA)
Grobya guieselii	BRA(SCA)
Guadua chacoensis	ARG(CHA, COS, ERI, FOR, MIS, SFE) / BRA(PAR, RGS, SCA) / PRY(CAA, CEN, GUA, SPE) / URY(ART)
Guadua paniculata	BRA(SCA)
Guadua paraguayana	ARG(CHA, COS, ERI, MIS, SFE) / PRY(CEN, COA)
Guadua tagoara	ARG(MIS) / BRA(PAR, RGS, SCA)
Guadua trinii	ARG(BAI, COS, ERI, MIS) / BRA(PAR, RGS, SCA) / URY(RIV, SAO, TAC)
Guadua variegata	ARG(MIS)
Guapira areolata	PRY(AMA, CON)
Guapira hirsuta	BRA(PAR, RGS, SCA) / PRY(APA)
Guapira nitida	BRA(RGS)
Guapira obtusata	BRA(SCA)
Guapira opposita	BRA(PAR, RGS, SCA) / PRY(AMA)
Guapurium peruvianum	ARG(CHA, COS, FOR, MIS) / PRY(Desconocida)
Guarea guidonia	ARG(MIS) / BRA(PAR) / PRY(AMA, CAA, CAN, CON, PAI)
Guarea kunthiana	ARG(MIS) / BRA(PAR) / PRY(APA, AMA, CAA, CAN, COA, GUA, PAI, SPE)
Guarea macrophylla ssp. spiciflora	ARG(CHA, COS, FOR, MIS, SFE) / BRA(PAR) / PRY(APA, AMA, CAU, CAA, CAN, CEN, CON, COA, GUA, ITA, MIE, ÑEE, PAI, SPE) / URY(ART, SAO)
Guarea macrophylla ssp. tuberculata	ARG(MIS) / BRA(PAR, RGS, SCA) / PRY(PAI)
Guarea macrophylla ssp. pachycarpa	BRA(PAR)
Guatteria australis	BRA(PAR, RGS, SCA)
Guazuma ulmifolia var. tomentella	ARG(COS, MIS) / PRY(APA, AMA, CAU, CAA, CEN, CON, COA, GUA, PAI)
Guazuma ulmifolia var. ulmifolia	ARG(CHA, FOR) / BRA(Fuera del área del proyecto) / PRY(APY, AMA, CEN, CHO, CON, COA, GUA, ÑEE, PAI, PHA, SPE)
Guettarda pohliana	BRA(PAR)
Guettarda uruguensis	ARG(BAI, CHA, COS, ERI, FOR, MIS) / BRA(PAR, RGS, SCA) / PRY(APA, APY, CAA, GUA, ITA, MIE, ÑEE, PAI, PHA) / URY(PAY, RIV, ROC, SAO, SJO, TAC, TYT)
Guettarda viburnoides	BRA(PAR) / PRY(AMA, CAN, CON)
Guibourtia hymenaeifolia	BRA(Fuera del área del proyecto) / PRY(APA, AMA, CAN, CEN, CON)
Guilleminea chacoensis	ARG(FOR) / PRY(APY, PHA)
Guilleminea densa	ARG(CAT, COR, COS, DFE, FOR, JUJ, SAL, SFE, TUC) / PRY(APY)
Guilleminea elongata	URY(DUR, SAO, TAC)
Guilleminea fragilis	BRA(Fuera del área del proyecto) / PRY(AMA, CON)
Guilleminea gracilis	ARG(CAT, JUJ, SAL, TUC)
Guilleminea hirsuta	ARG(SAL) / PRY(APY)
Guindilia cristata	ARG(CAT, LRI, SJU)
Guindilia dissecta	ARG(MEN)
Guindilia trinervis	ARG(MEN) / CHL(COQ, VAL, LBO, MAU, BIO, RME)
Gunnera apiculata	ARG(JUJ, SAL)
Gunnera berteroi	ARG(JUJ) / CHL(LBO, MAU)
Gunnera bracteata	CHL(JFE)
Gunnera herteri	BRA(RGS, SCA) / URY(ROC)
Gunnera lobata	ARG(SCR, TDF) / CHL(LLA, AIS, MAG)
Gunnera magellanica	ARG(CHU, MEN, NEU, RNE, SCR, TDF) / CHL(LBO, MAU, BIO, ARA, LLA, AIS, MAG, RME)
Gunnera manicata	BRA(PAR, RGS, SCA)
Gunnera masafuerae	CHL(JFE)
Gunnera peltata	CHL(JFE)
Gunnera schindleri	ARG(JUJ)
Gunnera tinctoria var. tinctoria	ARG(CHU, NEU, RNE) / CHL(COQ, VAL, LBO, MAU, BIO, ARA, LLA, AIS, MAG, JFE)
Gunnera tinctoria var. meyerii	ARG(NEU, RNE) / CHL(ARA, LLA)
Gunnera tinctoria var. valdiviensis	CHL(LLA)
Gutierrezia baccharoides	ARG(CHU, MEN, NEU, RNE, SCR, TDF) / CHL(AIS, MAG)
Gutierrezia espinosae	CHL(TAR, ANT, ATA)
Gutierrezia gayana	CHL(ATA, COQ)
Gutierrezia gilliesii	ARG(BAI, CAT, CHU, COR, LPA, LRI, MEN, NEU, RNE, SJU, SLU, TUC)
Gutierrezia isernii	ARG(CAT, MEN, SJU, TUC)
Gutierrezia mandonii	ARG(CAT, JUJ, LRI, SAL, TUC)
Gutierrezia neaeana	CHL(ATA)
Gutierrezia pulviniformis	ARG(MEN)
Gutierrezia repens	ARG(CAT, JUJ, SAL, TUC)
Gutierrezia resinosa	CHL(COQ, VAL, LBO, RME)
Gutierrezia solbrigii	ARG(CHU, LPA, MEN, NEU, RNE)
Gutierrezia spathulata	ARG(CHU, LPA, MEN, NEU, RNE, SCR, SLU)
Gutierrezia taltalensis	CHL(ANT, ATA)
Guynesomia scoparia	CHL(COQ)
Gymnanthes boticario 	PRY(APY)
Gymnanthes discolor	ARG(FOR, JUJ, MIS) / PRY(APA, CEN, COA)
Gymnanthes nervosa	ARG(BAI) / PRY(COA, PAI)
Gymneia virgata	BRA(Fuera del área del proyecto) / PRY(CAN)
Gymnocalycium albiareolatum	ARG(LRI)
Gymnocalycium amerhauseri	ARG(COR)
Gymnocalycium andreae	ARG(COR)
Gymnocalycium angelae	ARG(COS)
Gymnocalycium anisitsii	BRA(Fuera del área del proyecto) / PRY(CON)
Gymnocalycium baldianum	ARG(CAT)
Gymnocalycium bayrianum	ARG(SAL, TUC)
Gymnocalycium bruchii var. brigittae	ARG(COR)
Gymnocalycium bruchii var. bruchii	ARG(COR, SLU)
Gymnocalycium bruchii var. niveum	ARG(COR)
Gymnocalycium bueneckeri	BRA(RGS)
Gymnocalycium calochlorum	ARG(COR)
Gymnocalycium campestre	ARG(COR)
Gymnocalycium capillense	ARG(COR)
Gymnocalycium castellanosii var. castellanosii	ARG(LRI)
Gymnocalycium castellanosii var. bozsingianum	ARG(LRI)
Gymnocalycium castellanosii ssp. acorrugatum	ARG(SJU)
Gymnocalycium denudatum	ARG(MIS) / BRA(RGS) / URY(ART, CLA, RIV)
Gymnocalycium erinaceum	ARG(COR)
Gymnocalycium eurypleurum	PRY(APY)
Gymnocalycium gibbosum	ARG(BAI, CHU, LPA, MEN, RNE, SCR, SLU)
Gymnocalycium horstii	BRA(RGS)
Gymnocalycium hybopleurum	ARG(CAT, LRI)
Gymnocalycium hyptiacanthum	ARG(ERI) / URY(CAS, COL, FLA, LAV, MAL, RNO, ROC, SAO, SOR)
Gymnocalycium kieslingii f. kieslingii	ARG(LRI)
Gymnocalycium kieslingii f. castaneum	ARG(LRI)
Gymnocalycium kieslingii f. albiareolatum	ARG(LRI)
Gymnocalycium kroenleinii	ARG(LRI)
Gymnocalycium kuehhasii	ARG(COR)
Gymnocalycium leptanthum	ARG(SDE)
Gymnocalycium marsoneri	ARG(SAL, TUC)
Gymnocalycium mazanense	ARG(LRI)
Gymnocalycium megatae	PRY(APY)
Gymnocalycium mesopotamicum	ARG(COS)
Gymnocalycium mihanovichii	ARG(CHA, FOR) / PRY(APY, PHA)
Gymnocalycium monvillei ssp. achirasense	ARG(COR, SLU)
Gymnocalycium monvillei ssp. horridispinum	ARG(COR)
Gymnocalycium monvillei ssp. monvillei	ARG(COR, SLU)
Gymnocalycium mostii	ARG(COR)
Gymnocalycium mucidum	ARG(LRI)
Gymnocalycium neuhuberi	ARG(SLU)
Gymnocalycium ochoterenae ssp. ochoterenae	ARG(COR, SLU)
Gymnocalycium ochoterenae ssp. vatteri	ARG(COR)
Gymnocalycium oenanthemum	ARG(CAT)
Gymnocalycium paediophilum	PRY(APY)
Gymnocalycium paraguayense f. paraguayense	PRY(COA, PAI)
Gymnocalycium paraguayense f. fleischerianum	PRY(COA, PAI)
Gymnocalycium parvulum	ARG(SLU)
Gymnocalycium pflanzii ssp. argentinense	ARG(SAL) / PRY(APY, PHA)
Gymnocalycium pugionacanthum	ARG(CAT, LRI)
Gymnocalycium quehlianum	ARG(COR)
Gymnocalycium ragonesei	ARG(CAT)
Gymnocalycium raineri	ARG(CAT)
Gymnocalycium reductum var. reductum	ARG(BAI)
Gymnocalycium reductum var. platense	ARG(BAI)
Gymnocalycium ritterianum	ARG(LRI)
Gymnocalycium robustum	ARG(COR)
Gymnocalycium saglionis var. saglionis	ARG(CAT, LRI, SAL, SJU, TUC)
Gymnocalycium saglionis var. jujuyense	ARG(JUJ)
Gymnocalycium schickendantzii var. delaetii	ARG(SAL)
Gymnocalycium schickendantzii var. schickendantzii	ARG(CAT, COR, LRI, MEN, SAL, SDE, SFE, SJU, SLU, TUC)
Gymnocalycium schroederianum ssp. paucicostatum	ARG(COS, ERI)
Gymnocalycium schroederianum ssp. bayense	ARG(BAI)
Gymnocalycium schroederianum ssp. schroederianum	ARG(ERI) / URY(RNO)
Gymnocalycium schroederianum ssp. boessii	ARG(SFE)
Gymnocalycium spegazzinii	ARG(CAT, SAL, TUC)
Gymnocalycium stellatum	ARG(CAT, COR, LRI, SJU)
Gymnocalycium stenopleurum	PRY(APY)
Gymnocalycium stuckertii	ARG(SLU)
Gymnocalycium sutterianum ssp. dolezalii	ARG(COR)
Gymnocalycium sutterianum ssp. arachnispinum	ARG(COR)
Gymnocalycium taningaense ssp. taningaense	ARG(COR)
Gymnocalycium taningaense ssp. fuschilloi	ARG(COR)
Gymnocalycium uebelmannianum	ARG(LRI)
Gymnocalycium uruguayense	ARG(ERI) / BRA(RGS) / URY(ART, CAS, CLA, COL, DUR, FLO, FLA, LAV, MAL, MON, PAY, RNO, RIV, ROC, SAO, SJO, SOR, TAC, TYT)
Gymnocoronis spilanthoides var. spilanthoides	ARG(BAI, CHA, COS, DFE, ERI, FOR, MEN, MIS, SFE) / BRA(RGS) / PRY(CAA, CEN, CON, COA, ITA, PAI, PHA) / URY(ART, CAS, CLA, DUR, MON, PAY, RNO, RIV, ROC, SAO, SJO, SOR, TYT)
Gymnocoronis spilanthoides var. subcordata	ARG(BAI, CHA, COS, ERI, SFE) / BRA(RGS) / PRY(APY, AMA, CEN, COA, ÑEE, PAI, PHA) / URY(COL, SOR)
Gymnophyton flexuosum	CHL(ANT, ATA, COQ)
Gymnophyton foliosum	CHL(ANT, ATA, COQ)
Gymnophyton isatidicarpum	CHL(COQ, VAL, LBO, RME)
Gymnophyton polycephalum	ARG(CAT, LRI, MEN, SAL, SJU)
Gymnophyton robustum	CHL(TAR, ATA, COQ)
Gymnophyton spinosissimum	CHL(ANT, ATA, COQ)
Gymnopogon burchellii	ARG(CHA, COS, MIS) / BRA(PAR, RGS, SCA)
Gymnopogon glaber	ARG(CAT, JUJ, SAL, SLU, TUC)
Gymnopogon grandiflorus	ARG(BAI, COR, ERI, LPA, SFE) / BRA(RGS, SCA) / URY(FLA, MAL)
Gymnopogon legrandii	ARG(COR, COS, ERI, MIS) / BRA(RGS, SCA) / PRY(ÑEE) / URY(CAS)
Gymnopogon spicatus	ARG(CHA, COR, COS, ERI, FOR, JUJ, MIS, SAL, SLU, TUC) / BRA(PAR, RGS, SCA) / PRY(APY, APA, AMA) / URY(DUR, MON)
Gymnopogon toldensis	ARG(SAL)
Gymnosiphon divaricatus	ARG(MIS) / BRA(PAR, SCA)
Gynerium sagittatum	ARG(CHA, COS, FOR, JUJ, MIS, SAL) / BRA(PAR, SCA) / PRY(APA, CEN, COA, ITA)
Gynura aurantiaca	ARG(SAL)
Gypothamnium pinifolium	CHL(ANT, ATA)
Gyptidium militare	ARG(CHA, FOR)
Gyptis artemisifolia	ARG(BAI, COR, ERI)
Gyptis commersonii	ARG(BAI, COS, ERI, SFE, SDE) / BRA(RGS) / URY(ART, CAS, CLA, COL, LAV, MAL, MON, PAY, RNO, SAO, SJO, SJO, TAC)
Gyptis crassipes	ARG(BAI, CHA, COR, COS, ERI, MIS, SFE) / BRA(RGS) / PRY(AMA, CAU)
Gyptis lanigera	ARG(CHA, COR, COS, ERI, FOR, JUJ, MIS) / BRA(RGS, SCA) / PRY(APA, AMA, CAU, CON, COA, GUA, MIE, PAI) / URY(ART, COL, MON, PAY, RIV, TAC)
Gyptis tanacetifolia	ARG(BAI, CHA, COR, COS, ERI, MIS, SFE, SDE) / BRA(PAR, RGS, SCA) / PRY(GUA, PAI) / URY(CAS, CLA, COL, CLA, LAV, MAL, MON, PAY, SJO, SJO, TYT)