Wahlenbergia berteroi	CHL(JFE)
Wahlenbergia calycina	ARG(JUJ, SAL, TUC)
Wahlenbergia fernandeziana	CHL(JFE)
Wahlenbergia grahamae	CHL(JFE)
Wahlenbergia linarioides	ARG(BAI, CAT, COR, COS, ERI, FOR, JUJ, LPA, MEN, MIS, RNE, SAL, SJU, SLU, SFE, SDE, TUC) / BRA(PAR, RGS, SCA) / CHL(COQ, VAL, LBO, MAU, BIO, ARA, LLA) / PRY(APA, CAU, CAA, CEN, GUA, ÑEE, PAI) / URY(MON)
Wahlenbergia masafuerae	CHL(JFE)
Wahlenbergia peruviana	ARG(JUJ, SAL)
Wahlenbergia tuberosa	CHL(JFE)
Waltheria albicans	ARG(SAL, SDE) / PRY(APY, AMA, PHA)
Waltheria carmensarae	ARG(COS) / PRY(ITA, ÑEE)
Waltheria carpinifolia	BRA(PAR, RGS, SCA)
Waltheria communis	ARG(COS, ERI, FOR, JUJ, MIS, SAL) / BRA(PAR, RGS, SCA) / PRY(APY, APA, AMA, CAU, CAA, CAN, CEN, CON, COA, GUA, ITA, MIE, ÑEE, PAI, PHA, SPE) / URY(ART, RIV)
Waltheria indica	ARG(CAT, COR, COS, FOR, JUJ, LRI, MIS, SAL, SDE, TUC) / BRA(PAR, RGS, SCA) / PRY(APY, APA, AMA, CAN, CEN, CON, COA, GUA, ITA, MIE, PAI, PHA, SPE)
Waltheria macrophylla	PRY(CAU)
Waltheria operculata	PRY(APY, CON)
Waltheria ovata	CHL(TAR)
Waltheria procumbens	PRY(AMA)
Waltheria viscosissima	PRY(AMA, CON)
Warmingia eugenii	ARG(MIS) / BRA(PAR, RGS, SCA)
Warrea warreana	ARG(MIS) / BRA(PAR, RGS)
Watsonia borbonica ssp. ardernei	ARG(BAI)
Weberbauera chillanensis	ARG(MEN, NEU) / CHL(MAU, BIO, ARA)
Weberbauera colchaguensis	ARG(CHU, MEN, NEU, RNE, SCR) / CHL(COQ, MAU, BIO, LLA, AIS, MAG, RME)
Weberbauera densifolia	ARG(CAT, JUJ)
Weberbauera herzogii	ARG(JUJ, SAL)
Weberbauera imbricatifolia	ARG(LRI, MEN, SJU) / CHL(ATA, COQ, VAL, LBO, RME)
Weberbauera lagunae	CHL(ATA)
Weberbauera peruviana	ARG(CAT, JUJ, SAL, TUC)
Weberbauera spathulifolia	ARG(CAT, JUJ, LRI, TUC)
Weberbauera stenophylla	CHL(MAU, RME)
Weberbauera suffruticosa	CHL(COQ)
Weberbauerella chilensis	CHL(ATA)
Wedelia brachylepis	ARG(CHA, FOR, JUJ, SAL, SDE, TUC) / PRY(APY, BOQ, CON)
Wedelia buphtalmiflora	ARG(BAI, CAT, COR, LPA, LRI, SAL, SJU, SLU, SDE, TUC)
Wedelia holwayii	ARG(JUJ, SAL)
Wedelia kerrii	ARG(CHA, COS, MIS) / BRA(PAR) / PRY(APA, ITA)
Wedelia saltensis	ARG(CAT, JUJ, SAL, TUC)
Wedelia subvelutina	ARG(MIS) / BRA(PAR) / PRY(APA, CAU, CAN)
Weingartia neumanniana	ARG(JUJ)
Weinmannia boliviensis	ARG(JUJ, SAL)
Weinmannia discolor	BRA(PAR, RGS, SCA)
Weinmannia humilis	BRA(PAR, RGS, SCA)
Weinmannia organensis	BRA(PAR, SCA)
Weinmannia paulliniifolia	BRA(PAR, RGS, SCA)
Weinmannia trichosperma	ARG(CHU, NEU, RNE, SCR) / CHL(MAU, BIO, ARA, LLA, AIS, MAG)
Werneria aretioides	ARG(JUJ, SAL) / CHL(TAR, ANT)
Werneria cochlearis	ARG(CAT, JUJ, LRI, SAL)
Werneria glaberrima	CHL(TAR, ANT)
Werneria heteroloba f. heteroloba	ARG(CAT, JUJ, SAL, SJU, TUC) / CHL(TAR, ANT, ATA, COQ)
Werneria pinnatifida	ARG(SJU)
Werneria pumila	ARG(SAL)
Werneria pygmaea var. pygmaea	ARG(CAT, JUJ, LRI, MEN, NEU, SAL, SCR, SJU, TUC) / CHL(TAR, ANT, ATA, COQ, VAL, RME)
Werneria pygmaea var. apiculata	ARG(CAT, JUJ, LRI, SAL, TUC)
Werneria solivifolia	CHL(TAR)
Werneria spathulata	ARG(JUJ, SAL) / CHL(TAR, ANT)
Werneria villosa	ARG(JUJ, SAL, TUC)
Wettsteiniola apipensis	ARG(COS)
Wettsteiniola pinnata	BRA(PAR)
Wigginsia calvescens	ARG(COS) / BRA(RGS)
Wigginsia corynodes	URY(ROC)
Wigginsia erinacea	BRA(PAR)
Wigginsia pauciareolata	ARG(ERI) / URY(SOR)
Wigginsia sessiliflora	ARG(BAI, COR, LPA, RNE) / URY(RNO)
Wigginsia shaeferiana	ARG(COS)
Wigginsia tephracantha	ARG(BAI) / URY(COL)
Wilbrandia dusenii	BRA(PAR)
Wilbrandia ebracteata var. bracteata	ARG(MIS)
Wilbrandia ebracteata var. ebracteata	ARG(COS, MIS) / BRA(PAR, RGS, SCA) / PRY(APY, APA, CAU, CAN, GUA, SPE)
Wilbrandia ebracteata var. pedunculata	ARG(MIS) / PRY(PAI, SPE)
Wilbrandia hibiscoides	BRA(PAR)
Wilbrandia longisepala	BRA(PAR, RGS, SCA)
Wilbrandia verticillata	BRA(PAR) / PRY(COA)
Willkommia texana	ARG(BAI) / URY(RNO, RIV)
Wissadula decora	ARG(COS, FOR) / PRY(PHA)
Wissadula densiflora var. densiflora	ARG(CAT, CHA, COR, ERI, FOR, JUJ, LRI, MIS, SAL, SFE, SDE, TUC) / PRY(APY, PHA)
Wissadula densiflora var. schulzii	ARG(CHA)
Wissadula excelsior	ARG(MIS) / BRA(Fuera del área del proyecto) / PRY(AMA)
Wissadula glechomaefolia	ARG(COS, ERI, MIS) / BRA(RGS) / URY(CAS, PAY)
Wissadula gymnanthemum	ARG(CAT, COR, JUJ, LRI, SAL, SDE, SJU, SLU, TUC)
Wissadula hernandioides 	ARG(CHA, COS, FOR, JUJ, MIS, SAL, SFE) / BRA(PAR, RGS) / PRY(APY, AMA, CON, COA, GUA, PAI, PHA)
Wissadula indivisa	PRY(CON)
Wissadula krapovickasiana	PRY(APY, CON, COA)
Wissadula macrantha var. macrantha	PRY(APY, CON, PHA)
Wissadula macrantha var. brevipedunculata	PRY(PAI)
Wissadula paraguariensis	ARG(CHA, COS, FOR) / PRY(APY, CEN, CON, PAI, PHA)
Wissadula parviflora	ARG(MIS) / BRA(PAR, RGS, SCA)
Wissadula periplocifolia	BRA(PAR)
Wissadula setifera	ARG(COS) / PRY(APY)
Wissadula tucumanensis	ARG(JUJ, SAL, SDE, TUC)
Wissadula wissadifolia	ARG(JUJ, SAL)
Wittrockia cyathiformis	BRA(PAR, SCA)
Wittrockia superba	BRA(PAR, RGS, SCA)
Wolffia brasiliensis	ARG(BAI, CHA, COR, COS, ERI, FOR, JUJ, MIS, SAL, SFE) / BRA(PAR, RGS, SCA) / CHL(BIO) / PRY(APY, APA) / URY(MON)
Wolffia columbiana	ARG(BAI, CHA, COR, COS, ERI, LRI, SAL, SJU, SFE, TUC) / BRA(RGS) / PRY(APY) / URY(CAS, MON, TYT)
Wolffiella lingulata	ARG(BAI, CHA, COS, ERI, FOR, SFE) / BRA(Fuera del área del proyecto) / PRY(APY, CEN, COA) / URY(MON)
Wolffiella oblonga	ARG(BAI, CHA, CHU, COS, FOR, JUJ, LPA, RNE, SAL, SFE, TUC) / BRA(RGS, SCA) / CHL(VAL, MAU, RME) / PRY(APY, CEN, COA) / URY(CAS, FLA, MON, ROC, SJO, TYT)
Woodsia montevidensis	ARG(BAI, CAT, COR, JUJ, LPA, LRI, MEN, RNE, SAL, SJU, SLU, TUC) / BRA(RGS, SCA) / CHL(AYP, TAR) / URY(CAS, CLA, LAV, MON, TYT)
Wullschlaegelia aphylla	ARG(COS, MIS) / BRA(PAR, RGS, SCA) / PRY(APA, CAU, GUA)
