Kageneckia angustifolia	CHL(COQ, VAL, LBO, MAU, RME)
Kageneckia lanceolata	ARG(COR, JUJ, SAL, SDE, SLU, TUC)
Kageneckia oblonga	CHL(COQ, VAL, LBO, MAU, BIO, RME)
Kallstroemia tribuloides	ARG(CAT, CHA, FOR, JUJ, LRI, MEN, SAL, SDE, SJU, TUC) / BRA(Fuera del área del proyecto) / PRY(APY, PHA)
Kallstroemia tucumanensis	ARG(CAT, CHA, COR, ERI, JUJ, LRI, MEN, SAL, SDE, SFE, SJU, SLU, TUC) / PRY(APY, BOQ, PHA)
Katinasia cabrerae	ARG(MEN, NEU)
Kaunia lasiophthalma	ARG(CAT, JUJ, SAL, TUC)
Kaunia rufescens	ARG(MIS) / BRA(PAR, RGS, SCA) / PRY(CON, GUA)
Kaunia saltensis	ARG(JUJ, SAL)
Kentrothamnus weddellianus	ARG(JUJ)
Kickxia elatine	ARG(ERI) / CHL(BIO, ARA, RME, JFE) / URY(CAS, MON, PAY, SJO, TAC)
Kielmeyera coriacea	BRA(PAR) / PRY(AMA, CAN, CON)
Kielmeyera variabilis var. paranaensis	BRA(PAR)
Kielmeyera variabilis var. variabilis	BRA(PAR)
Kielmeyera variabilis var. stenophylla	BRA(PAR)
Kieslingia chilensis	CHL(ATA)
Knautia arvensis	ARG(NEU)
Knautia integrifolia	CHL(ARA)
Kniphofia uvaria	ARG(COR)
Koanophyllon simillimum	ARG(COS, MIS) / BRA(PAR, SCA) / PRY(CAU, CEN, CON, COA, GUA, PAI, PHA, SPE)
Koanophyllon solidaginoides	ARG(CAT, COS, JUJ, SAL, SDE) / PRY(APY, CHO)
Koeleria calderonii	ARG(MEN, SJU)
Koeleria fueguina	ARG(CHU, NEU, RNE, SCR, TDF) / CHL(LBO, MAU, MAG)
Koeleria inaequaliglumis	ARG(MEN, SJU)
Koeleria kurtzii	ARG(CAT, CHU, COR, JUJ, LRI, MEN, NEU, SAL, SJU, SLU, TUC) / CHL(TAR, MAU, MAG)
Koeleria mendocinensis	ARG(CHU, MEN, RNE, SCR)
Koeleria permollis	ARG(BAI, CAT, CHU, COR, ERI, JUJ, LPA, MEN, NEU, RNE, SJU, SLU, SCR, TDF) / CHL(MAU) / URY(SOR)
Koeleria praeandina	ARG(MEN)
Koeleria ventanicola	ARG(BAI)
Koeleria vurilochensis var. vurilochensis	ARG(CHU, NEU, RNE, SCR)
Koeleria vurilochensis var. patagonica	ARG(CHU, SCR)
Koenigia islandica	ARG(TDF) / CHL(MAG)
Krameria cistoidea	CHL(ANT, ATA, COQ, VAL, RME)
Krameria grandiflora	BRA(Fuera del área del proyecto) / PRY(AMA)
Krameria lappacea	ARG(CAT, JUJ, SAL, SJU, TUC) / CHL(TAR, ANT, ATA, COQ)
Krapovickasia flavescens	ARG(BAI, CAT, COR, COS, ERI, FOR, JUJ, LRI, MIS, SAL, SFE) / BRA(RGS) / PRY(ITA) / URY(ART, CAS, COL, FLO, FLA, MON, RIV, SAO, SJO, SOR, TAC)
Krapovickasia macrodon	ARG(COS, MIS) / BRA(PAR, RGS, SCA) / PRY(AMA, CAU, CAN, PAI)
Krapovickasia urticifolia	ARG(CHA, COR, COS, FOR, JUJ, MIS) / BRA(PAR, RGS) / PRY(APA, CAU, GUA, SPE) / URY(RIV)
Kummerowia striata	ARG(MIS)
Kurzamra pulchella	ARG(LRI, SJU) / CHL(ATA, COQ)
