Fabiana bryoides	ARG(CAT, JUJ, SAL) / CHL(ANT, ATA, COQ)
Fabiana densa	ARG(CAT, JUJ, SAL, TUC) / CHL(ATA)
Fabiana denudata	ARG(CAT, CHU, LRI, MEN, NEU, RNE, SJU) / CHL(TAR, ANT)
Fabiana foliosa	ARG(CHU, NEU, RNE, SCR)
Fabiana friesii	ARG(CAT, JUJ, LRI, SAL)
Fabiana imbricata	ARG(CHU, MEN, NEU, RNE, SJU) / CHL(ATA, COQ, VAL, LBO, MAU, BIO, ARA, LLA, RME)
Fabiana nana	ARG(CHU, NEU, SCR)
Fabiana patagonica	ARG(CAT, CHU, JUJ, LPA, LRI, MEN, NEU, RNE, SAL, SJU, SLU, SCR, TUC)
Fabiana peckii	ARG(BAI, CHU, LPA, LRI, MEN, NEU, RNE, SJU, SCR)
Fabiana punensis	ARG(CAT, JUJ, LRI, SAL, SJU, TUC)
Fabiana ramulosa	CHL(TAR, ANT)
Fabiana squamata	CHL(TAR, ANT)
Fabiana stephanii	CHL(AYP, TAR)
Fabiana viscosa	CHL(ATA, COQ)
Facelis lasiocarpa	ARG(CAT, JUJ, LRI, SAL, TUC)
Facelis plumosa	ARG(JUJ) / CHL(TAR)
Facelis retusa	ARG(BAI, CAT, CHA, CHU, COR, COS, ERI, LPA, LRI, MEN, MIS, RNE, SLU, SCR, SFE) / BRA(PAR, RGS, SCA) / CHL(ANT, COQ, VAL, LBO, MAU, BIO, ARA, RME) / PRY(APA, CAU, CEN, COA, GUA, ITA, PAI) / URY(ART, CAS, CLA, COL, LAV, MAL, MON, PAY, RNO, ROC, SJO, SJO, TAC)
Fagara mayu	CHL(JFE)
Fagonia chilensis	CHL(TAR, ANT, ATA, COQ)
Fallopia japonica	CHL(LLA)
Fallopia sachalinensis	CHL(LLA)
Famatina cisandina	CHL(MAU, RME)
Famatina maulensis	CHL(MAU)
Famatinanthus decussatus	ARG(LRI)
Faramea calyciflora	BRA(PAR, SCA)
Faramea cyanea	ARG(COS, MIS) / BRA(PAR) / PRY(APA, CAU, CAN, GUA, PAI)
Faramea hassleriana	PRY(CAN)
Faramea marginata	BRA(SCA)
Faramea montevidensis	BRA(PAR, RGS, SCA) / URY(MON)
Faramea multiflora	BRA(PAR, SCA)
Faramea oligantha	BRA(SCA)
Faramea porophylla	BRA(SCA) / PRY(APA, CAU, CAA, COA, PAI)
Faramea stipulacea	BRA(PAR)
Fascicularia bicolor ssp. bicolor	CHL(VAL, LBO, MAU, BIO, ARA, LLA)
Fascicularia bicolor ssp. canaliculata	CHL(MAU, BIO, ARA, LLA)
Festuca acanthophylla	ARG(JUJ, MEN, NEU, SJU, SLU) / CHL(TAR, COQ, VAL, LBO, MAU, RME)
Festuca argentina	ARG(CHU, MEN, NEU, RNE, SCR) / CHL(AIS)
Festuca argentinensis	ARG(CAT, JUJ, LRI, SAL, SJU, TUC)
Festuca arundinacea	ARG(BAI, CHU, ERI, LPA, NEU, RNE, SLU, TDF) / BRA(RGS, SCA) / CHL(MAU, BIO, LLA, MAG, RME, JFE) / URY(MON)
Festuca buchtienii	ARG(JUJ, SAL)
Festuca cabrerae	ARG(NEU)
Festuca castilloniana	ARG(TUC)
Festuca chrysophylla	ARG(CAT, JUJ, LRI, SAL, TUC) / CHL(TAR, ANT, COQ)
Festuca cirrosa	ARG(CHU, TDF) / CHL(MAG)
Festuca contracta	ARG(SCR, TDF) / CHL(MAG)
Festuca dissitiflora	ARG(CAT, COR, JUJ, LRI, MEN, SAL, SJU, SLU, TUC)
Festuca distichovaginata	ARG(JUJ, SAL, TUC)
Festuca dolichophylla	ARG(CAT, JUJ, LRI, SAL, SJU) / CHL(ANT)
Festuca fiebrigii	ARG(JUJ, SAL, TUC)
Festuca fimbriata	ARG(COS, MIS) / BRA(PAR, RGS, SCA) / PRY(CAA, ITA, MIE) / URY(CLA, MON, TAC)
Festuca gracillima var. glacialis	ARG(SCR) / CHL(MAG)
Festuca gracillima var. gracillima	ARG(SCR, TDF) / CHL(BIO, AIS, MAG)
Festuca hieronymi	ARG(CAT, COR, JUJ, LRI, SAL, SJU, SLU, TUC)
Festuca humilior	ARG(JUJ, SAL, SJU)
Festuca hypsophila	ARG(JUJ, SAL, SJU) / CHL(TAR, ANT, ATA)
Festuca juncifolia	CHL(MAG)
Festuca kurtziana	ARG(CAT, MEN, NEU, RNE) / CHL(COQ, MAU, RME)
Festuca lilloi	ARG(CAT, COR, JUJ, LRI, SAL, SLU, TUC)
Festuca magellanica	ARG(CAT, CHU, COR, LRI, MEN, NEU, RNE, SCR, TDF) / CHL(COQ, MAU, BIO, ARA, AIS, MAG, RME)
Festuca magensiana	CHL(MAG)
Festuca monticola	ARG(CHU, NEU, TDF) / CHL(MAU, BIO, ARA, LLA, MAG)
Festuca morenensis	CHL(ANT)
Festuca nardifolia	ARG(CAT, JUJ, LRI, SAL, SJU, TUC)
Festuca nemoralis	ARG(JUJ, SAL, TUC)
Festuca orthophylla	ARG(CAT, JUJ, LRI, SAL, TUC) / CHL(TAR, ANT, COQ, MAU)
Festuca ovina ssp. tenuifolia	ARG(SCR) / CHL(MAG)
Festuca pallescens	ARG(CHU, MEN, NEU, RNE, SCR) / CHL(AIS, MAG)
Festuca pampeana	ARG(BAI, SLU)
Festuca panda	CHL(TAR, COQ)
Festuca parodiana	ARG(CAT, JUJ, SJU, TUC)
Festuca parodii	ARG(CAT, JUJ, LRI, SAL)
Festuca purpurascens	ARG(CHU, NEU, SCR, TDF) / CHL(BIO, ARA, LLA, AIS, MAG, RME)
Festuca pyrogea	ARG(CHU, NEU, RNE, SCR, TDF) / CHL(ARA, AIS, MAG)
Festuca rigescens	ARG(CAT, LRI, SAL, SJU) / CHL(TAR, ANT, ATA, VAL)
Festuca roigii	ARG(MEN)
Festuca rubra	ARG(MEN, NEU, RNE, TDF) / CHL(COQ, VAL, MAG, RME)
Festuca scabriuscula	ARG(NEU, RNE) / CHL(BIO, ARA, LLA, RME)
Festuca simpliciuscula	ARG(CHU, MEN, NEU, SCR)
Festuca stuckertii	ARG(TUC)
Festuca subantarctica	ARG(TDF) / CHL(MAG)
Festuca superba	ARG(JUJ)
Festuca tectoria	CHL(TAR)
Festuca thermarum	ARG(CHU, NEU, TDF) / CHL(MAU, BIO, ARA, LLA, AIS, MAG)
Festuca tunicata	CHL(ANT, COQ, VAL, RME)
Festuca ulochaeta	ARG(JUJ, MIS, SAL) / BRA(PAR, RGS, SCA)
Festuca uninodis	ARG(CAT, JUJ, SAL, TUC)
Festuca ventanicola	ARG(BAI)
Festuca weberbaueri	ARG(JUJ, LRI, MEN, NEU, SAL, SJU)
Festuca werdermannii	CHL(ANT, ATA, COQ)
Festuca yalaensis	ARG(JUJ)
Fevillea passiflora	BRA(PAR)
Fevillea trilobata	ARG(MIS) / BRA(PAR, RGS) / PRY(APA)
Ficinia nodosa	CHL(VAL, LBO, MAU, BIO, ARA, LLA, AIS, JFE)
Ficus adhatodifolia	ARG(COS, FOR, MIS) / BRA(PAR, RGS, SCA) / PRY(APY, AMA, CAA, CEN, CON, COA, GUA, ITA, ÑEE, PAI, SPE)
Ficus calyptroceras	ARG(MIS) / BRA(PAR) / PRY(AMA, CEN, CON, COA, GUA, MIE, PAI)
Ficus cestrifolia	BRA(PAR, RGS, SCA) / URY(ROC)
Ficus citrifolia	ARG(CHA, COS, FOR, MIS) / BRA(PAR, RGS, SCA) / PRY(CAA, SPE)
Ficus enormis	BRA(PAR)
Ficus ernanii	BRA(PAR, RGS)
Ficus eximia	BRA(PAR, RGS, SCA) / PRY(AMA, CAA, CAN, CEN, CON, COA, GUA, MIE, PAI, SPE)
Ficus gomelleria	BRA(PAR, RGS, SCA)
Ficus luschnathiana	ARG(BAI, CHA, COS, ERI, MIS, SFE) / BRA(PAR, RGS, SCA) / PRY(APA, AMA, CAA, CAN, CEN, COA, GUA, ITA, ÑEE, PAI, PHA) / URY(CLA, RIV, ROC, TAC, TYT)
Ficus maroma	ARG(JUJ, SAL, TUC) / BRA(Fuera del área del proyecto)
Ficus obtusiuscula	ARG(COS, MIS) / BRA(PAR) / PRY(AMA, CON, COA, PAI)
Ficus pertusa	BRA(PAR, SCA) / PRY(AMA, CON)
Ficus pulchella	BRA(SCA)
Ficus trigona	BRA(PAR, SCA)
Fimbristylis autumnalis	ARG(BAI, CHA, COR, COS, ERI, FOR, MIS, SAL, TUC) / BRA(PAR, RGS, SCA) / PRY(APA, AMA, CAU, CAA, CEN, CON, COA, GUA, ÑEE, PAI, SPE) / URY(ART, CAS, CLA, DUR, LAV, MAL, MON, PAY, RNO, ROC, SAO, SOR, TAC, TYT)
Fimbristylis castanea	ARG(COS) / BRA(PAR)
Fimbristylis complanata	ARG(BAI, CHA, COR, COS, ERI, FOR, JUJ, MIS, SAL, SDE, TUC) / BRA(PAR, RGS) / PRY(CAU, CAA, CEN, COA, ITA, ÑEE, SPE) / URY(CAS, MAL, MON, RIV, SJO)
Fimbristylis cymosa	BRA(PAR, SCA)
Fimbristylis dichotoma	ARG(CAT, CHA, COS, ERI, FOR, JUJ, MIS, SAL, SFE, TUC) / BRA(PAR, RGS, SCA) / PRY(APY, AMA, CAU, CAA, CEN, COA, GUA, ITA, MIE, ÑEE, PAI, PHA, SPE) / URY(ART, FLA, LAV, MAL, PAY, RNO, RIV, SAO, SJO, SOR, TAC)
Fimbristylis miliacea	BRA(PAR, RGS) / PRY(ITA)
Fimbristylis spadicea	ARG(CHA, COS, ERI, FOR, SFE) / BRA(PAR, RGS, SCA) / PRY(CEN) / URY(MON, SJO)
Fimbristylis squarrosa	ARG(BAI, CHA, COR, COS, DFE, ERI, FOR, MIS, SFE) / BRA(PAR, RGS) / PRY(APY, CEN, CON, PHA) / URY(CLA, DUR, PAY, RNO, SAO, TAC)
Fimbristylis vahlii	ARG(FOR) / PRY(CON, ITA)
Fischeria stellata	ARG(MIS) / BRA(PAR, RGS, SCA) / PRY(APA, AMA, CAU, ITA)
Fitzroya cupressoides	ARG(CHU, NEU, RNE) / CHL(LLA)
Flaveria bidentis	ARG(BAI, CAT, CHA, COR, COS, ERI, FOR, JUJ, LPA, LRI, MEN, MIS, NEU, RNE, SAL, SDE, SFE, SJU, SLU, TUC) / BRA(Fuera del área del proyecto) / CHL(TAR, ANT, ATA, COQ, VAL, LBO, BIO, RME) / PRY(APY, CON, PHA) / URY(MON)
Flaveria haumanii	ARG(BAI, CAT, COR, ERI, JUJ, LPA, LRI, MEN, RNE, SJU, SLU, SDE) / CHL(TAR, ANT, ATA)
Fleischmannia dissolvens	ARG(CHA, ERI, SDE) / PRY(GUA, PHA)
Fleischmannia hassleri	PRY(CAU, CEN, COA)
Fleischmannia laxicephala	BRA(SCA)
Fleischmannia prasiifolia	ARG(CAT, CHA, COR, FOR, JUJ, LRI, MIS, SAL, SLU, SDE, TUC) / PRY(AMA, CAU, CEN, COA, GUA, PAI, SPE)
Fleischmannia schickendantzii	ARG(CAT, COR, JUJ, LRI, SAL, TUC)
Floscopa glabrata	ARG(COS, FOR, MIS) / BRA(PAR, RGS, SCA) / PRY(APA, AMA, CAU, CAA, CAN, COA, GUA, MIE, ÑEE, PAI, PHA, SPE) / URY(RIV)
Flourensia blakeana	ARG(CAT, COS, LRI, SAL, TUC)
Flourensia campestris	ARG(CAT, COR, LRI, SDE, SJU)
Flourensia fiebrigii	ARG(CAT, JUJ, LRI, SAL)
Flourensia hirta	ARG(CAT, LRI)
Flourensia hirtissima	ARG(LPA, NEU, RNE)
Flourensia leptopoda	ARG(LRI, SJU)
Flourensia macroligulata	ARG(JUJ, TUC)
Flourensia niederleinii	ARG(LRI)
Flourensia oolepis	ARG(CAT, COR, SLU)
Flourensia polyclada	ARG(LRI)
Flourensia riparia	ARG(CAT, JUJ, SAL, TUC)
Flourensia suffrutescens	ARG(JUJ, LRI, SAL)
Flourensia thurifera	CHL(COQ, VAL, RME)
Flourensia tortuosa	ARG(CAT, SAL, TUC)
Foeniculum vulgare	ARG(BAI, CAT, CHA, COR, COS, ERI, JUJ, LPA, MEN, MIS, NEU, RNE, SAL, SDE, SFE, SJU) / BRA(PAR, RGS, SCA) / CHL(TAR, ANT, COQ, VAL, LBO, MAU, BIO, ARA, LLA, RME, JFE) / PRY(APY) / URY(CAS, CLA, MAL, MON)
Fonkia uliginosa	ARG(NEU, RNE) / CHL(ARA, LLA)
Forsteronia correntina	ARG(COS)
Forsteronia glabrescens	ARG(CHA, COS, ERI, FOR, MIS, SAL, SFE) / BRA(PAR, RGS, SCA) / PRY(APA, AMA, CAU, CAA, CAN, CEN, CON, COA, GUA, ÑEE, PAI, SPE) / URY(ART, SAO)
Forsteronia leptocarpa	BRA(PAR, RGS, SCA)
Forsteronia pubescens	ARG(COS, JUJ, MIS, SAL) / BRA(PAR) / PRY(APY, APA, AMA, CAN, CEN, CON, COA, GUA, ITA, PAI, SPE)
Forsteronia refracta	ARG(MIS) / BRA(PAR, SCA) / PRY(APA, AMA, PAI)
Forsteronia rufa	BRA(PAR, SCA)
Forsteronia thyrsoidea var. thyrsoidea	ARG(COS, MIS) / BRA(PAR, RGS, SCA) / PRY(APA, CAU, CAA, CAN, PAI)
Forsteronia thyrsoidea var. glabriuscula	BRA(PAR, SCA)
Forsteronia velloziana	BRA(PAR, SCA)
Fosterella albicans	ARG(SAL)
Fosterella penduliflora	ARG(JUJ, SAL)
Fosterella rojasii	PRY(AMA)
Frailea alexanderi	BRA(PAR)
Frailea buenekeri	BRA(RGS)
Frailea castanea	ARG(ERI, MIS) / BRA(RGS) / URY(ART, RIV, SAO)
Frailea cataphracta	ARG(COS) / BRA(RGS) / PRY(COA)
Frailea curvispina	BRA(RGS)
Frailea gracillima	ARG(ERI) / BRA(RGS) / URY(ART, CLA, RIV)
Frailea mammifera ssp. angelae	ARG(ERI)
Frailea mammifera ssp. mammifera	BRA(RGS)
Frailea phaeodisca	URY(CLA, DUR, LAV, RIV, TAC)
Frailea pumila	ARG(ERI) / BRA(RGS) / PRY(APY) / URY(ART, RIV, SAO, TAC)
Frailea pygmaea ssp. pygmaea	ARG(ERI) / BRA(RGS) / URY(LAV, MAL, MON, RIV, SAO, TYT)
Frailea pygmaea ssp. albicolumnaris	BRA(RGS)
Frailea pygmaea ssp. fulviseta	BRA(RGS)
Frailea schilinzkyana	ARG(COS, ERI, MIS, SFE) / PRY(CON, PAI) / URY(RNO)
Francoa appendiculata var. appendiculata	CHL(VAL, LBO, MAU, BIO, ARA, LLA, RME)
Francoa appendiculata var. ramosa	CHL(RME)
Francoa appendiculata var. sonchifolia	CHL(BIO, LLA)
Frankenia chilensis	CHL(TAR, ANT, ATA, COQ, RME)
Frankenia chubutensis	ARG(CHU, SCR, TDF) / CHL(MAG)
Frankenia fischeri	ARG(LPA, NEU, RNE)
Frankenia juniperoides	ARG(BAI, CHU, LPA, MEN, RNE)
Frankenia microphylla	ARG(CHU, SCR) / CHL(MAG)
Frankenia patagonica	ARG(CHU, RNE, SCR)
Frankenia pulverulenta	ARG(BAI, CHU, LPA, MEN, RNE, SFE)
Frankenia salina	CHL(COQ, VAL, LBO, MAU, BIO, RME)
Frankenia triandra	ARG(CAT, JUJ, SAL, TUC) / CHL(TAR, ANT)
Frankenia vidalii	CHL(IDE)
Fraxinus excelsior	ARG(LPA)
Fraxinus ornus	ARG(LPA)
Fraxinus pennsylvanica ssp. pennsylvanica	ARG(BAI, COR, COS, DFE, ERI, LPA, RNE, TUC) / URY(PAY, RNO)
Fraxinus pennsylvanica ssp. velutina	ARG(LPA)
Freesia alba	ARG(BAI)
Freesia laxa	ARG(COS)
Fridericia candicans	BRA(Fuera del área del proyecto) / PRY(APY)
Fridericia caudigera	ARG(COS, MIS) / BRA(PAR, SCA) / PRY(APA, AMA, CAU, CAA, CAN, CEN, CON, COA, GUA, ITA, PAI, PHA, SPE)
Fridericia chica	ARG(COS, ERI, MIS) / BRA(PAR, RGS, SCA) / PRY(APA, AMA, CAU, CAA, CAN, CON, GUA, ITA, MIE, SPE)
Fridericia conjugata	BRA(PAR, RGS)
Fridericia craterophora	BRA(Fuera del área del proyecto) / PRY(AMA)
Fridericia dichotoma	ARG(CHA, COS, FOR, JUJ, MIS, SAL, SFE) / BRA(RGS, SCA) / PRY(APY, AMA, CEN, CON, COA, GUA, ITA, MIE, ÑEE, PAI, PHA, SPE)
Fridericia fagoides	BRA(Fuera del área del proyecto) / PRY(AMA)
Fridericia florida	ARG(MIS) / BRA(PAR) / PRY(APY, APA, AMA, CAU, CAA, CAN, CON, COA, PAI, SPE)
Fridericia leucopogon	BRA(PAR, SCA)
Fridericia platyphylla	BRA(PAR) / PRY(APY, AMA, CAU, CAA, CON, PAI, SPE)
Fridericia pubescens	BRA(PAR) / PRY(CON, SPE)
Fridericia samydoides	ARG(MIS, SAL) / BRA(PAR, SCA) / PRY(APY, APA, AMA, SPE)
Fridericia speciosa	BRA(PAR, RGS, SCA) / PRY(Desconocida)
Fridericia triplinervia	ARG(MIS) / BRA(PAR) / PRY(APY, APA, AMA, CAA, CAN, CEN, CON, COA, GUA, PAI, PHA, SPE)
Fridericia truncata	ARG(CHA, FOR, JUJ, SAL, SDE, TUC) / PRY(APY, AMA, CON, PHA)
Fridericia whitei	BRA(Fuera del área del proyecto) / PRY(APY)
Froelichia chacoensis	ARG(SAL) / PRY(APY, BOQ, COA, PHA)
Froelichia paraguayensis	PRY(AMA, CON, PAI)
Froelichia procera	ARG(COS, FOR, MIS) / BRA(PAR) / PRY(APA, AMA, CAU, CAN, CEN, CON, COA, GUA, ITA, PAI, SPE)
Froelichia tomentosa	ARG(COS, ERI) / BRA(Fuera del área del proyecto) / PRY(APY) / URY(RNO)
Fuchsia boliviana	ARG(CAT, JUJ, SAL, TUC)
Fuchsia brevilobis	BRA(PAR)
Fuchsia hatschbachii	BRA(PAR)
Fuchsia lycioides	CHL(COQ, VAL, RME)
Fuchsia magellanica	ARG(CHU, NEU, RNE, SCR, TDF, TUC) / CHL(VAL, LBO, MAU, BIO, ARA, LLA, AIS, MAG, RME, JFE)
Fuchsia regia ssp. serrae	BRA(PAR, RGS, SCA)
Fuchsia regia ssp. reitzii	BRA(PAR, RGS, SCA)
Fuirena incompleta f. incompleta	ARG(COS, ERI, MIS) / BRA(PAR, RGS) / PRY(CEN, COA, SPE) / URY(CLA, PAY, RNO, RIV)
Fuirena incompleta f. glabra	BRA(RGS) / PRY(PAI)
Fuirena robusta	ARG(CHA, COS, FOR, MIS) / BRA(PAR, RGS, SCA) / PRY(APY, PAI, SPE)
Fuirena umbellata	ARG(CHA, COS, FOR, MIS) / BRA(PAR, SCA) / PRY(APY, AMA, CAN, ÑEE, SPE)
Fumaria agraria	ARG(BAI, COR, SDE) / CHL(ANT, ATA, COQ, VAL, LBO, MAU, BIO, ARA, LLA, RME)
Fumaria bastardii	ARG(BAI, ERI)
Fumaria capreolata	ARG(BAI, COR, COS, ERI, LPA, MEN, RNE, SAL, SJU, SLU, SFE, TDF) / CHL(ATA, COQ, VAL, LBO, MAU, BIO, ARA, LLA, RME, JFE, IPA) / URY(MON)
Fumaria densiflora	ARG(COR, MEN, SJU) / CHL(VAL)
Fumaria officinalis	ARG(BAI, COR, COS, ERI, JUJ, MEN, RNE, SAL, SFE, SLU, TDF, TUC) / CHL(VAL) / URY(MON)
Fumaria parviflora	ARG(BAI, CAT, COR, LRI, MEN, SAL, SDE, SFE, SJU, SLU, TUC) / CHL(VAL)
Fumaria rostellata	CHL(VAL)
Funastrum clausum	ARG(BAI, CHA, COS, ERI, FOR, JUJ, SAL, SDE, SFE) / BRA(PAR) / PRY(APY, CEN, COA, PAI, PHA) / URY(ART)
Funastrum flavum	ARG(BAI, COS, ERI, MIS, SFE) / BRA(RGS) / URY(CAS, CLA, MON, SJO)
Funastrum gracile	ARG(CAT, CHA, COR, FOR, JUJ, LRI, SAL, SDE, SFE, TUC) / PRY(APY)
