Najas guadalupensis	ARG(COR, COS, SAL, SLU) / BRA(Fuera del área del proyecto)
Najas marina	ARG(COS, MEN, SLU) / BRA(Fuera del área del proyecto)
Najas microcarpa	BRA(Fuera del área del proyecto) / PRY(Desconocida)
Nama dichotomum	ARG(CAT, JUJ, LRI, SAL, SJU, TUC) / CHL(TAR, ANT, RME)
Nama jamaicensis	ARG(CAT, CHA, COR, ERI, JUJ, LRI, SAL, SDE, SFE, TUC)
Nama undulatum var. undulatum	ARG(CAT, COR, LRI, MEN, SAL, SDE, SJU, SLU, TUC)
Nama undulatum var. australe	ARG(CAT, COR, ERI, JUJ, LRI, SAL, SJU, SLU) / CHL(ATA)
Nanodea muscosa	ARG(CHU, SCR, TDF) / CHL(LLA, AIS, MAG)
Napeanthus primulifolius	BRA(PAR)
Napeanthus reitzii	BRA(PAR, SCA)
Nardophyllum bryoides	ARG(CHU, NEU, RNE, SCR, TDF) / CHL(AIS, MAG)
Nardophyllum chiliotrichioides	ARG(CHU, MEN, NEU, SCR, SJU) / CHL(COQ, RME)
Nardophyllum genistoides	CHL(RME)
Nardophyllum lanatum	CHL(ATA, COQ, VAL, LBO, RME)
Nardophyllum patagonicum	ARG(CHU)
Nasa urens	CHL(ANT)
Nassauvia aculeata var. aculeata	ARG(CHU, MEN, NEU, RNE) / CHL(VAL, LBO, MAU, BIO, ARA, RME)
Nassauvia aculeata var. azorelloides	ARG(CHU, SCR, TDF) / CHL(AIS, MAG)
Nassauvia aculeata var. robusta	ARG(CHU, NEU, RNE, SCR) / CHL(AIS)
Nassauvia ameghinoi	ARG(CHU, SCR)
Nassauvia argentea	ARG(CHU, MEN, NEU, RNE, SCR) / CHL(BIO, ARA, LLA)
Nassauvia argyrophylla	ARG(CHU, NEU, RNE, SCR)
Nassauvia axillaris	ARG(CAT, CHU, JUJ, LRI, MEN, NEU, RNE, SAL, SJU, SLU, TUC) / CHL(COQ, VAL, RME)
Nassauvia chubutensis	ARG(CHU)
Nassauvia coronipappa	CHL(MAG)
Nassauvia cumingii	ARG(MEN, NEU, SJU) / CHL(COQ, VAL, LBO, MAU, BIO, RME)
Nassauvia darwinii	ARG(CHU, NEU, RNE, SCR, TDF) / CHL(AIS, MAG)
Nassauvia dentata	ARG(CHU, NEU, RNE) / CHL(BIO, ARA, LLA, AIS, MAG, RME)
Nassauvia digitata	ARG(NEU) / CHL(MAU, BIO)
Nassauvia dusenii	ARG(CHU, RNE, SCR) / CHL(AIS, MAG)
Nassauvia falklandica	ARG(TDF)
Nassauvia fuegiana	ARG(CAT, CHU, MEN, NEU, RNE, SCR, TDF)
Nassauvia gaudichaudii	ARG(TDF)
Nassauvia glomerata	ARG(MEN, NEU) / CHL(LBO, MAU, BIO, RME)
Nassauvia glomerulosa	ARG(CHU, MEN, NEU, RNE, SCR, TDF) / CHL(MAG)
Nassauvia hillii	ARG(NEU)
Nassauvia juniperina	ARG(CHU, SCR)
Nassauvia lagascae var. globosa	ARG(CHU, RNE, SCR) / CHL(MAG)
Nassauvia lagascae var. lagascae	ARG(MEN, NEU, RNE, SJU) / CHL(COQ, VAL, LBO, MAU, RME)
Nassauvia lagascae var. lanata	ARG(CHU, MEN, NEU, RNE, SCR) / CHL(MAU, BIO, ARA, LLA, AIS, MAG)
Nassauvia latissima	ARG(TDF) / CHL(MAG)
Nassauvia looseri	CHL(RME)
Nassauvia maeviae	ARG(SCR) / CHL(AIS, MAG)
Nassauvia magellanica	ARG(SCR, TDF) / CHL(MAG)
Nassauvia pentacaenoides	ARG(SCR)
Nassauvia pinnigera	ARG(MEN, NEU) / CHL(VAL, LBO, MAU, RME)
Nassauvia planifolia	ARG(MEN, NEU)
Nassauvia pulcherrima	ARG(NEU, RNE) / CHL(LLA)
Nassauvia pygmaea var. intermedia	ARG(CHU, NEU, RNE) / CHL(BIO, ARA, LLA)
Nassauvia pygmaea var. pygmaea	ARG(SCR, TDF) / CHL(BIO, ARA, AIS, MAG)
Nassauvia pyramidalis	ARG(MEN, NEU) / CHL(LBO, MAU, BIO, RME)
Nassauvia ramosissima	CHL(LBO, MAU, BIO, LLA)
Nassauvia revoluta	ARG(CHU, MEN, NEU, RNE, SCR) / CHL(LBO, MAU, BIO, ARA, LLA, AIS, MAG, RME)
Nassauvia ruizii	ARG(MEN)
Nassauvia sceptrum	ARG(SCR)
Nassauvia serpens	ARG(TDF)
Nassauvia sprengelioides	ARG(NEU) / CHL(MAU, BIO, ARA)
Nassauvia sublobata	ARG(MEN, NEU, RNE)
Nassauvia ulicina	ARG(CHU, RNE, SCR)
Nassauvia uniflora	ARG(MEN, SJU) / CHL(COQ, VAL, RME)
Nassella airoides	ARG(BAI, MIS) / BRA(PAR, RGS, SCA) / PRY(CAU, GUA)
Nassella arcaënsis	ARG(CAT, JUJ, SAL, TUC)
Nassella arcuata	ARG(CAT, JUJ, SAL, TUC) / CHL(TAR, ANT)
Nassella arechavaletae	BRA(RGS) / URY(MAL, MON, RIV, SAO)
Nassella argentinensis	ARG(CAT, CHA, COS, SFE)
Nassella asplundii	CHL(TAR, ANT)
Nassella barbinodis	CHL(BIO, ARA, LLA)
Nassella brachychaetoides	ARG(CAT, TUC)
Nassella brachyglumis	ARG(LRI, MEN, SJU)
Nassella brachyphylla	ARG(SAL, TUC)
Nassella brasiliensis	BRA(RGS, SCA)
Nassella burkartii	ARG(BAI, COS, ERI)
Nassella cabrerae	ARG(JUJ, TUC)
Nassella caespitosa	ARG(CAT, JUJ, LRI, SAL, SJU, TUC) / CHL(ANT)
Nassella carettei	ARG(CAT, LRI, MEN, SJU)
Nassella catamarcensis	ARG(CAT)
Nassella charruana	ARG(BAI, COS, ERI) / BRA(RGS) / URY(CAS, COL, FLO, MAL, MON, PAY, SAO, SJO, SOR)
Nassella chilensis	ARG(CHU, NEU, RNE) / CHL(ANT, ATA, COQ, VAL, LBO, MAU, BIO, ARA, RME)
Nassella coquimbensis	CHL(COQ)
Nassella cordobensis	ARG(BAI, CAT, COR, LPA, LRI, MEN, SJU, SLU, SDE)
Nassella crassiflora	URY(MAL)
Nassella curamalalensis	ARG(BAI, LPA) / URY(SOR)
Nassella depauperata	ARG(CAT, JUJ, SAL, SJU, TUC)
Nassella duriuscula	CHL(ATA, COQ, VAL, LBO, BIO, LLA)
Nassella elata	ARG(JUJ, SAL)
Nassella entrerriensis	ARG(COS, ERI) / URY(CAS)
Nassella fabrisii	ARG(COR, TUC)
Nassella famatinensis	ARG(LRI, SJU)
Nassella filiculmis	ARG(BAI, CHU, COR, COS, ERI, LPA, MIS, NEU, RNE, SLU, SFE) / BRA(RGS, SCA) / CHL(BIO, ARA, LLA) / URY(FLA, LAV, MAL, PAY, SOR, TYT)
Nassella formicarum	ARG(BAI, ERI, LPA, RNE) / URY(SOR)
Nassella gibba	CHL(VAL, LBO, MAU, BIO, RME)
Nassella gigantea	ARG(CHU, NEU, RNE) / CHL(COQ, VAL, LBO, MAU, BIO, ARA, LLA, RME)
Nassella glabripoda var. glabripoda	ARG(JUJ, LRI, SJU)
Nassella glabripoda var. planifolia	ARG(JUJ, LRI)
Nassella hirtifolia	CHL(COQ, RME)
Nassella holwayii	ARG(JUJ)
Nassella hunzikeri	ARG(COR, SLU)
Nassella hyalina	ARG(BAI, CAT, COR, COS, ERI, JUJ, LPA, LRI, MEN, SLU, SFE, TUC) / BRA(RGS) / URY(CAS, FLO, FLA, MON, PAY, SOR)
Nassella inconspicua	ARG(JUJ, SAL, TUC)
Nassella juergensii	ARG(ERI) / BRA(RGS, SCA) / URY(FLO, LAV, MAL, MON, RIV, ROC, TYT)
Nassella juncea	CHL(MAU, ARA, LLA, RME)
Nassella lachnophylla	CHL(COQ, VAL, LBO, RME, JFE)
Nassella laevissima	ARG(CHU, NEU) / CHL(COQ, VAL, LBO, MAU, BIO, ARA, RME, JFE)
Nassella leptocoronata	URY(ART, COL, SAO)
Nassella leptothera	ARG(SAL, TUC)
Nassella longicoronata	URY(ART)
Nassella longiglumis	ARG(BAI, CAT, COR, JUJ, LPA, RNE, SAL, SLU, SDE, TUC) / CHL(COQ, MAU, BIO) / URY(MON)
Nassella macrathera	CHL(COQ, MAU, BIO, ARA, RME)
Nassella macrotricha	ARG(SJU)
Nassella manicata	CHL(ATA, COQ, VAL, MAU, BIO, ARA, RME)
Nassella megapotamia	ARG(BAI, COR, ERI, SLU, TUC) / BRA(PAR, RGS, SCA) / URY(CAS, COL, FLO, LAV, MAL, MON, RIV, SJO, SJO, TAC, TYT)
Nassella melanosperma	ARG(BAI, CHA, COR, COS, ERI, LPA, MIS) / BRA(PAR, RGS, SCA) / PRY(APA, AMA, CAU, CEN, MIE) / URY(FLA, LAV, MAL, MON, PAY, SJO, SOR)
Nassella mexicana	ARG(JUJ, LRI, SAL, TUC)
Nassella meyeniana	ARG(JUJ, LRI, SAL) / CHL(TAR)
Nassella meyeri	ARG(CAT, JUJ, LRI, SAL, SJU, TUC)
Nassella mucronata	ARG(SAL, TUC) / CHL(BIO)
Nassella nardoides	ARG(CAT, JUJ, LRI, SAL, SJU) / CHL(TAR, ANT, ATA)
Nassella neesiana	ARG(BAI, CAT, CHA, COR, COS, DFE, ERI, JUJ, LPA, LRI, MEN, MIS, SAL, SJU, SLU, SFE, SDE, TUC) / BRA(RGS, SCA) / CHL(COQ, VAL, BIO, ARA, LLA, RME, JFE) / PRY(COA, PAI, PHA) / URY(ART, CAS, MON, PAY, RNO, ROC, SAO, SJO, TAC, TYT)
Nassella nidulans	ARG(COR, SLU)
Nassella niduloides	ARG(CAT, COR, LRI, SLU)
Nassella novari	ARG(JUJ, SAL)
Nassella nubicola	ARG(CAT, JUJ, SAL, TUC)
Nassella nutans	BRA(RGS)
Nassella pampagrandensis	ARG(CAT, JUJ, LRI, SAL, SLU, TUC)
Nassella pampeana	ARG(BAI, CHU, COR, LPA, MEN, RNE, SJU, SLU, SCR)
Nassella paramilloensis	ARG(LRI, MEN, SJU)
Nassella parodii	CHL(BIO)
Nassella parva	ARG(CAT, JUJ, TUC)
Nassella pauciciliata	URY(MAL, ROC)
Nassella pfisteri	CHL(MAU, BIO)
Nassella philippii	ARG(BAI, COS, ERI, SFE) / BRA(RGS) / CHL(MAU, BIO, ARA, LLA) / URY(CLA, MAL, RIV, SOR)
Nassella planaltina	BRA(PAR, RGS, SCA)
Nassella poeppigiana	ARG(BAI, CHU, COR, LPA, NEU, RNE, SLU) / CHL(VAL, LBO, MAU, BIO, ARA, LLA) / URY(MAL)
Nassella pseudopampagrandensis	ARG(COR, SAL, SLU, TUC)
Nassella psittacorum	ARG(MEN)
Nassella pubiflora var. pubiflora	ARG(CAT, JUJ, LRI, SAL, SJU, TUC) / CHL(TAR, COQ)
Nassella pubiflora var. humilior	ARG(JUJ)
Nassella pubiflora var. levipoda	ARG(JUJ)
Nassella punensis	ARG(JUJ, SAL)
Nassella pungens	CHL(TAR, ANT, ATA, COQ, LBO)
Nassella quinqueciliata	URY(MAL)
Nassella ragonesei	ARG(CAT)
Nassella rhizomata	BRA(PAR, RGS, SCA)
Nassella rosengurttii	BRA(RGS) / URY(MON, SAO, SOR)
Nassella rupestris	ARG(JUJ, SAL, TUC) / CHL(TAR, ANT)
Nassella sanluisensis	ARG(BAI, CAT, COR, JUJ, LPA, LRI, MEN, NEU, RNE, SJU, SLU, SDE)
Nassella sellowiana	ARG(MIS) / BRA(PAR, RGS, SCA)
Nassella spegazzinii	ARG(COS) / URY(RNO)
Nassella stuckertii	ARG(COR)
Nassella subnitida	URY(PAY, SAO)
Nassella tenuiculmis	ARG(BAI, LPA, RNE) / BRA(RGS, SCA) / URY(TYT)
Nassella tenuis	ARG(BAI, CHU, COR, LPA, LRI, MEN, NEU, RNE, SJU, SLU, SCR) / CHL(MAG)
Nassella tenuissima	ARG(BAI, CAT, COR, COS, ERI, LPA, LRI, MEN, RNE, SJU, SLU, SCR, SFE, SDE, TUC)
Nassella torquata	ARG(BAI) / BRA(RGS) / URY(PAY, SAO)
Nassella trichotoma	ARG(BAI, CAT, CHU, COR, DFE, ERI, LPA, MEN, SLU, SFE) / BRA(RGS) / URY(MON, SJO, SOR)
Nassella tucumana	ARG(JUJ, SAL, TUC)
Nassella uspallatensis	ARG(LRI, MEN, SJU)
Nassella vallsii	BRA(PAR, RGS)
Nassella ventanicola	ARG(BAI)
Nassella yaviensis	ARG(JUJ)
Nastanthus caespitosus	CHL(ANT, ATA)
Nastanthus compactus	ARG(MEN) / CHL(MAU, RME)
Nastanthus falklandicus	ARG(TDF)
Nastanthus patagonicus	ARG(CHU, NEU, RNE, SCR)
Nastanthus scapigerus	ARG(CHU, MEN, NEU, RNE, SCR) / CHL(VAL, LBO, MAU, BIO, MAG, RME)
Nastanthus ventosus	ARG(LRI, MEN, NEU, SJU) / CHL(COQ, VAL, MAU, BIO, RME)
Nasturtium microphyllum	ARG(ERI) / CHL(VAL)
Nasturtium officinale	ARG(BAI, CAT, CHU, COR, COS, ERI, JUJ, LPA, LRI, MEN, MIS, NEU, RNE, SAL, SJU, SLU, SCR, SDE, TUC) / BRA(PAR, RGS) / CHL(TAR, ATA, COQ, VAL, LBO, MAU, BIO, LLA, RME, JFE) / PRY(CEN) / URY(MON, ROC)
Nautonia nummularia	ARG(COS, MIS) / BRA(PAR, RGS, SCA) / PRY(APA, AMA, CAN, SPE)
Navarretia involucrata	ARG(CHU, MEN, NEU, RNE, SCR) / CHL(VAL, LBO, MAU, BIO, ARA, LLA, MAG, RME)
Nectandra angusta	ARG(JUJ, SAL)
Nectandra angustifolia	ARG(CHA, COS, ERI, FOR, MIS, SFE) / BRA(PAR, RGS, SCA) / PRY(APA, CAN, ITA, ÑEE, PAI) / URY(ART, DUR, PAY, SAO, TAC)
Nectandra cissiflora	BRA(PAR, RGS, SCA)
Nectandra cuspidata	BRA(PAR) / PRY(AMA, CAN)
Nectandra grandiflora	BRA(PAR, RGS, SCA)
Nectandra hihua	BRA(Fuera del área del proyecto) / PRY(AMA)
Nectandra lanceolata	ARG(FOR, MIS) / BRA(PAR, RGS, SCA) / PRY(APA, CAU, CAA, CAN, GUA, ITA)
Nectandra leucantha	BRA(PAR, SCA)
Nectandra megapotamica	ARG(COS, ERI, FOR, MIS) / BRA(PAR, RGS, SCA) / PRY(APA, AMA, CAU, CAA, COA, GUA, ITA, PAI, SPE) / URY(CLA, RIV, ROC, SAO, SOR, TAC, TYT)
Nectandra membranacea	BRA(PAR, SCA)
Nectandra nitidula	BRA(PAR)
Nectandra oppositifolia	BRA(PAR, RGS, SCA)
Nectandra paranaensis	BRA(PAR)
Nectandra puberula	BRA(PAR, RGS, SCA) / PRY(APA, CAA)
Nectandra reticulata	BRA(PAR)
Neea hermaphrodita	BRA(Fuera del área del proyecto) / PRY(APA, AMA, CON)
Neea pendulina	BRA(PAR, SCA) / PRY(SPE)
Nelumbo nucifera	PRY(CEN)
Nematanthus australis	BRA(PAR, RGS, SCA)
Nematanthus fissus	BRA(PAR, RGS, SCA)
Nematanthus jolyanus	BRA(PAR)
Nematanthus maculatus	BRA(PAR, SCA)
Nematanthus tessmanii	BRA(PAR, RGS, SCA)
Nematanthus wettsteinii	BRA(PAR)
Neobaclea crispifolia	ARG(CHU, SCR)
Neobartsia australis	ARG(JUJ, SAL)
Neobartsia chilensis	CHL(COQ, VAL)
Neobartsia crenoloba	ARG(CAT, COR, JUJ, SAL, SLU, TUC)
Neobartsia elongata	ARG(JUJ)
Neobartsia fiebrigii	ARG(CAT, COR, JUJ, SAL, SLU)
Neobartsia jujuyensis	ARG(JUJ, SAL)
Neobartsia mutica	ARG(CAT, COR, JUJ, LRI, SAL, TUC)
Neobartsia pauciflora	ARG(SAL)
Neobartsia peruviana	ARG(CAT, JUJ, LRI, SAL, SLU, TUC) / CHL(TAR)
Neobartsia serrata	CHL(TAR)
Neobouteloua lophostachya	ARG(CAT, COR, LRI, MEN, SAL, SJU, SLU, SDE, TUC)
Neobouteloua paucirracemosa	ARG(LRI, SLU)
Neocabreria malacophylla	ARG(MIS) / BRA(SCA) / PRY(APA, ITA)
Neomarica caerulea	ARG(MIS) / BRA(PAR, RGS, SCA) / PRY(APA, CAN, COA)
Neomarica candida	ARG(COS, MIS) / BRA(PAR, RGS) / PRY(APY, APA, AMA, CAA, COA, GUA, PAI, SPE)
Neomarica glauca	BRA(SCA)
Neomarica latifolia	BRA(PAR)
Neomarica northiana	BRA(PAR) / PRY(AMA)
Neomarica rotundata	BRA(PAR)
Neomitranthes cordifolia	BRA(PAR, RGS, SCA)
Neomitranthes gemballae	BRA(RGS, SCA)
Neomitranthes glomerata	BRA(PAR, SCA)
Neomitranthes warmingiana	BRA(PAR)
Neonotonia wightii	ARG(BAI, JUJ, MIS) / PRY(COA)
Neoporteria castanea	CHL(LBO, MAU)
Neoporteria clavata	CHL(COQ)
Neoporteria nidus	CHL(COQ)
Neoporteria sociabilis	CHL(ATA)
Neoporteria subgibbosa	CHL(COQ, VAL, LBO, MAU, BIO, RME)
Neoporteria villosa	CHL(ATA, COQ)
Neoregelia chlorosticta	BRA(PAR)
Neoregelia doeringiana	BRA(PAR)
Neoregelia laevis f. laevis	BRA(PAR, SCA)
Neoregelia laevis f. maculata	BRA(PAR)
Neosparton aphyllum	ARG(LPA, MEN, NEU, RNE, SJU)
Neosparton ephedroides	ARG(BAI, CAT, CHU, MEN, NEU, SAL, TUC)
Neosparton patagonicum	ARG(CHU, SCR)
Neowerdermannia chilensis	CHL(TAR)
Neowerdermannia vorwerkii	ARG(JUJ, SAL)
Nepeta cataria	ARG(BAI, CHU, COR, LPA, MIS, NEU, RNE, SLU)
Nephrolepis biserrata	BRA(PAR)
Nephrolepis cordifolia	ARG(BAI, CAT, COR, COS, JUJ, MIS, SAL, SFE, TUC) / BRA(PAR, RGS) / PRY(CEN)
Nephrolepis exaltata	BRA(PAR, RGS)
Nephrolepis pectinata	BRA(PAR, SCA)
Nephrolepis pendula	BRA(PAR, SCA)
Nephrolepis rivularis	BRA(PAR, SCA)
Neptunia plena	PRY(APY, CON, PHA)
Neptunia pubescens	ARG(CHA, COS, ERI, FOR, SAL, SFE, SDE, TUC) / BRA(RGS) / PRY(APY, CEN, CON, COA, PAI, PHA) / URY(ART, CLA, DUR, RNO)
Nertera granadensis	ARG(CHU, NEU, RNE, SCR, TDF) / CHL(ARA, LLA, AIS, MAG, JFE)
Neslia paniculata	ARG(BAI, NEU, RNE, SFE)
Nesocaryum stylosum	CHL(IDE)
Neuontobotrys berningeri	CHL(TAR)
Neuontobotrys choiquense	ARG(MEN, NEU)
Neuontobotrys elloanensis	CHL(ANT)
Neuontobotrys frutescens	ARG(CAT, LRI, MEN, SJU)
Neuontobotrys grayana	CHL(TAR, ANT)
Neuontobotrys lanata	CHL(TAR, ANT, ATA, COQ, RME)
Neuontobotrys linearifolia	CHL(TAR, ATA)
Neuontobotrys mendocina	ARG(MEN, SJU) / CHL(RME)
Neuontobotrys polyphylla	ARG(CAT)
Neuontobotrys robusta	ARG(MEN, NEU, SJU)
Neuontobotrys tarapacana	ARG(CAT, JUJ, LRI, SAL, SJU) / CHL(TAR, ANT, ATA)
Nicandra physalodes	ARG(CAT, COR, COS, JUJ, LRI, SAL, TUC) / BRA(PAR, RGS, SCA) / CHL(TAR, COQ, VAL, RME)
Nicoraepoa andina	ARG(CHU, NEU, RNE) / CHL(MAU, BIO, ARA, LLA)
Nicoraepoa chonotica	ARG(CHU, NEU, RNE) / CHL(BIO, ARA, LLA, AIS, MAG)
Nicoraepoa erinacea	ARG(CHU)
Nicoraepoa pugionifolia	ARG(SCR, TDF) / CHL(MAG)
Nicoraepoa robusta	ARG(TDF) / CHL(AIS, MAG)
Nicoraepoa stepparia	ARG(MEN, NEU, RNE)
Nicoraepoa subenervis ssp. subenervis var. -	ARG(MEN, SCR, SJU) / CHL(MAG)
Nicoraepoa subenervis ssp. spegazziniana var. -	ARG(LRI, MEN, NEU, SJU) / CHL(RME)
Nicotiana acaulis	ARG(CHU, NEU, SCR)
Nicotiana acuminata var. acuminata	ARG(CHU, LRI, MEN, NEU, RNE, SJU) / CHL(ANT, ATA, COQ, VAL, LBO, MAU, BIO, RME)
Nicotiana acuminata var. compacta	CHL(COQ)
Nicotiana acuminata var. multiflora	CHL(ANT, ATA, COQ, VAL, MAU, BIO, ARA, LLA, RME)
Nicotiana alata	ARG(COS, ERI, MIS) / BRA(PAR, RGS, SCA) / PRY(APA, ITA) / URY(FLA, LAV, MAL, MON, PAY, RNO, RIV, SAO, SJO, TYT)
Nicotiana ameghinoi	ARG(CHU, NEU, SCR)
Nicotiana azambujae	BRA(SCA)
Nicotiana bonariensis	ARG(BAI, ERI, MIS) / BRA(PAR, RGS, SCA) / URY(ART, CAS, CLA, MAL, RIV, ROC, SJO, SOR)
Nicotiana cordifolia	CHL(JFE)
Nicotiana corymbosa var. corymbosa	ARG(CAT, CHU, LRI, MEN, NEU, RNE, SJU, SCR) / CHL(ANT, ATA, COQ, VAL, MAU, RME)
Nicotiana corymbosa var. australis	ARG(CHU, RNE, SJU, SCR)
Nicotiana forgetiana	BRA(RGS, SCA)
Nicotiana glauca	ARG(BAI, CAT, CHA, COR, COS, DFE, ERI, FOR, JUJ, LPA, LRI, MEN, MIS, SAL, SLU, SFE, SDE, TUC) / BRA(RGS) / CHL(TAR, ANT, ATA, COQ, VAL, RME) / PRY(APY, BOQ, COA, ÑEE, PAI, PHA) / URY(MON, SAO, SOR)
Nicotiana langsdorfii	ARG(MIS) / BRA(PAR, RGS, SCA) / PRY(APA)
Nicotiana linearis	ARG(CHU, MEN, NEU, RNE, SCR, SJU) / CHL(COQ, MAU)
Nicotiana longibracteata	ARG(CAT, SAL) / CHL(TAR, ANT)
Nicotiana longiflora	ARG(BAI, CAT, CHA, COR, COS, DFE, ERI, FOR, JUJ, LPA, LRI, MEN, MIS, SAL, SJU, SFE, SDE, TUC) / BRA(RGS, SCA) / PRY(CEN, CON, COA, PAI, PHA) / URY(CAS, COL, MON, PAY, RNO, SAO, SOR)
Nicotiana miersii var. lychnoides	CHL(ATA, COQ)
Nicotiana miersii var. miersii	CHL(ATA, COQ, VAL, RME)
Nicotiana mutabilis	BRA(RGS)
Nicotiana noctiflora	ARG(BAI, CAT, COR, JUJ, LPA, LRI, MEN, RNE, SAL, SJU, SDE, TUC)
Nicotiana otophora	ARG(JUJ, SAL)
Nicotiana paa	ARG(CAT, CHA, COR, JUJ, LPA, LRI, MEN, SAL, SJU, SLU, SCR, SDE, TUC) / CHL(ATA)
Nicotiana pauciflora	CHL(ATA, COQ)
Nicotiana petunioides	ARG(CAT, CHA, CHU, JUJ, LPA, LRI, MEN, NEU, RNE, SAL, SJU) / CHL(ANT, ATA)
Nicotiana plumbaginifolia	ARG(CHA, ERI, FOR, JUJ, SAL) / PRY(APY)
Nicotiana solanifolia	CHL(TAR, ANT, ATA, COQ)
Nicotiana spegazzini	ARG(CHU, LPA, MEN, NEU, RNE, SJU)
Nicotiana sylvestris	ARG(CAT, JUJ, LRI, SAL, TUC)
Nicotiana tabacum	ARG(JUJ, SAL, SJU, TUC) / BRA(PAR, RGS, SCA) / CHL(JFE) / PRY(PAI)
Nicotiana undulata	ARG(JUJ, SAL) / CHL(ANT)
Nidularium amazonicum	BRA(PAR, SCA)
Nidularium angustifolium	BRA(PAR)
Nidularium billbergioides	BRA(PAR, SCA)
Nidularium campo-alegrense	BRA(PAR, SCA)
Nidularium campos-portoi	BRA(SCA)
Nidularium catarinense	BRA(SCA)
Nidularium innocentii var. innocentii	BRA(PAR, RGS, SCA)
Nidularium innocentii var. wittmackianum	BRA(PAR, SCA)
Nidularium innocentii var. striatum	BRA(SCA)
Nidularium innocentii var. lineatum	BRA(PAR, SCA)
Nidularium jonesianum	BRA(RGS)
Nidularium microps	BRA(SCA)
Nidularium procerum	BRA(PAR, SCA)
Nidularium purpureum	BRA(PAR)
Nidularium rosulatum	BRA(PAR)
Nidularium rutilans	BRA(RGS)
Nidularium scheremetiewii	BRA(SCA)
Niedenzuella acutifolia	BRA(PAR, SCA)
Niedenzuella lucida	BRA(PAR, SCA)
Niedenzuella multiglandulosa	BRA(PAR) / PRY(COA)
Niedenzuella sericea	ARG(COS, MIS) / BRA(PAR) / PRY(ITA)
Niedenzuella stannea	BRA(Fuera del área del proyecto) / PRY(AMA)
Niedenzuella suaveolens	BRA(Fuera del área del proyecto) / PRY(COA)
Nierembergia aristata	ARG(BAI, CAT, CHA, COR, COS, ERI, FOR, MIS, SFE) / BRA(SCA) / PRY(PHA) / URY(FLA)
Nierembergia browallioides	ARG(CAT, JUJ, SAL, TUC)
Nierembergia calycina	ARG(ERI) / URY(CAS, COL, FLO, SOR)
Nierembergia ericoides	ARG(BAI)
Nierembergia graveolens	ARG(COS, ERI) / URY(CLA, SOR)
Nierembergia hatschbachii	BRA(PAR)
Nierembergia linariaefolia var. linariaefolia	ARG(BAI, CAT, CHA, COR, COS, ERI, JUJ, MIS, SAL, SLU, SDE, TUC) / BRA(RGS) / PRY(ITA, PHA) / URY(MON)
Nierembergia linariaefolia var. glabriuscula	ARG(CAT, COR, SLU)
Nierembergia linariaefolia var. pampeana	ARG(BAI, LPA, MEN, RNE, SLU)
Nierembergia linariaefolia var. pinifolioides	ARG(COR, SLU, SDE)
Nierembergia micrantha	ARG(ERI, MIS) / BRA(PAR, RGS) / URY(ART, RIV, TYT)
Nierembergia pinifolia	ARG(MIS) / BRA(RGS) / URY(ART, CLA, LAV, MAL)
Nierembergia pulchella var. pulchella	ARG(CAT, JUJ, MEN, SAL, SJU)
Nierembergia pulchella var. longistyla	ARG(SAL, TUC)
Nierembergia pulchella var. macrocalyx	ARG(CAT, JUJ, LRI, SAL, SJU)
Nierembergia repens	CHL(MAU, BIO, ARA)
Nierembergia rigida	ARG(BAI, CAT, CHA, COR, LPA, LRI, RNE, SAL, SCR, SDE, SFE, SLU, TUC)
Nierembergia riograndensis	BRA(RGS)
Nierembergia rivularis	ARG(BAI, COS, DFE, SAL) / URY(COL, SOR)
Nierembergia scoparia	ARG(BAI, COS, ERI, MIS) / BRA(RGS, SCA) / URY(CAS, CLA, COL, FLA, MON, RIV, SJO, SOR, TAC)
Nierembergia tandilensis	ARG(BAI)
Nierembergia tucumanensis	ARG(CAT, TUC)
Nierembergia veitchii	ARG(CAT, JUJ, SAL, SDE, TUC)
Niphidium crassifolium	ARG(COS, JUJ, MIS, SAL, TUC) / BRA(PAR, RGS) / PRY(CAA)
Niphidium rufosquamatum	ARG(MIS) / BRA(PAR, RGS, SCA) / PRY(CAA)
Nissolia fruticosa var. fruticosa	ARG(FOR, JUJ, MIS, SAL, TUC) / BRA(Fuera del área del proyecto) / PRY(APA, CEN, GUA, PAI, SPE)
Nissolia fruticosa var. guatemalensis	PRY(CAU, GUA)
Nitrophila atacamensis	CHL(ANT)
Nitrophila australis var. australis	ARG(BAI, CAT, JUJ, LRI, MEN, RNE, SAL, SJU)
Nitrophila australis var. kuntzei	ARG(CHU, RNE, SCR)
Noccaea magellanica	ARG(CHU, MEN, NEU, RNE, SCR, SJU, TDF) / CHL(VAL, MAU, BIO, AIS, MAG, RME)
Noisettia orchidiflora	BRA(PAR, SCA)
Nolana acuminata	CHL(ANT, ATA, COQ, VAL)
Nolana adansonii	CHL(TAR)
Nolana albescens	CHL(ANT, ATA, COQ)
Nolana aplocaryoides	CHL(TAR, ANT, ATA)
Nolana arenicola	CHL(TAR)
Nolana baccata	CHL(ANT, ATA, COQ)
Nolana balsamiflua	CHL(ANT)
Nolana carnosa	CHL(TAR, ATA)
Nolana clivicola	CHL(ANT, ATA)
Nolana coelestis	CHL(ATA, COQ)
Nolana crassulifolia	CHL(ATA, COQ, VAL)
Nolana deflexa	CHL(ATA)
Nolana dianae	CHL(ANT)
Nolana diffusa	CHL(ANT)
Nolana divaricata	CHL(ANT, ATA, COQ)
Nolana elegans	CHL(ANT, ATA)
Nolana filifolia	CHL(ATA, COQ)
Nolana foliosa	CHL(TAR)
Nolana glauca	CHL(ATA, COQ)
Nolana gracillima	CHL(TAR, ANT)
Nolana incana	CHL(ANT, ATA)
Nolana inconspicua	CHL(ANT)
Nolana intonsa	CHL(TAR)
Nolana jaffuelii	CHL(TAR, ANT)
Nolana lachimbensis	CHL(ANT)
Nolana leptophylla	CHL(TAR, ANT, ATA)
Nolana linearifolia	CHL(ANT, ATA)
Nolana lycioides	CHL(TAR, ANT)
Nolana mollis	CHL(ANT, ATA)
Nolana onoana	CHL(ANT)
Nolana paradoxa	CHL(ATA, COQ, VAL, MAU, BIO, ARA, LLA)
Nolana parviflora	CHL(ANT, ATA)
Nolana patula	CHL(ATA)
Nolana peruviana	CHL(TAR, ANT, ATA)
Nolana philippiana	CHL(ANT)
Nolana pterocarpa	CHL(TAR, ATA)
Nolana ramosissima	CHL(ANT)
Nolana reichei	CHL(COQ)
Nolana rhombifolia	CHL(TAR)
Nolana rostrata	CHL(TAR, ANT, ATA, COQ)
Nolana rupicola	CHL(ANT, ATA, COQ, VAL)
Nolana salsoloides	CHL(ANT, ATA, COQ)
Nolana sedifolia	CHL(TAR, ANT, ATA, COQ, VAL)
Nolana sessiliflora	CHL(ANT)
Nolana sphaerophylla	CHL(ANT, ATA)
Nolana stenophylla	CHL(ANT, ATA)
Nolana tarapacana	CHL(TAR, ANT, ATA)
Nolana tocopillensis	CHL(ANT)
Nolana villosa	CHL(ANT, ATA)
Nolana werdermannii	CHL(ATA)
Nopalea cochenillifera	PRY(CON, PHA)
Nordenstamia fabrisii	ARG(JUJ, SAL)
Notanthera heterophylla	CHL(VAL, LBO, MAU, BIO, ARA, LLA, RME, JFE)
Nothofagus alessandri	CHL(MAU)
Nothofagus alpina	ARG(NEU) / CHL(MAU, BIO, ARA, LLA)
Nothofagus antarctica	ARG(CHU, NEU, RNE, SCR, TDF) / CHL(MAU, BIO, ARA, LLA, AIS, MAG)
Nothofagus betuloides	ARG(SCR, TDF) / CHL(LLA, AIS, MAG)
Nothofagus dombeyi	ARG(CHU, NEU, RNE) / CHL(LBO, MAU, BIO, ARA, LLA, AIS)
Nothofagus glauca	CHL(VAL, LBO, MAU, BIO, RME)
Nothofagus macrocarpa	CHL(VAL, LBO, RME)
Nothofagus nitida	CHL(LLA, AIS, MAG)
Nothofagus obliqua	ARG(NEU) / CHL(VAL, LBO, MAU, BIO, ARA, LLA, RME)
Nothofagus pumilio	ARG(CHU, NEU, RNE, SCR, TDF) / CHL(MAU, BIO, ARA, LLA, AIS, MAG)
Notholaena sulphurea	ARG(COR, JUJ, LRI, SJU) / CHL(ATA)
Nothomyrcia fernandeziana	CHL(JFE)
Nothoscordum achalense	ARG(COR)
Nothoscordum albitractum	ARG(JUJ)
Nothoscordum altillanense	ARG(CAT, LRI, SJU)
Nothoscordum andicola	ARG(JUJ, SAL, TUC)
Nothoscordum aparadense	BRA(SCA)
Nothoscordum arenarium	ARG(BAI, CAT, COR, ERI, JUJ, LRI, SAL) / URY(COL, MON, RNO, SJO)
Nothoscordum auratum	URY(MON)
Nothoscordum balaenense	URY(MAL)
Nothoscordum basalticum	ARG(COS)
Nothoscordum bivalve var. bivalve	ARG(BAI, CHA, COS, ERI, NEU) / URY(LAV, MON)
Nothoscordum bivalve var. nanum	ARG(BAI, COS, ERI)
Nothoscordum boliviense	ARG(JUJ, TUC)
Nothoscordum bonariense	ARG(BAI, COS, ERI, MIS) / BRA(RGS, SCA) / URY(CAS, FLA, MAL, MON, PAY, ROC, SOR)
Nothoscordum calderense	ARG(SAL)
Nothoscordum cambarense	BRA(RGS)
Nothoscordum capivarinum	BRA(PAR)
Nothoscordum castilloi	BRA(RGS)
Nothoscordum catharinense	BRA(RGS, SCA)
Nothoscordum clevelandicum	BRA(PAR)
Nothoscordum collinum	BRA(RGS)
Nothoscordum conostylum	ARG(ERI)
Nothoscordum correntinum	ARG(COS)
Nothoscordum curvipes	BRA(PAR)
Nothoscordum dynamiandrum	ARG(JUJ)
Nothoscordum entrerianum	ARG(ERI)
Nothoscordum exile	BRA(PAR)
Nothoscordum famatinense	ARG(LRI)
Nothoscordum flavescens	CHL(VAL)
Nothoscordum gaudichaudianum	ARG(COS, ERI) / BRA(RGS) / URY(LAV, MAL, MON, ROC)
Nothoscordum gibbatum	BRA(SCA)
Nothoscordum glareosum	ARG(COS)
Nothoscordum gracile var. gracile	ARG(BAI, CAT, CHA, COR, COS, ERI, FOR, MIS, RNE, SJU, SFE) / BRA(RGS) / CHL(COQ, VAL, LBO, BIO, ARA, LLA, RME) / PRY(ITA) / URY(MAL, MON, SJO)
Nothoscordum gracile var. macrostemon	ARG(BAI, CHA, COR, COS, DFE, ERI) / BRA(RGS) / PRY(ITA) / URY(FLA, MAL, MON, RIV, SJO, SOR, TYT)
Nothoscordum gracilipes	BRA(PAR)
Nothoscordum gramineum var. gramineum	ARG(BAI) / CHL(VAL, LBO, BIO, ARA, LLA, RME) / URY(MAL)
Nothoscordum gramineum var. philippianum	ARG(BAI)
Nothoscordum ibiramense	BRA(SCA)
Nothoscordum inundatum	ARG(COS)
Nothoscordum ipacarainum	PRY(COA)
Nothoscordum itatiense	ARG(COS)
Nothoscordum izaguirreae	URY(LAV)
Nothoscordum leptogynum	BRA(RGS)
Nothoscordum luteomajus	BRA(PAR)
Nothoscordum macrantherum	PRY(PAI)
Nothoscordum mahui	CHL(RME)
Nothoscordum marchesii	BRA(RGS) / URY(ROC)
Nothoscordum moconense	ARG(MIS)
Nothoscordum modestum	PRY(Desconocida)
Nothoscordum montevidense ssp. latitepalum	ARG(BAI, LPA) / URY(FLA)
Nothoscordum montevidense ssp. minarum	ARG(BAI, COS, ERI) / BRA(RGS) / URY(CLA, LAV, MAL, TAC)
Nothoscordum montevidense ssp. montevidense	ARG(BAI, COS, ERI, LPA, MIS, SFE) / BRA(RGS) / URY(COL, LAV, MAL, MON, RIV, SJO, SOR)
Nothoscordum muscorum	BRA(RGS)
Nothoscordum nidulans	CHL(RME)
Nothoscordum nublense	CHL(MAU, BIO, ARA, LLA)
Nothoscordum nudicaule	ARG(BAI, CHU, COS, ERI, MEN, RNE, SJU, SLU, TUC) / BRA(RGS) / URY(LAV, MAL, RIV, SJO)
Nothoscordum nudum	ARG(ERI) / URY(LAV, MAL)
Nothoscordum nutans	BRA(PAR)
Nothoscordum ostenii	URY(PAY)
Nothoscordum pachyrhizum	URY(CLA)
Nothoscordum paradoxum	URY(DUR)
Nothoscordum patricium	ARG(COS)
Nothoscordum pedersenii	ARG(COS)
Nothoscordum planifolium	URY(LAV)
Nothoscordum portoalegrense	BRA(RGS)
Nothoscordum punillense	ARG(COR, SJU, SLU)
Nothoscordum rigidiscapum	URY(LAV)
Nothoscordum saltense	ARG(CAT, JUJ, SAL, TUC)
Nothoscordum scabridulum	URY(LAV)
Nothoscordum sengesianum	BRA(PAR)
Nothoscordum stenandrum	BRA(PAR)
Nothoscordum subtile	URY(PAY)
Nothoscordum tafiense	ARG(TUC)
Nothoscordum tarijanum	ARG(JUJ)
Nothoscordum tenuifolium	ARG(ERI)
Nothoscordum tibaginum	BRA(PAR)
Nothoscordum tricostatum	ARG(JUJ)
Nothoscordum uruguaianum	BRA(RGS)
Nothoscordum velazcoënse	ARG(LRI)
Nothoscordum yalaënse	ARG(JUJ)
Nothoscordum yatainum	ARG(COS)
Noticastrum acuminatum	ARG(BAI, CHA, COS, ERI, FOR, MIS, SFE) / BRA(PAR, RGS) / PRY(APY, PHA) / URY(CAS, COL, MON, PAY, RNO, SJO, TAC)
Noticastrum adscendens	CHL(VAL, LBO, MAU, BIO, RME)
Noticastrum antucense	CHL(BIO, ARA, LLA)
Noticastrum argenteum	ARG(CAT, COR, JUJ, LRI, SAL, SJU, TUC)
Noticastrum argentinense	ARG(BAI, COR, COS, ERI)
Noticastrum calvatum	ARG(ERI) / BRA(PAR, RGS, SCA) / URY(TAC)
Noticastrum chebataroffii	ARG(BAI, ERI) / BRA(RGS) / URY(MON)
Noticastrum decumbens	BRA(RGS, SCA)
Noticastrum diffusum	ARG(BAI, CAT, COR, COS, DFE, ERI, MEN, SAL, SLU, SFE) / BRA(RGS, SCA) / URY(CAS, CLA, COL, FLO, FLA, MAL, MON, PAY, RIV, SJO, SJO)
Noticastrum erectum	CHL(MAU, ARA, LLA)
Noticastrum eriophorum	CHL(VAL, LBO, MAU, BIO, ARA, LLA)
Noticastrum gnaphalioides	ARG(BAI, CAT, CHA, COR, COS, ERI, FOR, MIS) / BRA(PAR, RGS, SCA) / PRY(AMA, CAU, GUA) / URY(LAV, MAL, MON, PAY, RIV, SOR)
Noticastrum hatschbachii	BRA(RGS, SCA)
Noticastrum jujuyense	ARG(JUJ)
Noticastrum macrocephalum	ARG(COS, MIS) / PRY(APA, CAU, ITA, MIE, PHA)
Noticastrum malmei	BRA(RGS, SCA) / URY(ROC)
Noticastrum marginatum	ARG(BAI, CAT, COR, COS, ERI, JUJ, LRI, SAL, SJU, SLU, TUC)
Noticastrum psammophilum	BRA(RGS, SCA)
Noticastrum sericeum	ARG(BAI, CHU, COR, LPA, SLU) / CHL(VAL, LBO, MAU, BIO, ARA, LLA, RME) / URY(SAO)
Notiosciadium pampicola	ARG(BAI) / URY(CAS, CLA, FLA, SAO, SJO, SOR, TYT)
Notogrammitis angustifolia	ARG(CHU, RNE, SCR, TDF) / CHL(BIO, ARA, LLA, AIS, MAG, JFE)
Notogrammitis crassior	ARG(NEU, SCR, TDF)
Notogrammitis patagonica	ARG(CHU, SCR) / CHL(LLA, AIS, MAG)
Nototriche alternata	CHL(TAR)
Nototriche anthemidifolia	ARG(JUJ, SAL) / CHL(TAR)
Nototriche argentea	CHL(TAR, ANT)
Nototriche auricoma	CHL(TAR, ANT)
Nototriche borussica	CHL(TAR)
Nototriche cabrerae	ARG(JUJ, SAL)
Nototriche caesia	ARG(CAT, TUC)
Nototriche cajonensis	ARG(CAT, SAL)
Nototriche calchaquensis	ARG(CAT, TUC)
Nototriche castillonii	ARG(JUJ, SAL)
Nototriche chaniensis	ARG(JUJ)
Nototriche chuculaensis	ARG(CAT)
Nototriche clandestina	ARG(CAT) / CHL(ANT, ATA)
Nototriche compacta	ARG(CAT, LRI, MEN, NEU, SAL, SJU) / CHL(TAR, ANT, ATA, COQ, VAL, LBO, RME)
Nototriche copon	ARG(LRI, SJU)
Nototriche diminutiva	CHL(TAR)
Nototriche estipulata	CHL(TAR, ANT)
Nototriche famatinensis	ARG(LRI)
Nototriche friesii	ARG(JUJ)
Nototriche glabra	ARG(LRI)
Nototriche glauca	ARG(JUJ)
Nototriche hieronymi	ARG(LRI)
Nototriche hillii	ARG(LRI, SAL, SJU) / CHL(TAR, ATA)
Nototriche hunzikeri	ARG(LRI, SJU)
Nototriche kurtzii	ARG(LRI)
Nototriche leucosphaera	CHL(TAR, ANT)
Nototriche lorentzii	ARG(JUJ, SAL)
Nototriche macrotuba	ARG(JUJ)
Nototriche meyenii	CHL(TAR)
Nototriche nana	CHL(TAR)
Nototriche niederleinii	ARG(LRI)
Nototriche obcuneata var. cinerea	CHL(TAR)
Nototriche obcuneata var. obcuneata	CHL(TAR)
Nototriche orbignyana	CHL(TAR)
Nototriche ovata	ARG(LRI, SJU) / CHL(ATA)
Nototriche parviflora	ARG(JUJ) / CHL(TAR, ANT)
Nototriche pediculariifolia	CHL(TAR)
Nototriche philippii	ARG(JUJ, SAL, SJU) / CHL(ANT)
Nototriche pulverulenta	ARG(JUJ) / CHL(TAR)
Nototriche pulvilla	ARG(LRI)
Nototriche pulvinata	CHL(TAR)
Nototriche pusilla	ARG(JUJ, LRI, TUC) / CHL(TAR, ANT)
Nototriche pygmaea	ARG(JUJ, LRI, TUC) / CHL(TAR)
Nototriche rohmederi	ARG(CAT, SAL, TUC)
Nototriche rugosa	ARG(CAT, JUJ, SJU) / CHL(TAR, ANT, ATA)
Nototriche sleumeri	ARG(JUJ)
Nototriche stipularis	CHL(TAR, ANT)
Nototriche tucumana	ARG(JUJ, TUC)
Nototriche turritella	CHL(TAR)
Nototriche viridula	ARG(CAT)
Notylia cardioglossa	BRA(PAR, RGS)
Notylia hemitricha	BRA(PAR, RGS, SCA)
Notylia lyrata var. lyrata	BRA(Fuera del área del proyecto) / PRY(CEN)
Notylia lyrata var. major	PRY(CON, GUA)
Notylia pubescens	BRA(RGS, SCA)
Notylia sagittifera	BRA(SCA)
Novenia acaulis	ARG(SAL)
Nymphaea alba	CHL(MAU, BIO, ARA, LLA)
Nymphaea amazonum ssp. pedersenii	ARG(BAI, COS) / BRA(Fuera del área del proyecto) / URY(ART, TYT)
Nymphaea caerulea	ARG(MIS) / BRA(Fuera del área del proyecto)
Nymphaea gardneriana	ARG(CHA, COS, FOR, MIS) / BRA(Fuera del área del proyecto) / PRY(APY, ÑEE, PAI, SPE)
Nymphaea jamesoniana	ARG(CHA, COS, FOR, SAL, SFE, TUC) / BRA(Fuera del área del proyecto) / PRY(CEN, COA, PHA)
Nymphaea oxypetala	BRA(Fuera del área del proyecto) / PRY(PHA)
Nymphaea prolifera	ARG(CHA, COS, ERI, FOR, SFE) / BRA(RGS) / PRY(APY, COA, ÑEE, PAI) / URY(ART)
Nymphaea rudgeana	BRA(PAR)
Nymphoides indica	ARG(BAI, COS, ERI, FOR, MIS, SFE, TUC) / BRA(PAR, RGS, SCA) / PRY(AMA, CEN, COA, GUA, ÑEE, PAI, PHA) / URY(MAL, ROC)
Nymphoides verrucosa	ARG(COS) / PRY(CON, COA)
