Baccharis acaulis	ARG(CAT, JUJ, SAL) / CHL(TAR, ANT)
Baccharis albida	ARG(BAI, CHA, COS, ERI, SFE)
Baccharis aliena	ARG(COR, LRI, SLU) / BRA(RGS, SCA) / URY(CAS, CLA, CLA, FLA, LAV, MAL, MON, RNO, RIV, ROC, TAC, TYT)
Baccharis alnifolia	CHL(TAR, ANT)
Baccharis alpina	ARG(CAT, JUJ, SAL, TUC)
Baccharis amambayensis	PRY(AMA)
Baccharis angusticeps	BRA(PAR, RGS)
Baccharis anomala	ARG(ERI, MIS) / BRA(PAR, RGS, SCA) / PRY(CAA, GUA) / URY(ART, DUR, RNO, RIV, TAC, TYT)
Baccharis aphylla	BRA(PAR)
Baccharis apicifoliosa	BRA(RGS, SCA)
Baccharis aracatubensis	BRA(PAR, SCA)
Baccharis arenaria	ARG(COS, ERI) / BRA(RGS, SCA) / URY(CAS, COL, FLA, LAV, MAL, MON, ROC)
Baccharis argentina	ARG(CAT, JUJ, LRI, MIS, SAL, TUC)
Baccharis artemisioides	ARG(BAI, CAT, COR, COS, ERI, LPA, RNE, SLU, SFE, TUC)
Baccharis articulata	ARG(BAI, CAT, CHA, COR, COS, ERI, JUJ, LPA, LRI, MIS, SAL, SLU, SFE, SDE, TUC) / BRA(PAR, RGS, SCA) / PRY(APA, AMA, CAU, CEN, COA, GUA, ITA, PAI, SPE) / URY(ART, CAS, CLA, COL, FLA, LAV, MAL, MON, RNO, RIV, ROC, SJO, SJO, TYT)
Baccharis axillaris	BRA(PAR, SCA)
Baccharis axillaris var. dentata	
Baccharis boliviensis var. boliviensis	ARG(CAT, JUJ, SAL, TUC) / CHL(TAR, ANT, ATA, COQ)
Baccharis brachylaenoides	ARG(MIS) / BRA(PAR, RGS, SCA)
Baccharis brachylaenoides var. polycephala	ARG(MIS) / BRA(PAR, RGS, SCA)
Baccharis brachystachys	BRA(PAR, RGS, SCA) / URY(MON)
Baccharis brevifolia	BRA(PAR, RGS, SCA) / URY(TYT)
Baccharis breviseta	ARG(BAI, CHA, COS, ERI, MIS) / BRA(PAR, RGS, SCA) / PRY(CAA, CON, COA, GUA, ITA) / URY(CAS, CLA, COL, FLA, MON, RNO, ROC, SJO, TAC)
Baccharis cabrerae	ARG(SAL)
Baccharis caespitosa var. caespitosa	ARG(JUJ, SAL, TUC) / CHL(TAR, ANT, LBO)
Baccharis calliprinos	ARG(CAT, LRI, MEN, SAL, SJU, TUC) / CHL(TAR, ANT)
Baccharis calvescens	BRA(PAR, SCA)
Baccharis camporum f. camporum	ARG(COS, MIS, SAL) / BRA(PAR, SCA) / PRY(AMA, CAU, CAN, CEN, SPE)
Baccharis camporum f. parvifolia	BRA(SCA)
Baccharis capitalensis	ARG(JUJ, SAL, TUC)
Baccharis caprariifolia	ARG(BAI, COS, ERI, MIS) / BRA(PAR, RGS, SCA) / PRY(APA, CAU, CAN, GUA, SPE) / URY(RIV, TYT)
Baccharis chionolaenoides	BRA(SCA)
Baccharis cognata	ARG(COS, MIS) / BRA(PAR, RGS, SCA) / PRY(AMA, CAU, CAA, CEN, CON, COA, GUA, MIE, PAI)
Baccharis concava	CHL(BIO)
Baccharis concinna	BRA(PAR)
Baccharis conyzoides	BRA(PAR, RGS, SCA)
Baccharis cordobensis	ARG(BAI, COR, COS, LPA, SFE)
Baccharis coridifolia	ARG(BAI, CAT, CHA, COR, COS, ERI, FOR, JUJ, LPA, LRI, MEN, MIS, SAL, SJU, SLU, SFE, SDE, TUC) / BRA(PAR, RGS, SCA) / PRY(MIE) / URY(ART, CAS, COL, CLA, LAV, MAL, MON, PAY, RNO, SJO, TAC, TYT)
Baccharis coronata	BRA(RGS, SCA)
Baccharis crispa	ARG(BAI, CAT, CHU, COR, LPA, LRI, MEN, MIS, RNE, SAL, SJU, SLU, SFE, TUC) / BRA(PAR, RGS, SCA) / PRY(AMA, CAU, CAA, CAN, GUA, PAI) / URY(LAV, MAL, MON)
Baccharis cultrata	BRA(PAR, RGS, SCA) / URY(LAV, MAL, MON, RIV, TAC)
Baccharis curitybensis	BRA(PAR, SCA)
Baccharis cymosa	CHL(LLA)
Baccharis darwinii	ARG(BAI, CAT, CHA, CHU, COR, COS, ERI, FOR, LPA, LRI, MEN, NEU, RNE, SAL, SJU, SLU, SCR, SFE, SDE, TUC) / CHL(LLA) / URY(RNO)
Baccharis deblei	BRA(RGS, SCA)
Baccharis deltoidea	BRA(RGS)
Baccharis dentata	ARG(MIS) / BRA(PAR, RGS, SCA) / PRY(AMA, GUA)
Baccharis divaricata	ARG(BAI, CHU, RNE)
Baccharis dracunculifolia	ARG(BAI, CAT, CHA, COS, ERI, FOR, JUJ, MIS, SAL, SFE, TUC) / BRA(PAR, RGS, SCA) / PRY(AMA, CAU, CAA, CAN, CEN, COA, GUA, MIE, PAI) / URY(ART, CAS, CLA, FLA, LAV, MAL, PAY, RNO, RIV, SAO, TAC, TYT)
Baccharis dracunculifolia ssp. tandilensis	ARG(BAI)
Baccharis dunensis	BRA(RGS)
Baccharis effusa	ARG(CAT, JUJ, SAL, TUC)
Baccharis elaeoides	ARG(CHU, RNE) / CHL(BIO, LLA)
Baccharis elliptica	BRA(PAR)
Baccharis erigeroides	BRA(PAR, RGS, SCA)
Baccharis erioclada	BRA(PAR, RGS, SCA) / PRY(AMA)
Baccharis famatinensis	ARG(LRI)
Baccharis flabellata	ARG(COR, LPA, LRI, SDE, SJU, SLU) / BRA(RGS) / URY(ART, PAY, SAO)
Baccharis flexuosiramosa	BRA(RGS, SCA)
Baccharis floccosa	BRA(RGS, SCA)
Baccharis frenguellii	ARG(CHA, COS, ERI, SFE) / PRY(CEN, COA, PAI)
Baccharis genistifolia	ARG(BAI, CHU, COR, LPA, SFE) / URY(CAS, FLO, MAL, MON, ROC, SJO)
Baccharis gibertii	BRA(RGS, SCA) / URY(CAS, MAL, MON, SJO)
Baccharis gilliesii	ARG(BAI, CAT, CHA, CHU, COR, COS, ERI, JUJ, LPA, LRI, MEN, RNE, SAL, SJU, SLU, SFE, SDE, TUC)
Baccharis glaucescens	PRY(AMA, CON)
Baccharis glaziovii	BRA(PAR, RGS, SCA)
Baccharis glutinosa	ARG(BAI, CAT, CHA, CHU, COR, COS, DFE, ERI, FOR, JUJ, LPA, LRI, MEN, MIS, NEU, RNE, SAL, SJU, SLU, SFE, SDE) / BRA(PAR, RGS, SCA) / CHL(ANT, ATA, COQ, VAL, LBO, MAU, BIO, ARA, LLA, RME) / PRY(APY, AMA, CAU, CAN, CEN, COA, GUA, MIE, PAI) / URY(CAS, CLA, COL, MAL, MON, PAY, RNO, SJO, SJO)
Baccharis gnaphalioides	ARG(BAI) / BRA(RGS, SCA) / URY(CAS, MAL, MON, ROC, TAC)
Baccharis gracilis	BRA(PAR, SCA) / PRY(CAA, GUA)
Baccharis grisebachii	ARG(CAT, JUJ, LRI, MEN, SAL, SJU, TUC)
Baccharis helichrysoides	ARG(MIS) / BRA(PAR, RGS, SCA) / PRY(APA, AMA, CAU, CAA)
Baccharis hirta	BRA(RGS, SCA) / URY(MAL, MON, RIV)
Baccharis humilis	BRA(SCA)
Baccharis hyemalis	BRA(RGS)
Baccharis hypericifolia	BRA(RGS)
Baccharis illinitoides	PRY(AMA)
Baccharis incisa var. incisa	BRA(PAR, RGS, SCA) / URY(MON)
Baccharis incisa var. dentata	BRA(RGS)
Baccharis inexspectata	BRA(RGS)
Baccharis intermedia	CHL(COQ, VAL, LBO, RME)
Baccharis intermixta	BRA(PAR, RGS, SCA)
Baccharis isabelae	PRY(CEN, COA, PAI)
Baccharis itapirocensis	BRA(PAR)
Baccharis jocheniana	BRA(RGS)
Baccharis juncea ssp. clavata	ARG(CAT, JUJ, LRI, SAL)
Baccharis juncea	ARG(BAI, CAT, CHU, COR, ERI, JUJ, LPA, LRI, MEN, NEU, RNE, SAL, SCR, SDE, SFE, SJU, SLU, TUC) / CHL(TAR, ANT, ATA, COQ, VAL, MAU, LLA, RME) / URY(MON)
Baccharis kurtziana	ARG(LRI, SAL, SJU)
Baccharis lateralis	BRA(PAR, RGS, SCA)
Baccharis latifolia	ARG(CAT, JUJ, LRI, SAL, TUC)
Baccharis leucocephala	BRA(PAR, RGS, SCA)
Baccharis leucopappa	BRA(PAR, RGS, SCA)
Baccharis lilloi	ARG(CAT, JUJ, SAL, TUC)
Baccharis linearifolia	ARG(BAI, CAT, CHA, COR, COS, ERI, FOR, JUJ, LPA, LRI, MEN, MIS, RNE, SAL, SJU, SLU, SFE) / BRA(PAR, RGS, SCA) / PRY(APA, AMA, CAU, CAA, CAN, CEN, COA, PAI, PHA, SPE) / URY(CAS, COL, FLA, MAL, MON, PAY, RNO, RIV, ROC, TAC, TYT)
Baccharis linearifolia ssp. polycephala	ARG(MIS, SAL)
Baccharis linearis ssp. linearis	ARG(CHU, MEN, NEU, RNE, SJU) / CHL(ATA, COQ, VAL, LBO, MAU, BIO, ARA, LLA, RME)
Baccharis linearis ssp. pycnocephala	ARG(CHU, NEU, RNE) / CHL(VAL, LBO, MAU, BIO, ARA, LLA)
Baccharis longoattenuata	BRA(RGS, SCA)
Baccharis lycioides	ARG(NEU) / CHL(MAU, BIO, ARA, LLA)
Baccharis lymannii	BRA(PAR, RGS, SCA)
Baccharis macraei	CHL(COQ, VAL, LBO, RME)
Baccharis magellanica	ARG(CHU, MEN, NEU, RNE, SCR, TDF) / CHL(MAU, BIO, ARA, LLA, AIS, MAG)
Baccharis malmei	BRA(PAR)
Baccharis megapotamica var. megapotamica	ARG(MIS) / BRA(PAR, RGS, SCA) / PRY(CAU, CAA, GUA) / URY(RIV, ROC, TAC, TYT)
Baccharis megapotamica var. weirii	BRA(PAR, RGS, SCA)
Baccharis melanopotamica	ARG(BAI, CHU, COR, LPA, RNE, SLU)
Baccharis mesoneura	BRA(RGS, SCA)
Baccharis microcephala	ARG(CHA, COS, DFE, ERI, FOR, MIS, SFE) / BRA(PAR, RGS, SCA) / PRY(CAU, CAA, CEN, COA, GUA, ÑEE, PAI, SPE) / URY(ART, CAS, CLA, FLA, LAV, MAL, MON, PAY, RNO, ROC, SJO, SOR, TAC, TYT)
Baccharis microdonta	ARG(CAT, COS, JUJ, MIS, SAL, TUC) / BRA(PAR, RGS, SCA) / URY(CAS, FLA, LAV, MAL, MON, ROC, SAO)
Baccharis milleflora	BRA(PAR, RGS, SCA)
Baccharis minutiflora	BRA(RGS, SCA)
Baccharis montana	ARG(MIS) / BRA(PAR, RGS, SCA) / PRY(APA, CAU, CAN, GUA, ITA, PAI)
Baccharis muelleri	BRA(PAR, SCA)
Baccharis multiflosculosa	ARG(SAL)
Baccharis multifolia	BRA(RGS)
Baccharis mylodontis	CHL(MAG)
Baccharis myricifolia	BRA(PAR, SCA)
Baccharis myriocephala	BRA(PAR, RGS, SCA) / PRY(CAA) / URY(Desconocida)
Baccharis napaea	BRA(PAR, RGS, SCA)
Baccharis neaei	ARG(CHU, JUJ, MEN, NEU, RNE) / CHL(COQ, VAL, LBO, MAU, BIO, ARA, LLA, RME)
Baccharis nebulae	BRA(PAR, SCA)
Baccharis nebularis	BRA(PAR, SCA)
Baccharis neorupestris	ARG(CAT, JUJ, SAL, TUC)
Baccharis niederleinii var. niederleinii	ARG(LRI, SJU)
Baccharis niederleinii var. potrerillana	ARG(LRI, SJU)
Baccharis nitida	ARG(SAL) / BRA(PAR, RGS, SCA)
Baccharis nivalis	ARG(CHU, NEU, RNE, SCR, TDF) / CHL(BIO, ARA, LLA, AIS, MAG)
Baccharis notosergila	ARG(BAI, CHA, COR, COS, ERI, FOR, SDE, SFE) / BRA(RGS) / PRY(CAU, CEN, COA, PHA) / URY(CAS, FLO, FLA, MON, PAY, RNO, SJO, SOR, TAC)
Baccharis nummularia	BRA(PAR, RGS, SCA)
Baccharis obovata	ARG(CHU, NEU, RNE, SCR) / CHL(VAL, LBO, MAU, BIO, ARA, LLA, AIS, RME)
Baccharis ochracea	ARG(ERI) / BRA(RGS, SCA) / URY(CLA, LAV, MAL, MON, RIV, ROC, TAC, TYT)
Baccharis opuntioides	BRA(SCA)
Baccharis oreophila	BRA(PAR)
Baccharis organensis	BRA(PAR, RGS, SCA)
Baccharis oxyodonta	ARG(MIS) / BRA(PAR, RGS, SCA) / PRY(APY, APA, AMA, CAA, CEN, GUA, PAI) / URY(CAS, COL, FLA, MAL, MON)
Baccharis palustris	BRA(RGS, SCA)
Baccharis pampeana	BRA(RGS)
Baccharis paniculata	CHL(COQ, VAL, LBO, MAU, BIO, RME)
Baccharis paranensis	BRA(PAR, RGS, SCA)
Baccharis patagonica	ARG(CHU, NEU, RNE, SCR, TDF) / CHL(MAU, BIO, ARA, LLA, AIS, MAG, JFE)
Baccharis patagonica ssp. palenae	ARG(CHU, NEU, RNE)
Baccharis patens	BRA(RGS) / URY(LAV, MAL, MON)
Baccharis pauciflosculosa	BRA(PAR, SCA)
Baccharis pedersenii	ARG(COS, ERI, SFE) / PRY(COA, GUA, ITA)
Baccharis penningtonii	ARG(BAI, COS, DFE, ERI, SFE) / BRA(RGS) / URY(CAS, COL, MON, SJO)
Baccharis pentaptera	ARG(COS) / BRA(PAR, RGS, SCA)
Baccharis pentodonta	BRA(PAR, RGS, SCA) / PRY(CAU, GUA)
Baccharis pentziifolia var. pentziifolia	BRA(PAR, RGS, SCA)
Baccharis pentziifolia var. minor	BRA(PAR, RGS, SCA)
Baccharis perulata	ARG(CAT, JUJ, LRI, SAL, TUC)
Baccharis petraea	ARG(MIS) / BRA(SCA) / PRY(CEN, COA, PAI) / URY(FLO, FLA)
Baccharis petrophila	ARG(JUJ, SAL)
Baccharis phylicifolia	BRA(RGS, SCA)
Baccharis phyteuma	ARG(BAI, ERI, SFE)
Baccharis phyteumoides	ARG(BAI, CHA, COS, ERI, MIS, SFE) / BRA(RGS) / PRY(ÑEE) / URY(ART, CAS, COL, FLA, MAL, MON, PAY, RNO, RIV, ROC, SAO, SJO, SOR)
Baccharis pilcensis	CHL(MAU, BIO)
Baccharis poeppigiana ssp. austropedicellata	ARG(NEU) / CHL(LBO, MAU, BIO, RME)
Baccharis poeppigiana ssp. ocellata	ARG(NEU) / CHL(LBO, MAU, BIO)
Baccharis poeppigiana ssp. poeppigiana	CHL(COQ, VAL, RME)
Baccharis polifolia	ARG(CAT, JUJ, LRI, MEN, SAL, SJU, TUC)
Baccharis polygama	ARG(TUC)
Baccharis pseudomyriocephala	BRA(PAR, RGS, SCA)
Baccharis pseudovillosa	BRA(PAR, RGS, SCA)
Baccharis psiadioides	BRA(RGS, SCA) / URY(CLA, RIV, TAC, TYT)
Baccharis pulchella	ARG(CAT, COR, JUJ, LRI, MEN, SAL, SJU, SLU, TUC)
Baccharis punctulata	ARG(BAI, CAT, CHA, COS, ERI, FOR, JUJ, MIS, SFE, TUC) / BRA(PAR, RGS, SCA) / PRY(APA, AMA, CAA, CAN, CEN, COA, GUA, PAI, SPE) / URY(ART, CLA, COL, DUR, FLA, MAL, MON, PAY, SJO, SOR, TAC, TYT)
Baccharis pycnantha	CHL(ATA)
Baccharis quitensis	ARG(CAT, JUJ, LRI, SAL, TUC) / BRA(SCA)
Baccharis racemosa	ARG(CHU, NEU, RNE) / CHL(VAL, BIO, ARA, LLA)
Baccharis ramboi	BRA(RGS, SCA)
Baccharis retamoides	ARG(CAT, LRI, MEN, SAL, SJU, TUC)
Baccharis reticularia	BRA(PAR, SCA)
Baccharis reticularioides	BRA(PAR)
Baccharis retusa	BRA(PAR, RGS, SCA) / PRY(CAU, CEN, COA)
Baccharis rhexioides	ARG(JUJ, SAL)
Baccharis rhomboidalis	CHL(ATA, VAL, LBO, MAU, BIO, ARA, LLA, RME)
Baccharis rhomboidalis ssp. truncata	ARG(NEU, RNE)
Baccharis riograndensis	BRA(RGS)
Baccharis rodriguezii	ARG(SAL, TUC)
Baccharis rufescens var. ventanicola	ARG(BAI)
Baccharis sagittalis	ARG(CHU, MEN, NEU, RNE, SJU) / BRA(RGS, SCA) / CHL(TAR, ATA, COQ, VAL, LBO, MAU, BIO, ARA, LLA, AIS, RME)
Baccharis salicifolia	ARG(BAI, CAT, CHA, CHU, COR, COS, DFE, ERI, FOR, JUJ, LPA, LRI, MEN, MIS, NEU, RNE, SAL, SCR, SDE, SFE, SJU, SLU, TUC) / CHL(TAR, ANT, ATA, COQ, VAL, LBO, MAU, BIO, ARA, LLA, RME) / PRY(APY, BOQ, CEN, PHA) / URY(COL)
Baccharis samensis	ARG(SAL)
Baccharis santelicis ssp. santelicis	ARG(MEN, SJU) / CHL(TAR)
Baccharis santelicis ssp. chrysophylla	CHL(TAR)
Baccharis scabrifolia	BRA(RGS, SCA)
Baccharis scopulorum	BRA(SCA)
Baccharis sculpta	ARG(CAT, JUJ, LRI, SAL, TUC)
Baccharis selloi	BRA(PAR, RGS, SCA)
Baccharis semiserrata	ARG(MIS) / BRA(PAR, RGS, SCA) / PRY(GUA, ITA, PAI)
Baccharis sessiliflora	ARG(BAI, CHA, COR, COS, ERI, LPA, SFE) / BRA(PAR, RGS, SCA) / PRY(APY, APA, CAU, CEN, PHA) / URY(MAL, MON, PAY, RIV)
Baccharis sessilifolia	CHL(VAL, MAU, BIO)
Baccharis singularis	BRA(PAR, RGS, SCA)
Baccharis spartioides	ARG(BAI, CAT, CHU, COR, JUJ, LPA, LRI, MEN, NEU, RNE, SAL, SCR, SJU, SLU, TUC) / CHL(ATA, COQ)
Baccharis sphaerocephala	CHL(BIO, LLA)
Baccharis sphagnophila	BRA(RGS, SCA)
Baccharis spicata	ARG(BAI, CHA, COR, COS, DFE, ERI, FOR, LPA, SDE, SFE) / BRA(PAR, RGS, SCA) / PRY(CEN, COA, PAI, PHA) / URY(CAS, CLA, COL, FLA, LAV, MAL, MON, RNO, ROC, SAO, SJO, TAC, TYT)
Baccharis stenophylla	ARG(BAI, CAT, COR, LPA, LRI, SLU, SFE) / URY(COL, FLO, FLA, MON, RNO)
Baccharis subdentata	BRA(PAR, RGS, SCA) / PRY(CAU, CAA)
Baccharis suberectifolia	BRA(PAR)
Baccharis subtropicalis	BRA(PAR, RGS, SCA) / URY(MON)
Baccharis taltalensis	CHL(ANT, ATA)
Baccharis tarchonanthoides	BRA(PAR)
Baccharis tenella	ARG(BAI, CAT, CHU, COR, LPA, LRI, MEN, NEU, RNE, SCR, SLU)
Baccharis tenuiptera	BRA(RGS)
Baccharis thymifolia	ARG(MEN)
Baccharis tola ssp. tola	ARG(CAT, JUJ, LRI, MEN, SAL, SJU, TUC) / CHL(ANT, ATA)
Baccharis tola ssp. altiplanicola	CHL(TAR, ANT)
Baccharis tola ssp. fimbriata	ARG(JUJ, SAL)
Baccharis tola ssp. santelicis var. incarum	ARG(JUJ)
Baccharis triangularis	ARG(BAI, CHU, LPA, RNE, SLU)
Baccharis tridentata	ARG(BAI, CHA, COR, COS, ERI, FOR, JUJ, LPA, MIS, SAL, SFE) / BRA(PAR, RGS, SCA) / PRY(AMA, CAU, CAA, CAN, CON, GUA, MIE) / URY(CAS, LAV, MAL, MON, RIV, SAO, TAC)
Baccharis trilobata	BRA(PAR, SCA)
Baccharis trimera	ARG(BAI, COR, COS, ERI, JUJ, LPA, MIS, SAL, SFE) / BRA(PAR, RGS, SCA) / PRY(APA, AMA, CAU, CAA, CAN, GUA, ITA, MIE, PAI, SPE) / URY(ART, CAS, CLA, COL, DUR, LAV, MAL, MON, PAY, RNO, RIV, ROC, SJO, SOR, TAC, TYT)
Baccharis trinervis var. trinervis	ARG(CHA, COS, FOR, JUJ, MIS, SAL, SDE) / BRA(PAR, RGS, SCA) / PRY(APY, AMA, BOQ, CAN, CEN, CON, COA, GUA, PAI, PHA, SPE)
Baccharis trinervis var. debilis	ARG(CHA, COS, FOR, JUJ, MIS, SAL) / PRY(APY, CON)
Baccharis trineura	BRA(Fuera del área del proyecto) / PRY(APY)
Baccharis tucumanensis var. tucumanensis	ARG(CAT, COR, JUJ, LRI, SAL, SLU, TUC)
Baccharis uleana	BRA(SCA)
Baccharis ulicina	ARG(BAI, CAT, CHA, COR, COS, ERI, JUJ, LPA, LRI, RNE, SAL, SCR, SDE, SFE, SLU, TUC)
Baccharis umbellata	BRA(PAR)
Baccharis uncinella	BRA(PAR, RGS, SCA)
Baccharis usterii	BRA(PAR, RGS, SCA)
Baccharis venosa	CHL(TAR)
Baccharis vernalis	CHL(COQ, VAL, LBO, MAU, BIO)
Baccharis vincifolia	BRA(PAR, RGS, SCA) / URY(MON)
Baccharis vismioides	BRA(PAR)
Baccharis vulneraria	ARG(BAI, CHA, COS, ERI, MIS, SFE) / BRA(PAR, RGS, SCA) / PRY(CAU, CEN, COA, GUA, PAI) / URY(ART, CAS, COL, FLA, MAL, MON, RNO, ROC, SJO, TAC, TYT)
Baccharis zoellneri ssp. zoellneri	ARG(TDF) / CHL(LLA, AIS, MAG)
Baccharis zoellneri ssp. minor	CHL(BIO, ARA)
Bacopa australis	ARG(COS) / BRA(PAR, RGS, SCA)
Bacopa cladostyla	ARG(COS)
Bacopa congesta	ARG(COS, MIS) / BRA(RGS) / PRY(AMA, CAN, CEN, COA, PAI)
Bacopa dubia	ARG(COS, FOR, MIS) / PRY(ÑEE)
Bacopa gratioloides	BRA(Fuera del área del proyecto) / PRY(CON)
Bacopa hirsuta	ARG(COS, MIS) / PRY(AMA)
Bacopa lanigera	BRA(RGS, SCA)
Bacopa monnieri	ARG(BAI, CAT, CHA, COR, COS, DFE, ERI, FOR, JUJ, LRI, MEN, SAL, SDE, SFE, SJU, SLU, TDF, TUC) / BRA(PAR, RGS, SCA) / CHL(TAR, ANT, ATA, COQ) / PRY(CAA, PHA) / URY(CAS, COL, FLA, LAV, MAL, MON, RNO, ROC, SJO, SOR)
Bacopa monnierioides	ARG(MIS) / BRA(PAR, RGS) / PRY(COA)
Bacopa myriophylloides	BRA(PAR)
Bacopa paraguariensis	ARG(CHA, COS, FOR) / PRY(GUA)
Bacopa rotundifolia	ARG(BAI, CHA, COR, COS, DFE, ERI, FOR, SFE) / BRA(Fuera del área del proyecto) / PRY(CAA, CON, PHA)
Bacopa salzmannii	ARG(CHA, COS, FOR, MIS) / BRA(PAR, RGS) / PRY(CAN, COA, ÑEE)
Bacopa scabra var. scabra	ARG(CHA, COS, MIS) / BRA(RGS) / PRY(CAA, CAN)
Bacopa scabra var. laxiflora	BRA(RGS, SCA) / PRY(CON, ÑEE)
Bacopa serpyllifolia	ARG(MIS) / BRA(PAR, RGS, SCA) / PRY(SPE)
Bacopa stricta	BRA(PAR, SCA)
Bacopa verticillata	ARG(COS) / BRA(Fuera del área del proyecto) / PRY(SPE)
Bactris gasipaes	ARG(SAL) / BRA(Fuera del área del proyecto) / PRY(CAN)
Bactris glaucescens	BRA(Fuera del área del proyecto) / PRY(APY, AMA, CON, SPE)
Bactris hatschbachii	BRA(PAR)
Bactris setosa	BRA(PAR, RGS, SCA)
Bactris vulgaris	BRA(PAR)
Bahia ambrosioides	CHL(ANT, ATA, COQ, VAL, RME, JFE)
Baillonia amabilis	ARG(FOR) / PRY(APY, CON, PHA)
Bakerolimon plumosum	CHL(ANT, ATA)
Balbisia aphanifolia	ARG(CAT, LRI, SJU, SLU)
Balbisia calycina	ARG(CAT, JUJ, LRI, SAL, SLU, TUC)
Balbisia gracilis	ARG(CHU, NEU, RNE) / CHL(COQ, VAL, LBO, MAU, BIO, ARA, AIS, RME)
Balbisia integrifolia	ARG(JUJ)
Balbisia meyeniana	ARG(JUJ)
Balbisia microphylla	CHL(TAR, ATA)
Balbisia miniata var. miniata	ARG(LRI, SAL, SJU)
Balbisia miniata var. anomala	ARG(SAL)
Balbisia peduncularis	CHL(ANT, ATA, COQ)
Balbisia stitchkinii	CHL(TAR)
Balfourodendron riedelianum	ARG(COS, MIS) / BRA(PAR, RGS, SCA) / PRY(APA, AMA, CAU, CAA, CAN, CEN, CON, ITA, PAI, SPE)
Ballota nigra ssp. nigra	ARG(BAI) / URY(CAS, MON)
Ballota nigra ssp. foetida	ARG(BAI)
Ballota nigra ssp. velutina	ARG(DFE)
Balsamocarpon brevifolium	CHL(ATA, COQ)
Baltimora geminata	PRY(APY)
Banara arguta	ARG(CHA, COS, ERI, FOR, SFE) / BRA(Fuera del área del proyecto) / PRY(APY, AMA, CEN, CON, COA, ÑEE, PHA)
Banara parviflora	ARG(MIS) / BRA(PAR, RGS, SCA)
Banara tomentosa	ARG(COS, FOR, MIS) / BRA(PAR, RGS, SCA) / PRY(APA, AMA, CAU, CAA, CAN, CEN, CON, COA, GUA, ITA, MIE, PAI, SPE) / URY(CLA, RIV)
Banara umbraticola	ARG(CHA, COS, FOR, SFE) / URY(ART, TAC)
Banisteriopsis acerosa	BRA(Fuera del área del proyecto) / PRY(AMA)
Banisteriopsis adenopoda	BRA(PAR)
Banisteriopsis argyrophylla	BRA(Fuera del área del proyecto) / PRY(AMA, CON)
Banisteriopsis caapi	ARG(SAL) / BRA(Fuera del área del proyecto)
Banisteriopsis campestris	BRA(PAR)
Banisteriopsis confusa	BRA(Fuera del área del proyecto) / PRY(COA, PAI)
Banisteriopsis ferruginea	BRA(PAR)
Banisteriopsis laevifolia	BRA(PAR)
Banisteriopsis muricata	ARG(COS, JUJ, MIS, SAL) / BRA(PAR) / PRY(CAN, GUA, PAI)
Banisteriopsis nummifera	BRA(PAR)
Banisteriopsis oxyclada	BRA(Fuera del área del proyecto) / PRY(AMA)
Banisteriopsis paraguariensis	BRA(Fuera del área del proyecto) / PRY(AMA, CAN)
Banisteriopsis parviflora	BRA(PAR)
Banisteriopsis pseudojanusia	BRA(PAR, SCA)
Banisteriopsis pulchra	BRA(Fuera del área del proyecto) / PRY(AMA)
Banisteriopsis variabilis	BRA(PAR) / PRY(AMA, CON)
Barbacenia paranaensis	BRA(PAR)
Barbaceniopsis boliviensis	ARG(JUJ, SAL, TUC)
Barbaceniopsis castillonii	ARG(TUC)
Barbaceniopsis humahuaquensis	ARG(JUJ)
Barbarea verna	ARG(RNE, SCR) / CHL(MAU, BIO, ARA, LLA, RME)
Barbarea vulgaris	ARG(CHU, NEU, RNE)
Barbosella australis	BRA(PAR, RGS, SCA)
Barbosella cogniauxiana	ARG(MIS) / BRA(PAR, RGS, SCA)
Barbosella crassifolia	BRA(RGS)
Barbosella dusenii	BRA(PAR, RGS)
Barbosella gardneri	BRA(PAR, SCA)
Barbosella miersii	BRA(PAR)
Barbosella trilobata	BRA(PAR)
Barjonia erecta	BRA(PAR)
Barnadesia odorata	ARG(JUJ, SAL, TUC)
Barneoudia balliana	ARG(CAT, JUJ, LRI, MEN, SAL, SJU, TUC) / CHL(COQ, RME)
Barneoudia chilensis	ARG(SJU) / CHL(COQ, VAL, RME)
Barneoudia major var. major	ARG(MEN) / CHL(VAL, LBO, RME)
Barneoudia major var. patagonica	ARG(CHU, NEU, RNE)
Barrosoa betonicaeformis	ARG(BAI, ERI, FOR, SAL, TUC) / BRA(PAR, RGS, SCA) / URY(CLA, MAL, ROC, TYT)
Barrosoa cabrerae	ARG(BAI, ERI, SFE)
Barrosoa candolleana	ARG(BAI, CHA, COR, COS, ERI, FOR, MIS, SFE) / BRA(RGS, SCA) / PRY(APY, BOQ, CAN, CEN, CHO, CON, COA, GUA, ITA, ÑEE, NAS, PAI, PHA, SPE)
Basistemon spinosus	ARG(FOR, JUJ, SAL, TUC) / PRY(APY, BOQ, CON, PHA)
Baskervilla paranaensis	BRA(PAR, SCA)
Bassia hyssopifolia	ARG(BAI, LPA, MEN, RNE, SJU)
Bassia scoparia	ARG(BAI, CAT, CHU, COR, JUJ, LPA, LRI, MEN, NEU, RNE, SAL, SJU, SCR, SFE)
Bastardia bivalvis	ARG(CHA, FOR, JUJ, SAL) / BRA(Fuera del área del proyecto) / PRY(APY)
Bastardia viscosa	ARG(SAL) / PRY(APY)
Bastardiopsis densiflora	ARG(COS, MIS) / BRA(PAR) / PRY(APA, AMA, CAA, CEN, GUA, ITA, PAI)
Bathysa australis	BRA(PAR, RGS, SCA)
Bauhinia acuruana	BRA(Fuera del área del proyecto) / PRY(AMA, CAN)
Bauhinia affinis	ARG(MIS) / BRA(PAR, SCA)
Bauhinia amambayensis	PRY(AMA)
Bauhinia argentinensis var. megasiphon	ARG(SAL)
Bauhinia argentinensis var. argentinensis	ARG(FOR, SAL) / PRY(APY, BOQ, CEN, CON, GUA, PHA)
Bauhinia bauhinioides	ARG(FOR) / BRA(Fuera del área del proyecto) / PRY(APY, CEN, CON, COA, ÑEE)
Bauhinia cheilantha	BRA(Fuera del área del proyecto) / PRY(AMA, CAN, CON)
Bauhinia estrellensis	PRY(AMA)
Bauhinia forficata ssp. pruinosa	ARG(BAI, CAT, CHA, COR, COS, DFE, ERI, FOR, JUJ, LPA, MEN, MIS, SAL, SFE, SJU, TUC) / BRA(PAR, RGS, SCA) / PRY(APA, CAU, COA, ITA) / URY(MON, PAY, ROC, SAO)
Bauhinia hagenbeckii	PRY(APY, AMA, BOQ, CEN, COA, GUA, PAI, SPE)
Bauhinia holophylla	BRA(PAR) / PRY(AMA)
Bauhinia kleiniana	BRA(SCA)
Bauhinia longifolia	BRA(PAR) / PRY(AMA)
Bauhinia mollis var. notophila	ARG(JUJ, SAL)
Bauhinia mollis var. mollis	ARG(FOR) / BRA(Fuera del área del proyecto) / PRY(APY, AMA, CON, COA, SPE)
Bauhinia ungulata var. ungulata	BRA(Fuera del área del proyecto) / PRY(APY, AMA, CAN, CON, COA, GUA, PAI, SPE)
Bauhinia ungulata var. cuiabensis	BRA(Fuera del área del proyecto) / PRY(AMA, CAN, CON, GUA)
Bauhinia uruguayensis	ARG(COS, MIS) / BRA(PAR, RGS, SCA) / PRY(PAI)
Bauhinia variegata var. candida	ARG(SAL)
Beauverdia dialystemon	ARG(BAI, COS, ERI, MIS) / BRA(RGS) / URY(FLA, MON)
Beauverdia hirtella ssp. hirtella	URY(LAV, MAL, MON, RIV, ROC)
Beauverdia hirtella ssp. lorentzii	ARG(COS, ERI)
Beauverdia sellowiana	ARG(ERI) / URY(FLA, LAV, MAL, MON, SJO, SJO)
Beauverdia vittata	ARG(BAI, ERI) / BRA(RGS) / URY(CAS, LAV, MAL, MON, RNO, TAC)
Becquerelia cymosa	BRA(PAR, SCA)
Becquerelia muricata	BRA(SCA)
Begonia angulata	BRA(PAR, SCA)
Begonia balansae var. balansae	ARG(MIS) / PRY(COA, PAI)
Begonia balansae var. glabrior	PRY(CAN, COA)
Begonia barkleyana	BRA(PAR, SCA)
Begonia biguassuensis	BRA(SCA)
Begonia boliviensis var. boliviensis	ARG(JUJ, SAL, TUC)
Begonia boliviensis var. latipetala	ARG(JUJ, SAL)
Begonia boliviensis var. volcanensis	ARG(JUJ)
Begonia calvescens	BRA(RGS, SCA)
Begonia campos-portoana	BRA(SCA)
Begonia capanemae	BRA(SCA)
Begonia catharinensis	BRA(SCA)
Begonia coccinea	BRA(SCA)
Begonia convolvulacea	BRA(PAR, SCA)
Begonia cucullata var. cucullata	ARG(BAI, CHA, COS, ERI, FOR, JUJ, MIS, SAL, SFE, TUC) / BRA(PAR, RGS, SCA) / PRY(CAU, CAA, CAN, COA, ÑEE, PHA) / URY(ART, CAS, CLA, COL, DUR, MAL, MON, RNO, RIV, ROC, SAO, SOR, TAC, TYT)
Begonia cucullata var. arenosicola	ARG(CHA, FOR, JUJ, MIS, SAL, SFE, TUC) / BRA(SCA) / PRY(ITA, ÑEE)
Begonia cucullata var. spatulata	ARG(BAI, CHA, COS, ERI, JUJ, MIS) / BRA(PAR) / PRY(CAA, COA)
Begonia descoleana	ARG(FOR, MIS) / BRA(PAR, SCA)
Begonia echinosepala var. echinosepala	BRA(PAR, SCA)
Begonia echinosepala var. elongatifolia	BRA(SCA)
Begonia fiebrigii	ARG(CAT, JUJ, MIS, SAL, TUC) / PRY(APA)
Begonia fischeri var. fischeri	ARG(MIS) / BRA(PAR, RGS, SCA)
Begonia fruticosa	ARG(MIS) / BRA(PAR, RGS, SCA)
Begonia fuscocaulis	BRA(SCA)
Begonia garuvae	BRA(SCA)
Begonia hassleri	ARG(MIS)
Begonia hilariana	BRA(SCA)
Begonia hirtella	BRA(PAR, RGS, SCA)
Begonia hispida	BRA(PAR, SCA)
Begonia insularis	BRA(SCA)
Begonia isopterocarpa	BRA(RGS, SCA)
Begonia itatinensis	BRA(SCA)
Begonia itupavensis	BRA(PAR)
Begonia konder-reisiana	BRA(SCA)
Begonia lineolata	BRA(SCA)
Begonia lucidissima	PRY(CEN)
Begonia maculata	ARG(MIS) / BRA(Fuera del área del proyecto)
Begonia micranthera var. fimbriata	ARG(JUJ, SAL)
Begonia micranthera var. foliosa	ARG(CAT, JUJ, SAL, TUC)
Begonia micranthera var. hieronymi	ARG(JUJ, SAL, TUC)
Begonia micranthera var. micranthera	ARG(CAT, JUJ, SAL, TUC)
Begonia micranthera var. nana	ARG(JUJ, SAL, TUC)
Begonia micranthera var. rhacophylla	ARG(JUJ)
Begonia micranthera var. venturii	ARG(JUJ, SAL, TUC)
Begonia obovatistipula	PRY(AMA)
Begonia paranaensis	BRA(PAR)
Begonia parodiana	ARG(SAL)
Begonia parvistipulata	BRA(SCA)
Begonia per-dusenii	ARG(MIS) / BRA(PAR, SCA)
Begonia pilgeriana	BRA(SCA)
Begonia pluvialis	BRA(PAR)
Begonia polyandra	BRA(SCA)
Begonia pulchella	BRA(PAR)
Begonia radicans	BRA(PAR, RGS, SCA)
Begonia rubricaulis var. rubricaulis	ARG(JUJ, SAL, TUC)
Begonia rubricaulis var. volcanensis	ARG(JUJ)
Begonia rufosericea	BRA(SCA)
Begonia rupium	BRA(SCA)
Begonia schenckii var. schenckii	BRA(SCA)
Begonia serranegrae	BRA(PAR)
Begonia sleumeri	ARG(JUJ)
Begonia solitudinis	BRA(SCA)
Begonia squamipes	BRA(SCA)
Begonia stenolepis	BRA(SCA)
Begonia subvillosa var. subvillosa	ARG(MIS) / BRA(PAR, RGS, SCA) / PRY(APA, CAN) / URY(RIV)
Begonia subvillosa var. leptotricha	PRY(APA)
Begonia tafiensis	ARG(CAT, JUJ, TUC)
Begonia tominana	ARG(JUJ, TUC)
Behuria insignis	BRA(PAR)
Beilschmiedia berteroana	CHL(VAL, LBO, MAU, BIO, RME)
Beilschmiedia miersii	CHL(VAL, LBO, RME)
Bejaranoa balansae	ARG(FOR, SAL) / PRY(APY, BOQ, CAU, CEN, CON, COA, GUA, NAS, PAI, PHA, SPE)
Belamcanda chinensis	PRY(PAI)
Bellardia trixago	ARG(BAI, ERI, SFE) / CHL(VAL, MAU, BIO, ARA) / URY(CAS, CLA, COL, LAV, MAL, MON, PAY, RIV, ROC, SJO, SJO, TAC)
Bellis perennis	ARG(CHU, TDF) / CHL(COQ, VAL, MAU, BIO, ARA, LLA, MAG, RME)
Belloa chilensis	ARG(NEU, RNE) / CHL(TAR, LBO, MAU, BIO, ARA, LLA, RME)
Beloglottis boliviensis	ARG(SAL)
Benthamiella azorella	ARG(NEU, SCR) / CHL(MAG)
Benthamiella azorelloides	ARG(CHU)
Benthamiella chubutensis	ARG(CHU)
Benthamiella graminifolia	ARG(CHU, NEU, RNE)
Benthamiella lanata	ARG(CHU) / CHL(MAG)
Benthamiella longifolia	ARG(SCR)
Benthamiella nordenskioldii	ARG(SCR, TDF) / CHL(MAG)
Benthamiella patagonica	ARG(CHU, RNE, SCR) / CHL(MAG)
Benthamiella pycnophylloides	ARG(CHU, SCR)
Benthamiella skottsbergii	ARG(SCR)
Benthamiella sorianoi	ARG(SCR)
Benthamiella spegazziniana	ARG(SCR)
Berberidopsis corallina	CHL(BIO, ARA, LLA)
Berberis actinacantha	CHL(ANT, COQ, VAL, LBO, MAU, BIO, ARA, RME)
Berberis andeana	ARG(CAT, SAL, TUC)
Berberis argentinensis	ARG(CAT, COR, JUJ, LRI, SAL, TUC)
Berberis bidentata	ARG(NEU, RNE) / CHL(LLA)
Berberis calilehua	ARG(JUJ, SAL)
Berberis chilensis var. brachybotria	CHL(COQ, VAL, LBO, RME)
Berberis chilensis var. chilensis	CHL(COQ, VAL, LBO, MAU, BIO, ARA, RME)
Berberis comberi	ARG(MEN, NEU)
Berberis commutata	ARG(JUJ, SAL, TUC)
Berberis congestiflora	CHL(ARA, LLA, RME)
Berberis copahuensis	ARG(NEU)
Berberis corymbosa	CHL(JFE)
Berberis darwinii	ARG(CHU, NEU, RNE, TDF) / CHL(MAU, BIO, ARA, LLA, AIS)
Berberis empetrifolia	ARG(CAT, CHU, LRI, MEN, NEU, RNE, SCR, SJU, TDF) / CHL(COQ, VAL, LBO, MAU, BIO, ARA, LLA, AIS, MAG, RME)
Berberis fiebrigii	ARG(JUJ)
Berberis glomerata	CHL(COQ)
Berberis grevilleana	ARG(COR, MEN, SJU)
Berberis hieronymi	ARG(COR)
Berberis horrida	CHL(VAL, LBO, MAU, BIO, RME)
Berberis ilicifolia	ARG(CHU, SCR, TDF) / CHL(LLA, AIS, MAG)
Berberis jobii	ARG(JUJ, SAL)
Berberis jujuyensis	ARG(JUJ)
Berberis kleinii	BRA(SCA)
Berberis laurina	ARG(MIS) / BRA(PAR, RGS, SCA) / URY(DUR, LAV, MAL, RIV, ROC, TAC, TYT)
Berberis lilloana	ARG(CAT, JUJ, SAL, TUC)
Berberis litoralis	CHL(ANT)
Berberis masafuerana	CHL(JFE)
Berberis microphylla	ARG(CHU, NEU, RNE, SCR, TDF) / CHL(LBO, MAU, BIO, ARA, LLA, AIS, MAG)
Berberis montana	ARG(NEU, RNE) / CHL(VAL, LBO, MAU, BIO, ARA, LLA, RME)
Berberis montevidensis	URY(MON)
Berberis negeriana	CHL(BIO)
Berberis rotundifolia	CHL(MAU, BIO, ARA, LLA)
Berberis ruscifolia	ARG(BAI, CAT, CHA, CHU, COR, COS, ERI, LPA, LRI, NEU, SDE, SFE, SLU) / URY(ART, COL, MON, PAY, RNO, SAO, SJO, SOR)
Berberis sellowiana	BRA(RGS) / URY(MON)
Berberis serratodentata	ARG(CHU, NEU, RNE) / CHL(BIO, ARA, LLA, AIS)
Berberis trigona	ARG(NEU, RNE) / CHL(MAU, BIO, ARA, LLA, MAG)
Berberis valdiviana	CHL(LBO, MAU, BIO, ARA, LLA)
Bergeronia sericea	ARG(CHA, FOR, SAL) / PRY(CEN, CON, PHA)
Bernardia alarici	BRA(RGS)
Bernardia ambigua	BRA(PAR, RGS)
Bernardia argentinensis	ARG(CAT, COR, SAL, SDE, TUC)
Bernardia asplundii	ARG(COS)
Bernardia caperoniifolia	PRY(CAN)
Bernardia confertifolia var. glabrata	ARG(MIS)
Bernardia flexuosa	BRA(RGS)
Bernardia geniculata	BRA(RGS)
Bernardia hagelundii	BRA(RGS)
Bernardia hassleriana	PRY(COA)
Bernardia leptostachys	PRY(CAN)
Bernardia longipedunculata	BRA(PAR) / PRY(CON)
Bernardia multicaulis	ARG(CHA, COR, COS, ERI, FOR, MIS) / BRA(PAR, RGS) / PRY(CAA, CAN, CEN, CON, COA, PAI) / URY(PAY, RNO)
Bernardia odonellii	ARG(MIS)
Bernardia paraguariensis	PRY(APY)
Bernardia polymorpha var. polymorpha	PRY(AMA, CAA, CAN, CON)
Bernardia polymorpha var. curuguatensis	PRY(AMA)
Bernardia polymorpha var. setosa	PRY(AMA)
Bernardia pulchella	ARG(COS, MIS, SFE) / BRA(PAR, RGS, SCA) / PRY(APA, AMA, CAU, CAA, CAN, GUA, ITA, MIE, PAI, SPE)
Bernardia sellowii	ARG(COS, ERI, SAL) / BRA(PAR, SCA) / PRY(CAN) / URY(PAY)
Bernardia simplex	PRY(CAN)
Berroa gnaphalioides	ARG(BAI, CAT, CHA, CHU, COR, COS, ERI, LPA, SFE, SDE) / BRA(RGS) / URY(CAS, CLA, FLA, MON, PAY, RNO, SOR)
Bertolonia acuminata ssp. acuminata	BRA(PAR, SCA)
Bertolonia acuminata ssp. paranaensis	BRA(PAR)
Bertolonia leuzeana	BRA(PAR)
Bertolonia mosenii	BRA(PAR, SCA)
Beschorneria yuccoides	ARG(COR)
Besleria selloana	BRA(PAR)
Beta vulgaris ssp. maritima	ARG(BAI, COR, RNE) / CHL(ATA, RME, JFE) / URY(CAS, MON)
Beta vulgaris ssp. vulgaris	ARG(BAI, NEU, RNE, SAL, SFE, TUC) / CHL(TAR)
Betula pendula	ARG(NEU, RNE)
Bidens alba	BRA(PAR, RGS) / CHL(JFE)
Bidens andicola var. andicola	ARG(CAT, JUJ, LRI, SAL, TUC)
Bidens andicola var. cosmantha	ARG(CAT, JUJ, LRI, MEN, SAL, SLU, TUC)
Bidens aurea	ARG(BAI) / CHL(ANT, ATA, COQ, VAL, LBO, MAU, BIO, LLA, RME, IPA)
Bidens bipinnata	BRA(PAR, RGS, SCA)
Bidens chodatii	PRY(AMA, CAN, CON)
Bidens exigua	ARG(CAT, COR, JUJ, LRI, MEN, SAL, SJU, SLU, TUC)
Bidens gardneri	BRA(Fuera del área del proyecto) / PRY(CAU, CAA, CAN, CON, COA, SPE)
Bidens hassleriana	ARG(MIS) / PRY(AMA, CAN)
Bidens laevis	ARG(BAI, CHA, COR, COS, DFE, ERI, FOR, JUJ, MIS, SAL, SJU, SFE, TUC) / BRA(PAR, RGS, SCA) / PRY(CEN, COA, PAI) / URY(Desconocida)
Bidens mandonii	ARG(JUJ, SAL)
Bidens pilosa var. pilosa	ARG(BAI, CAT, CHA, COR, COS, ERI, FOR, JUJ, LRI, MEN, MIS, SAL, SJU, SFE, SDE, TUC) / BRA(PAR, RGS, SCA) / CHL(COQ, RME, JFE) / PRY(AMA, CAU, CEN, COA, GUA, PAI) / URY(CAS, CLA, COL, LAV, MON, SAO)
Bidens pilosa var. alausensis	CHL(TAR, COQ, VAL, LBO, BIO, RME, JFE)
Bidens pilosa var. apiifolia	CHL(ATA, COQ, VAL, LBO, RME)
Bidens pseudocosmos	ARG(JUJ, LRI, SAL, TUC) / CHL(ANT, COQ)
Bidens reptans	ARG(JUJ, MIS) / BRA(Fuera del área del proyecto)
Bidens riedelii	ARG(MIS) / PRY(AMA, CAU, CAN, CON, SPE)
Bidens subalternans var. subalternans	ARG(BAI, CAT, CHA, COR, COS, ERI, JUJ, LPA, LRI, MEN, MIS, SAL, SJU, SLU, SFE, SDE, TUC) / BRA(RGS) / CHL(TAR, ANT) / PRY(APY, AMA, CAU, CAA, CEN, COA, GUA, PAI)
Bidens subalternans var. simulans	ARG(BAI, CAT, COR, COS, ERI, JUJ, LPA, MIS, SDE, SFE, SJU, SLU, TUC) / BRA(PAR)
Bidens subalternans var. unipinnata	ARG(CAT, COR, LRI, SAL, SLU) / BRA(Fuera del área del proyecto) / PRY(COA)
Bidens tenera	ARG(JUJ) / PRY(AMA)
Bidens triplinervia var. triplinervia	ARG(COR, JUJ, MEN) / CHL(TAR)
Bidens triplinervia var. macrantha	ARG(CAT, COR, COS, JUJ, LRI, MEN, SAL, SJU, SLU, TUC) / CHL(TAR, ANT)
Bieneria boliviana	ARG(TUC)
Bifrenaria aureo-fulva	BRA(PAR, RGS, SCA)
Bifrenaria harrisoniae var. harrisoniae	BRA(PAR, RGS, SCA)
Bifrenaria harrisoniae var. grandiflora	BRA(PAR)
Bifrenaria harrisoniae var. pubifera	BRA(PAR)
Bifrenaria inodora	BRA(PAR, RGS, SCA)
Bifrenaria racemosa	BRA(PAR)
Bifrenaria stefanae	BRA(PAR)
Bifrenaria tetragona	BRA(PAR, RGS, SCA)
Bignonia binata	ARG(CHA, COS, MIS, SAL) / BRA(PAR, RGS, SCA) / PRY(APA, APY, CAU, CAA, CAN, GUA, ITA, MIE, ÑEE, PAI, SPE)
Bignonia callistegioides	ARG(BAI, COS, ERI, JUJ, MEN, MIS, SAL) / BRA(RGS) / PRY(APY, CEN) / URY(CAS, CLA, FLA, MON, RNO, SAO, SOR)
Bignonia decora	BRA(PAR) / PRY(AMA, CAN, GUA, SPE)
Bignonia sciuripabulum	ARG(MIS) / BRA(PAR, RGS, SCA) / PRY(APA, APY, AMA, CAA, CAN, GUA, ITA, SPE)
Billbergia alfonsi-joannis	BRA(PAR, SCA)
Billbergia amoena var. amoena	BRA(PAR, SCA)
Billbergia amoena var. rubra	BRA(SCA)
Billbergia amoena var. viridis	BRA(PAR, SCA)
Billbergia distachia var. distachia	BRA(PAR, RGS, SCA)
Billbergia distachia var. straussiana	BRA(PAR, SCA)
Billbergia distachia var. concolor	BRA(SCA)
Billbergia distachia var. maculata	BRA(SCA)
Billbergia magnifica var. magnifica	BRA(PAR) / PRY(AMA)
Billbergia magnifica var. acutisepala	BRA(PAR) / PRY(AMA)
Billbergia nutans var. nutans	ARG(CHA, COR, COS, ERI, JUJ, MIS, SAL) / BRA(PAR, RGS, SCA) / PRY(APA, CAU, CAA, CAN, GUA, PAI) / URY(MON, RIV)
Billbergia nutans var. striata	BRA(RGS)
Billbergia porteana	BRA(PAR)
Billbergia pyramidalis	BRA(PAR)
Billbergia schimperiana	BRA(SCA) / PRY(Desconocida)
Billbergia zebrina	ARG(COS, MIS) / BRA(PAR, RGS, SCA) / PRY(COA, GUA, ITA, PAI) / URY(ART)
Bipinnula biplumata	ARG(BAI) / BRA(PAR, RGS) / URY(MAL, MON)
Bipinnula fimbriata	CHL(COQ, VAL, RME)
Bipinnula gibertii	BRA(RGS) / URY(DUR, LAV, MAL, MON, RIV, SJO)
Bipinnula montana	BRA(RGS) / URY(CLA, LAV, MAL, MON, RIV)
Bipinnula pennicillata	ARG(BAI) / BRA(PAR, RGS, SCA) / URY(COL, MON, SJO, TAC)
Bipinnula plumosa	CHL(COQ, VAL, RME)
Bipinnula polysyka	ARG(BAI) / URY(CAS, CLA, COL, LAV, MAL, MON, PAY, RNO, SJO, SOR)
Bipinnula taltalensis	CHL(ANT)
Bipinnula volkmannii	CHL(BIO, ARA)
Bishovia mikaniifolia	ARG(CHA)
Bixa orellana	ARG(CHA, COR, FOR, SAL) / BRA(RGS, SCA) / PRY(AMA, CEN, COA, PAI, PHA)
Blackstonia perfoliata	ARG(BAI, ERI, LPA, MEN) / URY(CAS, MAL, MON)
Blandowia striata	
Blechnum acutum	ARG(MIS) / BRA(PAR, RGS, SCA) / PRY(CAN)
Blechnum arcuatum	ARG(NEU, RNE) / CHL(MAU, BIO, ARA, LLA, AIS, MAG)
Blechnum asperum	CHL(BIO, ARA, LLA)
Blechnum asplenioides	ARG(MIS) / BRA(PAR) / PRY(APA, CAA, CAN, COA)
Blechnum auriculatum	ARG(BAI, CAT, COR, COS, ERI, LPA, MIS, RNE, SAL, SLU, TUC) / BRA(PAR, RGS, SCA) / URY(ART, CAS, COL, CLA, FLO, FLA, MAL, MON, RNO, RIV, SJO, TAC, TYT)
Blechnum austrobrasilianum	ARG(CAT, JUJ, MIS, SAL) / BRA(PAR, RGS, SCA) / URY(LAV, TYT)
Blechnum blechnoides	CHL(MAU, BIO, ARA, LLA, AIS, MAG)
Blechnum brasiliense var. brasiliense	ARG(BAI, CHA, COS, ERI, FOR, MIS, SAL) / BRA(PAR, RGS, SCA) / PRY(AMA, CAA, CAN, COA, SPE) / URY(CLA, CLA, TAC, TYT)
Blechnum cordatum	ARG(BAI, CHU, COR, JUJ, MEN, MIS, NEU, RNE, SAL, SLU, SCR, TDF) / BRA(PAR, RGS, SCA) / CHL(COQ, VAL, LBO, MAU, BIO, ARA, LLA, AIS, MAG, RME, JFE) / PRY(CAU, COA, SPE) / URY(CAS, MAL, MON, RIV, SJO, TAC)
Blechnum corralense	CHL(LLA)
Blechnum cycadifolium	CHL(JFE)
Blechnum divergens	BRA(PAR, SCA)
Blechnum gracile	ARG(MIS) / BRA(PAR, RGS, SCA) / PRY(CAN, PAI)
Blechnum hastatum	ARG(CHU, COR, MEN, NEU, RNE, SLU, SCR) / CHL(COQ, VAL, LBO, MAU, BIO, ARA, LLA, RME, JFE)
Blechnum laevigatum	ARG(BAI, CAT, COR, JUJ, MIS, SAL, SLU) / BRA(PAR, RGS) / URY(ART, CLA, COL, DUR, FLO, MAL, RIV, SOR, TAC)
Blechnum lanceola	ARG(MIS) / BRA(RGS) / PRY(APA, CAN, COA, GUA)
Blechnum lehmanii	BRA(PAR, SCA)
Blechnum longicauda	CHL(JFE)
Blechnum ludificans	URY(DUR)
Blechnum magellanicum	ARG(CHU, NEU, RNE, SCR, TDF) / CHL(MAU, BIO, ARA, LLA, AIS, MAG, JFE)
Blechnum microphyllum	ARG(MEN, NEU, RNE) / CHL(LBO, MAU, BIO, ARA, LLA)
Blechnum mochaenum var. achalense	ARG(CHU, COR, NEU, RNE)
Blechnum mochaenum var. mochaenum	ARG(CAT, CHU, COR, JUJ, NEU, RNE, SAL, TUC) / BRA(RGS) / CHL(MAU, BIO, ARA, LLA, AIS, MAG)
Blechnum mochaenum var. fernandezianum	CHL(JFE)
Blechnum moritzianum	ARG(JUJ, SAL)
Blechnum obtusifolium	PRY(CAA, CAN, PAI) / URY(CAS, CLA, MAL, RIV, ROC, SJO, TAC, TYT)
Blechnum occidentale var. occidentale	ARG(JUJ, MIS, SAL, TUC) / BRA(PAR, RGS, SCA) / PRY(CAN)
Blechnum penna-marina	ARG(BAI, CHU, COR, JUJ, NEU, RNE, SAL, SCR, SLU, TDF, TUC) / BRA(RGS, SCA) / CHL(ARA, LLA, AIS, MAG)
Blechnum polypodioides	ARG(MIS) / BRA(PAR, RGS, SCA) / PRY(CAN, COA)
Blechnum sampaioanum	BRA(PAR, SCA) / URY(CLA)
Blechnum schomburgkii	ARG(COS, MIS) / BRA(PAR, RGS, SCA) / PRY(APA, AMA, CAU, CAA, GUA)
Blechnum schottii	CHL(VAL)
Blechnum serrulatum	ARG(CHA, COS) / BRA(PAR, RGS, SCA) / PRY(APA, CEN, COA, PAI, SPE)
Blechnum sprucei	ARG(CAT, JUJ, SAL, TUC)
Blechnum squamipes	ARG(CAT, COR, JUJ, SAL, TUC)
Blechnum usterianum	BRA(PAR, RGS)
Blechnum yungense	ARG(JUJ, SAL)
Blennosperma chilense	CHL(VAL, LBO, MAU)
Blepharidachne benthamiana	ARG(CAT, COR, LRI, MEN, SJU, SLU)
Blepharidachne hitchcockii	ARG(CAT, LRI, MEN, SJU, SLU)
Blepharocalyx cruckshanksii	CHL(VAL, LBO, MAU, BIO, ARA, LLA, RME)
Blepharocalyx salicifolius	ARG(BAI, CAT, COS, ERI, JUJ, MIS, SAL, SFE, TUC) / BRA(PAR, RGS, SCA) / PRY(APA, AMA, CAU, CAA, CAN, COA, GUA, ÑEE, PAI) / URY(ART, CLA, COL, DUR, FLO, FLA, LAV, MAL, PAY, RNO, RIV, ROC, SAO, SOR, TAC, TYT)
Blepharodon angustifolius	PRY(COA)
Blepharodon bicuspidatum	BRA(PAR)
Blepharodon lineare	ARG(COS, MIS) / BRA(PAR, RGS, SCA) / PRY(APA, AMA, CAU, PAI, SPE)
Blepharodon nitidum	BRA(PAR) / PRY(AMA, CAU, CON, COA, PAI, SPE)
Blepharodon reflexum	BRA(Fuera del área del proyecto) / PRY(SPE)
Bletia catenulata	ARG(SAL) / BRA(Fuera del área del proyecto) / PRY(AMA)
Bletia wagenerii	ARG(SAL, TUC)
Blitum nuttallianum	ARG(BAI, CHU, LPA, MEN, NEU, RNE)
Blossfeldia liliputana	ARG(CAT, JUJ, LRI, MEN, SAL, SJU)
Blumenbachia catharinensis	BRA(RGS, SCA)
Blumenbachia dissecta	ARG(CHU, MEN, NEU, RNE, SCR) / CHL(VAL, LBO, MAU, RME)
Blumenbachia eichleri	BRA(PAR, RGS, SCA)
Blumenbachia exalata	BRA(RGS)
Blumenbachia hieronymi	ARG(COR, SLU)
Blumenbachia insignis	ARG(BAI, CAT, COR, ERI, LPA, MEN, RNE, SLU, SFE) / BRA(RGS) / URY(LAV, MON, ROC, SOR)
Blumenbachia latifolia	ARG(BAI, CHA, COS, ERI, FOR, JUJ, MIS, SFE, TUC) / BRA(PAR, RGS, SCA) / PRY(CAA, CEN, GUA, MIE) / URY(ART, COL, LAV, MAL, RNO)
Blumenbachia prietea	ARG(NEU, RNE) / CHL(LBO, MAU, BIO, ARA)
Blumenbachia scabra	BRA(PAR, SCA)
Blumenbachia silvestris	ARG(CHU, MEN, NEU, RNE) / CHL(VAL, LBO, BIO, ARA, RME)
Blutaparon portulacoides var. commersonii	ARG(BAI) / BRA(RGS, SCA) / URY(MON)
Blutaparon portulacoides var. portulacoides	BRA(PAR, RGS, SCA)
Bocconia integrifolia	ARG(JUJ, SAL, TUC)
Boehmeria caudata	ARG(BAI, COS, JUJ, MIS, SAL, TUC) / BRA(PAR, RGS, SCA) / PRY(APA, CAU, CAN, GUA, MIE)
Boehmeria cylindrica	ARG(BAI, CHA, COS, ERI, FOR, MIS, SFE) / BRA(PAR, RGS, SCA) / PRY(APA, CAU, CAA, CEN, COA, GUA, PAI) / URY(CAS, CLA, MON, SJO, SOR)
Boehmeria excelsa	CHL(JFE)
Boehmeria nivea	PRY(APA)
Boehmeria pavonii	BRA(Fuera del área del proyecto) / PRY(AMA)
Boerhavia coccinea	BRA(PAR, RGS, SCA)
Boerhavia cordobensis	ARG(CAT, COR, LRI, SDE, SLU)
Boerhavia diffusa var. diffusa	ARG(BAI, CAT, CHA, COR, COS, ERI, JUJ, LRI, MEN, MIS, SAL, SFE) / BRA(Fuera del área del proyecto) / CHL(TAR, ATA, COQ, VAL, LBO, MAU, BIO, RME, IPA) / PRY(APY, CAA, CEN, GUA, PHA) / URY(MON)
Boerhavia diffusa var. leiocarpa	ARG(BAI, CAT, CHA, COS, ERI, JUJ, SAL, SDE, SFE, SJU, SLU, TUC) / PRY(PHA)
Boerhavia pulchella	ARG(COR, LRI, MEN, RNE, SDE, SJU, SLU)
Boerhavia spicata	ARG(CAT)
Bolax caespitosa	ARG(SCR, TDF) / CHL(LLA, AIS, MAG)
Bolax gummifera	ARG(SCR, TDF) / CHL(MAG)
Bolbitis curupirae	BRA(PAR, SCA)
Bolbitis serratifolia	ARG(JUJ, SAL, TUC) / BRA(PAR) / PRY(AMA, CAN, COA, GUA)
Bolboschoenus maritimus ssp. maritimus	ARG(BAI) / CHL(LLA)
Bolboschoenus maritimus ssp. paludosus	ARG(BAI, CHA, CHU, COR, FOR, LPA, MEN, RNE, SFE, TUC) / BRA(RGS)
Bolboschoenus robustus	ARG(BAI, FOR, SFE) / BRA(RGS, SCA) / PRY(PHA) / URY(MON, SJO)
Bomarea boliviensis	ARG(CAT, JUJ, SAL, TUC)
Bomarea dulcis	CHL(TAR)
Bomarea edulis	ARG(CAT, JUJ, MIS, SAL, TUC) / BRA(PAR, RGS, SCA) / PRY(APA)
Bomarea involucrosa	CHL(TAR)
Bomarea macrocephala	ARG(CAT, JUJ, SAL, TUC)
Bomarea salsilla	CHL(VAL, LBO, MAU, BIO, ARA)
Bomarea stans	ARG(SAL)
Bonamia agrostopolis	BRA(Fuera del área del proyecto) / PRY(APA, AMA, CAU)
Bonamia balansae	BRA(Fuera del área del proyecto) / PRY(APA, AMA, CON)
Bonamia sericea var. latifolia	ARG(SDE, TUC)
Bonamia sericea var. sericea	ARG(CAT, CHA, COR, LRI, SDE, SLU)
Bonamia subsessilis	BRA(Fuera del área del proyecto) / PRY(AMA)
Boopis anthemoides var. anthemoides	ARG(BAI, CAT, CHA, CHU, COR, ERI, LPA, LRI, MEN, NEU, RNE, SAL, SCR, SDE, SFE, SJU, SLU, TUC)
Boopis anthemoides var. andina	ARG(LRI, SJU)
Boopis anthemoides var. subintegrifolia	ARG(CAT, CHA, COR, LPA, MEN, SDE, SFE, SLU, TUC)
Boopis australis	ARG(CHU, NEU, RNE, SCR, TDF) / CHL(AIS, MAG)
Boopis bupleuroides	BRA(PAR, SCA)
Boopis castillonii	ARG(CAT)
Boopis chubutensis	ARG(CHU)
Boopis filifolia	ARG(CHU, SCR) / CHL(MAG)
Boopis gracilis	ARG(CHU, COR, LPA, MEN, NEU, RNE, SLU, SCR) / CHL(MAU, BIO, RME)
Boopis graminea var. graminea	ARG(NEU) / CHL(MAU, BIO, ARA)
Boopis graminea var. bracteata	ARG(NEU, RNE) / CHL(LLA)
Boopis jürgensii	BRA(RGS)
Boopis multicaulis	ARG(NEU) / CHL(MAU, ARA)
Boopis necronensis	ARG(CAT, LRI)
Boopis patagonica	ARG(NEU, SCR, TDF) / CHL(MAG)
Boopis pterocalyx	ARG(MEN)
Boopis pusilla	CHL(RME)
Boopis raffaellii	ARG(CHU, RNE)
Boquila trifoliolata	ARG(CHU, NEU) / CHL(MAU, BIO, ARA, LLA)
Borago officinalis	ARG(BAI, CAT, CHA, COR, COS, ERI, JUJ, LPA, MEN, MIS, NEU, RNE, SAL, SFE) / CHL(ARA) / URY(CAS, FLA, MON)
Bordasia bicornis	PRY(APY)
Borojoa lanceolata	PRY(AMA, CON, PHA)
Borreria argentea	BRA(Fuera del área del proyecto) / PRY(AMA, CAU)
Borreria brachystemonoides	ARG(COS, ERI, MIS) / BRA(PAR, RGS, SCA) / PRY(CAA, CEN, CON, ITA, ÑEE) / URY(RIV, TAC)
Borreria brownii	ARG(JUJ) / BRA(Fuera del área del proyecto)
Borreria capitata	BRA(PAR, RGS) / PRY(CAN)
Borreria cupularis	BRA(Fuera del área del proyecto) / PRY(APY, AMA, CAN, GUA)
Borreria dasycephala	ARG(BAI, ERI, JUJ, SAL, SFE, TUC) / BRA(PAR, RGS, SCA) / URY(FLA, MON, RIV, ROC)
Borreria krapocarmeniana	ARG(COS, MIS) / BRA(RGS, SCA) / PRY(CAN, GUA, ITA, SPE)
Borreria latifolia	BRA(PAR, SCA) / PRY(AMA, CAU, CAN, SPE)
Borreria loretiana	ARG(MIS)
Borreria marticrovettiana	ARG(MIS) / BRA(Fuera del área del proyecto) / PRY(CAU, CAN, CON, SPE)
Borreria multiflora	BRA(Fuera del área del proyecto) / PRY(AMA, CAU, CAN, SPE)
Borreria nelidae	ARG(COS, MIS)
Borreria ocymifolia	BRA(PAR, SCA)
Borreria orientalis	ARG(MIS) / BRA(PAR) / PRY(APA, CAU, CAA, CEN, GUA, ITA, PAI)
Borreria palustris	ARG(MIS, SFE) / BRA(PAR, RGS, SCA)
Borreria paranaensis	BRA(PAR, SCA)
Borreria poaya	ARG(MIS) / BRA(PAR, RGS, SCA) / PRY(APA, AMA, CAU, CAA, CAN, CON, PAI, SPE)
Borreria prostrata	ARG(BAI, CHA, COS, ERI, FOR, MIS, SFE) / BRA(PAR, SCA) / PRY(APA, APY, BOQ, CAU, CAN, CHO, CON, COA, MIE, PAI, PHA) / URY(RNO)
Borreria pulchristipula	BRA(Fuera del área del proyecto) / PRY(AMA, CAU, CEN, COA, PAI, SPE)
Borreria quadrifaria	ARG(COS, MIS) / BRA(PAR) / PRY(APY, AMA, CAU, CAA, CAN, CEN, CON, COA, GUA, PAI)
Borreria remota	BRA(Fuera del área del proyecto)
Borreria runkii	PRY(AMA, CAU, CAN)
Borreria schumannii	ARG(CHA, COS, ERI, MIS) / BRA(PAR, RGS, SCA) / PRY(APA, APY, CAU, COA, GUA, ITA, MIE, ÑEE, PAI, SPE)
Borreria spinosa	ARG(BAI, CAT, CHA, COR, ERI, FOR, JUJ, MIS, SAL, SDE, TUC) / BRA(RGS, SCA) / PRY(APY, BOQ, PHA)
Borreria suaveolens	BRA(PAR, SCA)
Borreria sulcata	ARG(COR, COS, ERI) / BRA(PAR)
Borreria tenella	ARG(COS, MIS) / BRA(PAR, RGS, SCA) / PRY(APA, AMA, CAN, CON, COA, GUA, MIE, PAI, SPE) / URY(CLA, RIV, TYT)
Borreria valens	ARG(MIS) / BRA(PAR) / PRY(APA, CAU, CAA, GUA, ITA, PAI)
Borreria verticillata	ARG(BAI, CHA, COR, COS, ERI, FOR, MIS, SFE) / BRA(PAR, RGS, SCA) / PRY(AMA, CAA, CAN, COA, ÑEE) / URY(ART, CLA, COL, PAY, RIV, ROC, SAO, SOR, TAC, TYT)
Borreria warmingii	BRA(PAR)
Bothriochloa alta	ARG(BAI, CAT, CHA, COR, DFE, FOR, JUJ, LPA, LRI, SAL, SJU, SLU, SDE)
Bothriochloa barbinodis	ARG(BAI, CAT, CHA, COR, COS, DFE, ERI, FOR, JUJ, LPA, LRI, MEN, RNE, SAL, SJU, SLU, SFE, SDE, TUC) / BRA(RGS) / PRY(APY) / URY(COL)
Bothriochloa bladhii	ARG(LPA)
Bothriochloa catharinensis	BRA(SCA)
Bothriochloa edwardsiana	ARG(BAI, COR, ERI, LPA, MEN, SAL, SFE) / URY(CAS, MON, PAY, RNO, ROC, SAO, SJO, SOR)
Bothriochloa eurylemma	ARG(CHA, COS, ERI, FOR, SAL, TUC) / BRA(Fuera del área del proyecto)
Bothriochloa exaristata	ARG(CHA, COS, DFE, ERI, FOR, MIS, SFE, SDE) / BRA(RGS, SCA) / PRY(APY, AMA, CEN, CON, ÑEE, PAI, PHA)
Bothriochloa imperatoides	ARG(BAI) / BRA(RGS) / URY(ART, CAS, CLA, COL, FLA, LAV, MAL, MON, PAY, RNO, RIV, SAO, SJO, SOR, TAC)
Bothriochloa laguroides	ARG(BAI, CHA, COR, COS, ERI, FOR, LPA, MIS, SLU, SFE, SDE, TUC) / BRA(RGS, SCA) / CHL(MAU, BIO, ARA) / PRY(CEN, GUA) / URY(ART, CLA, COL, FLA, LAV, MAL, MON, PAY, RNO, ROC, SAO, SJO, SOR, TAC, TYT)
Bothriochloa longipaniculata	ARG(CHA, COS, FOR, MIS, SDE) / BRA(SCA) / PRY(APY, PHA)
Bothriochloa meridionalis	BRA(RGS)
Bothriochloa perforata	ARG(COR, JUJ, LRI, SLU)
Bothriochloa saccharoides var. saccharoides	ARG(BAI, CHA, COR, COS, ERI, JUJ, LPA, SAL, SFE, SDE, TUC) / BRA(PAR, RGS) / CHL(VAL, MAU, BIO, ARA) / PRY(COA) / URY(ART, MAL, SOR)
Bothriochloa saccharoides var. parvispicula	ARG(SAL)
Bothriochloa saccharoides ssp. australis	ARG(COR)
Bothriochloa springfieldii	ARG(BAI, CAT, COR, LPA, LRI, MEN, RNE, SAL, SJU, SLU, SDE, TUC)
Bothriochloa torreyana	ARG(COS, FOR, MIS) / BRA(RGS, SCA) / URY(MAL)
Bothriochloa velutina	BRA(PAR, SCA)
Botrychium dusenii	ARG(CHU, MEN, NEU, RNE, SCR, TDF) / CHL(AIS, MAG)
Botrypus virginianus	ARG(SAL) / BRA(RGS, SCA) / URY(RIV)
Bouchea fluminensis var. fluminensis	ARG(COS, JUJ, MIS, SAL) / BRA(PAR) / PRY(APY)
Bouchea fluminensis f. albiflora	BRA(RGS)
Bouchetia anomala	ARG(BAI, CAT, CHA, COR, COS, ERI, FOR, JUJ, LRI, MIS, SAL, SJU, SLU, SFE, SDE, TUC) / BRA(RGS, SCA) / PRY(ÑEE) / URY(CAS, COL, FLA, MAL, MON, SAO, TAC)
Bougainvillea campanulata	ARG(CHA, FOR, JUJ, SAL, SDE, TUC) / PRY(APY, BOQ, NAS, PHA)
Bougainvillea glabra var. glabra	BRA(PAR, RGS, SCA)
Bougainvillea glabra var. graciliflora	BRA(SCA)
Bougainvillea infesta	ARG(CHA, JUJ, SAL) / PRY(APY, BOQ, NAS, PHA)
Bougainvillea praecox	ARG(CHA, FOR, JUJ, SAL) / PRY(APY, BOQ, PHA)
Bougainvillea spectabilis	BRA(PAR, RGS, SCA)
Bougainvillea spinosa	ARG(BAI, CAT, CHU, COR, JUJ, LPA, LRI, MEN, NEU, RNE, SAL, SJU, SLU) / PRY(APY)
Bougainvillea stipitata	ARG(CAT, CHA, COR, FOR, JUJ, LRI, SAL, SDE, SLU, TUC)
Bougueria nubicola	ARG(JUJ, SAL, TUC)
Bouteloua aristidoides	ARG(CAT, COR, FOR, JUJ, LRI, MEN, SAL, SJU, SLU, SDE, TUC) / BRA(Fuera del área del proyecto) / PRY(Desconocida)
Bouteloua barbata	ARG(CAT, COR, JUJ, LPA, LRI, MEN, SJU, SLU)
Bouteloua curtipendula var. caespitosa	ARG(CAT, COR, JUJ, LPA, LRI, MEN, SAL, SJU, SLU, SDE, TUC) / URY(PAY)
Bouteloua media	BRA(Fuera del área del proyecto) / PRY(AMA) / URY(PAY, SOR)
Bouteloua megapotamica	ARG(BAI, CAT, CHA, COR, COS, ERI, LPA, MIS, SLU, SFE, SDE, TUC) / BRA(RGS) / URY(ART, CAS, CLA, DUR, FLA, MAL, MON, PAY, RNO, SAO, SOR, TAC)
Bouteloua simplex	ARG(CAT, COR, JUJ, LRI, MEN, SAL, SJU, SLU, TUC) / CHL(TAR, ANT, VAL)
Bowdichia virgilioides f. major	BRA(Fuera del área del proyecto) / PRY(AMA, CAN)
Bowlesia flabilis	ARG(JUJ, LRI, SAL, TUC)
Bowlesia hieronymusii	ARG(JUJ, SAL, TUC)
Bowlesia incana	ARG(BAI, CAT, CHU, COR, COS, ERI, JUJ, LPA, MEN, MIS, NEU, RNE, SAL, SJU, SLU, SCR, SDE, TUC) / BRA(RGS, SCA) / CHL(ANT, COQ, VAL, LBO, MAU, BIO, RME) / PRY(CEN, PAI) / URY(CAS, COL, MON, SJO, SOR)
Bowlesia lobata	ARG(CAT, COR, JUJ, LRI, SAL, SLU, TUC) / CHL(TAR)
Bowlesia macrophysa	CHL(COQ)
Bowlesia paposana	CHL(TAR)
Bowlesia platanifolia	ARG(CAT, JUJ, SAL, TUC)
Bowlesia ruiz-lealii	ARG(MEN, NEU)
Bowlesia sodiroana	CHL(COQ)
Bowlesia tropaeolifolia	ARG(CAT, CHU, JUJ, LRI, MEN, NEU, RNE, SAL, SCR, SJU, SLU, TUC) / CHL(TAR, ANT, COQ, VAL, LBO, MAU, BIO, ARA, LLA, AIS, MAG, RME)
Bowlesia uncinata	CHL(COQ, VAL, LBO, MAU, BIO, RME)
Bowlesia venturii	ARG(TUC)
Brachionidium restrepioides	BRA(PAR)
Brachyclados caespitosus	ARG(CHU, SCR) / CHL(MAG)
Brachyclados lycioides	ARG(BAI, CHU, LPA, MEN, NEU, RNE, SJU, SLU) / CHL(COQ, VAL)
Brachyclados megalanthus	ARG(BAI, CHU, LPA, RNE)
Brachyotum microdon	ARG(JUJ, SAL)
Brachypodium distachyon	ARG(BAI, DFE, ERI) / CHL(COQ, VAL, LBO, MAU, BIO, JFE) / URY(ART, CAS, MON, TAC)
Brachypodium sylvaticum	ARG(DFE) / URY(MON)
Brachystele arechavaletae	BRA(RGS) / URY(ART, MAL, ROC, TAC)
Brachystele bicrinita	BRA(SCA)
Brachystele bracteosa	BRA(RGS, SCA) / PRY(PAI)
Brachystele burkartii	ARG(MIS)
Brachystele camporum	ARG(BAI, CHA, COS, ERI, MIS) / BRA(PAR, RGS) / PRY(CAU, CEN, COA, GUA, MIE, PAI) / URY(CAS, COL, LAV, MAL, MON, PAY, RNO, RIV, ROC, SOR, TAC, TYT)
Brachystele chlorops	ARG(JUJ, SAL)
Brachystele cyclochila	ARG(COS, ERI, MIS) / BRA(PAR, SCA) / PRY(AMA) / URY(LAV, MAL, RNO, SAO, SOR)
Brachystele delicatula	
Brachystele dilatata	ARG(BAI, CHA, COS, MIS, SFE, TUC) / BRA(PAR, RGS, SCA) / PRY(PAI) / URY(CAS, COL, LAV, MAL, MON, RNO, RIV, ROC, SJO, SOR, TAC)
Brachystele icmadophila	BRA(RGS)
Brachystele pappulosa	URY(MON)
Brachystele subfiliformis	BRA(PAR, RGS, SCA)
Brachystele unilateralis	ARG(CHU, RNE) / CHL(COQ, VAL, MAU, BIO, ARA, LLA)
Brachystele waldemarii	URY(LAV)
Brachystele widgreni	ARG(ERI) / BRA(PAR, RGS)
Brasiliopuntia brasiliensis	ARG(SAL) / BRA(PAR)
Brasiliopuntia schulzii	ARG(CHA, COS, FOR, MIS) / PRY(AMA, CEN, CON, COA, GUA, ITA, PAI, SPE)
Brasiliorchis picta	ARG(MIS) / BRA(PAR, RGS, SCA) / PRY(APA)
Brassavola cebolleta	ARG(CHA, FOR, MIS) / BRA(Fuera del área del proyecto) / PRY(GUA, ÑEE)
Brassavola perrinii	
Brassavola tuberculata	ARG(CHA, COS, ERI, FOR, MIS) / BRA(PAR, RGS, SCA) / PRY(CEN, GUA, ÑEE, SPE)
Brassica juncea	ARG(BAI, COR, ERI, LPA, MIS, SAL, SJU) / PRY(APY)
Brassica napus	ARG(ERI, JUJ) / CHL(COQ, BIO, ARA, LLA, MAG, RME, JFE)
Brassica nigra	ARG(BAI, CAT, CHA, CHU, COR, COS, RNE, SAL, SJU, SFE) / CHL(ANT, ATA, COQ, VAL, BIO, RME, JFE)
Brassica oleracea	CHL(LLA, MAG, JFE)
Brassica rapa	ARG(BAI, CAT, CHA, CHU, COR, COS, DFE, ERI, JUJ, LPA, LRI, MEN, MIS, NEU, RNE, SAL, SCR, SDE, SFE, SJU, SLU, TDF, TUC) / CHL(ANT, COQ, VAL, LBO, MAU, BIO, ARA, LLA, MAG, RME, JFE) / PRY(APY) / URY(MON)
Brassica tournefortii	CHL(VAL)
Brayopsis calycina	ARG(CAT, JUJ, SAL, TUC)
Brayopsis monimocalyx	ARG(JUJ, LRI, SAL)
Bredemeyera brevifolia	PRY(APY)
Bredemeyera colletioides	ARG(CAT, LRI, MEN, SJU, TUC)
Bredemeyera floribunda	BRA(PAR) / PRY(APY, AMA, CAN, CON, COA, GUA, PAI)
Bredemeyera microphylla var. adpressa	ARG(BAI, LPA, LRI, MEN, RNE, SJU)
Bredemeyera microphylla var. microphylla	ARG(BAI, CAT, CHU, LPA, LRI, MEN, NEU, RNE, SJU, TUC)
Breynia disticha	BRA(SCA)
Brickellia diffusa	ARG(JUJ, SAL) / BRA(Fuera del área del proyecto)
Brickellia gentianoides	BRA(RGS)
Bridgesia incisifolia	CHL(ATA, COQ, VAL, RME)
Briquetia denudata	ARG(SAL) / BRA(Fuera del área del proyecto) / PRY(CAA, CAN, GUA, PHA)
Briza maxima	ARG(BAI, CAT, CHU, COR, ERI, SFE) / BRA(PAR, RGS) / CHL(ATA, VAL, MAU, BIO, ARA, LLA, MAG, JFE) / URY(CAS, CLA, COL, DUR, FLA, MAL, MON, SOR)
Briza media	ARG(NEU, RNE)
Briza minor	ARG(BAI, CAT, COR, COS, ERI, LPA, MEN, MIS, NEU, RNE, SAL, SJU, SLU, SFE, TUC) / BRA(PAR, RGS, SCA) / CHL(ATA, COQ, VAL, LBO, MAU, BIO, ARA, LLA, RME, JFE) / URY(CAS, CLA, FLO, FLA, LAV, MAL, MON, PAY, RNO, SAO, SJO, SOR, TYT)
Bromelia antiacantha	BRA(PAR, RGS, SCA) / URY(MAL, RIV, ROC)
Bromelia balansae	ARG(COS, ERI, FOR, MIS) / BRA(PAR, RGS, SCA) / PRY(APA, APY, AMA, CAA, CAN, CEN, COA, GUA, ITA, ÑEE, PAI, SPE)
Bromelia hieronymi	ARG(CHA, FOR, JUJ, SAL, SDE, TUC) / PRY(APY, PHA)
Bromelia serra	ARG(CHA, COR, COS, FOR, JUJ, SAL, SDE, SFE, TUC) / BRA(Fuera del área del proyecto) / PRY(APY, CEN, PAI, PHA)
Bromelia urbaniana	ARG(CAT, CHA, COR, FOR, LRI, MEN, SAL, SJU, SLU, SFE, SDE, TUC) / PRY(APY, PHA)
Bromidium anomalum	ARG(CHU, NEU) / CHL(COQ, VAL, LBO, MAU, BIO, ARA, LLA, RME)
Bromidium hygrometricum	ARG(BAI, COS, ERI, SFE) / BRA(PAR, RGS, SCA) / URY(CAS, CLA, FLA, MAL, MON, RNO, RIV, ROC, SJO, SOR, TAC)
Bromidium ramboi var. ramboi	BRA(RGS, SCA)
Bromidium ramboi var. pubescens	BRA(SCA)
Bromidium tandilense	ARG(BAI, COR, COS, ERI, MIS, SFE) / BRA(RGS) / PRY(ITA) / URY(ART, CLA, FLO, FLA, LAV, MAL, MON, PAY, RNO, RIV, SJO, SOR, TAC)
Bromidium trisetoides	CHL(MAU, BIO, ARA, LLA)
Bromus araucanus	ARG(CHU, NEU, RNE, TDF) / CHL(ARA, LLA, MAG)
Bromus arvensis	ARG(BAI)
Bromus auleticus	ARG(BAI, COR, COS, ERI, LPA, SLU, SFE) / BRA(RGS, SCA) / URY(ART, CAS, CLA, COL, FLO, FLA, LAV, MAL, MON, PAY, RNO, RIV, ROC, SAO, SJO, SOR, TAC, TYT)
Bromus berteroanus	ARG(CHU, LPA, MEN, NEU, RNE) / CHL(TAR, ANT, ATA, COQ, VAL, LBO, MAU, BIO, ARA, RME, JFE)
Bromus bonariensis	ARG(BAI, LPA, SFE)
Bromus brachyanthera var. brachyanthera	ARG(BAI, COR, COS, DFE, ERI, MIS, TUC) / BRA(PAR, RGS, SCA) / URY(FLO, FLA, MAL, MON, RNO, ROC, SAO, SOR, TAC, TYT)
Bromus brachyanthera var. uruguayensis	ARG(BAI, ERI) / BRA(RGS) / URY(ART, CAS, CLA, LAV, MAL, SAO, TAC)
Bromus catharticus var. catharticus	ARG(BAI, CAT, CHA, CHU, COR, COS, DFE, ERI, FOR, JUJ, LPA, LRI, MEN, MIS, NEU, RNE, SAL, SJU, SLU, SFE, SDE, TDF, TUC) / BRA(PAR, RGS, SCA) / CHL(TAR, ANT, ATA, COQ, VAL, LBO, MAU, BIO, ARA, LLA, AIS, MAG, RME, JFE, IPA) / PRY(CEN, PAI, SPE) / URY(CAS, CLA, COL, DUR, FLO, FLA, MAL, MON, PAY, RNO, RIV, SJO, SOR)
Bromus catharticus var. rupestris	ARG(BAI, CAT, CHU, COR, DFE, ERI, LPA, MEN, NEU, RNE, SJU, SLU, SCR, TUC)
Bromus catharticus var. elata	ARG(CHU, NEU, RNE, SCR, TDF) / CHL(TAR, ANT, COQ, VAL, LBO, MAU, BIO, ARA, LLA, MAG, RME, JFE)
Bromus coloratus	ARG(CHU, NEU, RNE, SCR, TDF) / CHL(VAL, BIO, ARA, LLA, AIS, MAG)
Bromus commutatus	ARG(BAI, COS, DFE, LPA, MEN, NEU, RNE, SLU) / BRA(RGS) / URY(CAS, COL, MON, ROC, SJO, SOR)
Bromus erectus	ARG(BAI, COR, SAL, SFE) / CHL(BIO, MAG)
Bromus flexuosus var. flexuous	ARG(CAT, LRI, SAL, TUC)
Bromus flexuosus var. famatinensis	ARG(CAT, JUJ, LRI)
Bromus gunckelii	CHL(TAR)
Bromus hordeaceus	ARG(BAI, CHU, COR, DFE, MEN, NEU, RNE, SCR, SFE, TDF) / BRA(RGS) / CHL(COQ, VAL, LBO, MAU, BIO, ARA, LLA, MAG, RME, JFE) / URY(CAS, CLA, COL, DUR, FLO, FLA, LAV, MAL, MON, PAY, RNO, SJO, SOR)
Bromus inermis	ARG(BAI, DFE) / URY(COL, SOR)
Bromus japonicus	ARG(CHU, RNE)
Bromus lanatus	ARG(CAT, JUJ, LRI, SJU, TUC) / CHL(TAR)
Bromus lanceolatus	CHL(MAU) / URY(MAL, PAY, RNO)
Bromus lithobius	ARG(CHU, NEU, RNE) / CHL(COQ, VAL, MAU, BIO, ARA, LLA, AIS, MAG, JFE)
Bromus madritensis	ARG(BAI, JUJ, NEU) / CHL(COQ, VAL, MAU, ARA) / URY(MAL)
Bromus mango	ARG(CHU, NEU, RNE) / CHL(ARA, AIS)
Bromus modestus	ARG(JUJ, LRI, SAL, TUC)
Bromus parodii	ARG(LPA)
Bromus pellitus	ARG(SCR, TDF) / CHL(MAG)
Bromus racemosus	ARG(CHU, DFE, NEU, SCR) / CHL(LLA, MAG)
Bromus rigidus	ARG(BAI, CHA, LPA, MIS, NEU, RNE, SCR) / CHL(ATA, COQ, VAL, LBO, MAU, BIO, ARA, LLA, RME, JFE)
Bromus rubens	ARG(BAI, CAT, MEN, NEU)
Bromus scoparius	CHL(VAL, LBO, BIO, RME)
Bromus secalinus	ARG(BAI, CHU, DFE, NEU, RNE) / CHL(BIO, ARA, LLA, MAG)
Bromus setifolius var. setifolius	ARG(CHU, MEN, NEU, RNE, SJU, SCR) / CHL(ATA, COQ, LBO, MAU, BIO, MAG, RME)
Bromus setifolius var. brevifolius	ARG(CHU, LRI, MEN, NEU, RNE, SCR, SJU) / CHL(ATA, COQ, VAL, LBO, MAU, BIO, ARA, AIS, MAG, RME)
Bromus setifolius var. pictus	ARG(CHU, MEN, RNE, SJU, SCR) / CHL(MAG, RME)
Bromus squarrosus	CHL(RME)
Bromus sterilis	ARG(CHU, DFE, NEU, RNE, SFE) / CHL(VAL, LBO, BIO, ARA, LLA, MAG, RME)
Bromus tectorum	ARG(BAI, CHU, COR, LPA, MEN, NEU, RNE, SCR) / CHL(ARA, MAG)
Bromus tunicatus	ARG(CHU, MEN, NEU, RNE, SCR) / CHL(COQ, LBO, MAU, BIO, ARA, MAG, RME)
Brosimum gaudichaudii	BRA(Fuera del área del proyecto) / PRY(AMA, CAU, CAN, CON, SPE)
Brosimum glaziovii	BRA(RGS, SCA)
Brosimum lactescens	BRA(PAR, SCA)
Broussonetia papyrifera	ARG(BAI, CHA, COR, COS, ERI, LPA, SFE)
Browningia caineana	PRY(APY, CON)
Browningia candelaris	CHL(TAR)
Brugmansia suaveolens	ARG(MIS) / BRA(RGS, SCA) / PRY(CAA)
Brunfelsia australis	ARG(CHA, COS, FOR, MIS, SAL) / BRA(PAR, RGS, SCA) / PRY(AMA, CAA, CAN, CEN, COA, GUA, ÑEE, PAI, PHA, SPE) / URY(Desconocida)
Brunfelsia brasiliensis ssp. brasiliensis	BRA(PAR)
Brunfelsia brasiliensis ssp. macrocalyx	BRA(PAR, SCA)
Brunfelsia cuneifolia	BRA(PAR, RGS, SCA)
Brunfelsia pauciflora	BRA(PAR, SCA)
Brunfelsia pilosa	ARG(MIS) / BRA(PAR, RGS, SCA) / PRY(APA)
Brunfelsia plowmaniana	ARG(JUJ, SAL)
Brunfelsia uniflora	BRA(Fuera del área del proyecto) / PRY(COA, ÑEE, PAI, SPE)
Brunsvigia rosea	ARG(BAI)
Bryantiella glutinosa	CHL(TAR, ANT, ATA)
Bryophyllum daigremontianum 	ARG(BAI, DFE, MIS)
Bryophyllum delagoense 	ARG(BAI, ERI)
Bryophyllum fedtschenkoi 	ARG(BAI, MIS, SAL)
Bryophyllum pinnatum 	ARG(COS, MIS)
Buchenavia kleinii	BRA(PAR, RGS, SCA)
Buchnera amethystina	BRA(PAR, SCA)
Buchnera integrifolia	ARG(COS) / BRA(PAR, RGS, SCA) / URY(RIV)
Buchnera juncea	BRA(PAR) / PRY(AMA, CON)
Buchnera lavandulacea	BRA(Fuera del área del proyecto) / PRY(AMA, GUA)
Buchnera longifolia	ARG(BAI, CHA, COR, COS, ERI, FOR, JUJ, MIS, SAL, SDE, SFE, TUC) / BRA(PAR, RGS, SCA) / PRY(APY, CEN, CON, COA, GUA, PAI) / URY(ART, CAS, CLA, DUR, FLO, FLA, LAV, MAL, MON, PAY, RNO, RIV, ROC, SAO, SJO, SOR, TAC, TYT)
Buchnera palustris	BRA(Fuera del área del proyecto) / PRY(CON)
Buchnera ternifolia	ARG(CHA, COS, ERI, FOR, MIS, SAL, SFE, TUC) / BRA(PAR) / PRY(APY, APA, COA, GUA, SPE) / URY(MON)
Buchtienia boliviensis	PRY(APY)
Buddleja araucana	ARG(MEN, NEU, RNE) / CHL(ATA, COQ, VAL, BIO)
Buddleja aromatica	ARG(JUJ, SAL)
Buddleja brachiata	PRY(CON)
Buddleja cestrifolia	BRA(RGS, SCA)
Buddleja cordobensis	ARG(COR, LRI, SJU, SLU)
Buddleja cuneata	BRA(PAR, RGS, SCA)
Buddleja diffusa	ARG(SAL)
Buddleja elegans ssp. angustata	ARG(COS, MIS) / BRA(RGS) / PRY(APA, AMA, CAU, CAA, CEN, COA, GUA, ITA, PAI, SPE) / URY(RIV, TAC)
Buddleja elegans ssp. elegans	BRA(PAR, RGS, SCA)
Buddleja globosa	ARG(CHU, MEN, NEU, RNE) / CHL(VAL, LBO, MAU, BIO, ARA, LLA, RME)
Buddleja grandiflora	ARG(COS, SFE) / BRA(PAR, RGS, SCA) / URY(CLA, RIV, TAC, TYT)
Buddleja hatschbachii	BRA(PAR, RGS, SCA)
Buddleja hieronymi	ARG(JUJ)
Buddleja iresinoides	ARG(CAT, CHA, FOR, JUJ, SAL, TUC) / URY(RIV)
Buddleja kleinii	BRA(RGS, SCA)
Buddleja mendozensis	ARG(CAT, COR, JUJ, LPA, LRI, MEN, SAL, SDE, SJU, SLU, TUC)
Buddleja misionum	ARG(COS, MIS) / BRA(RGS) / PRY(GUA)
Buddleja oblonga	BRA(PAR)
Buddleja ramboi	BRA(RGS, SCA)
Buddleja stachyoides	ARG(BAI, CAT, CHA, COR, COS, ERI, FOR, JUJ, MIS, SAL, SFE, TUC) / BRA(PAR, RGS, SCA) / PRY(APA, CAU, CAA, CAN, CEN, CON, COA, GUA, ITA, PAI, PHA, SPE) / URY(ART, PAY, RNO, SOR)
Buddleja suaveolens	CHL(ANT, ATA, COQ)
Buddleja thyrsoides ssp. thyrsoides	ARG(BAI, COS, ERI, MIS) / BRA(RGS) / URY(CAS, MON, SJO, SOR, TAC, TYT)
Buddleja thyrsoides ssp. angusticarpa	ARG(BAI, COS, MIS) / BRA(PAR, RGS, SCA) / PRY(GUA, MIE) / URY(ART, CLA, COL, DUR, LAV, MAL, RIV, SJO)
Buddleja tubiflora	ARG(CHA, COR, COS, ERI, FOR, SDE, SFE) / PRY(APA, CAU, CAN, CEN, CON, COA, GUA, MIE, PAI, PHA, SPE)
Buddleja tucumanensis	ARG(CAT, CHA, JUJ, SAL, SDE, TUC)
Buglossoides arvensis	ARG(BAI, CAT, CHU, COR, DFE, ERI, LPA, MEN, NEU, RNE, SJU, SLU, SCR, SFE, TUC) / CHL(AIS) / URY(CAS, ROC)
Bulbophyllum atropurpureum	BRA(PAR)
Bulbophyllum chloroglossum	BRA(PAR) / PRY(CAN)
Bulbophyllum dusenii	BRA(PAR)
Bulbophyllum epiphytum	BRA(PAR)
Bulbophyllum gladiatum	BRA(PAR, SCA)
Bulbophyllum glutinosum	BRA(PAR, RGS, SCA)
Bulbophyllum granulosum	BRA(PAR, SCA)
Bulbophyllum laciniatum var. laciniatum	BRA(PAR)
Bulbophyllum laciniatum var. janeirense	BRA(PAR, SCA)
Bulbophyllum luederwaldtii	BRA(PAR, SCA)
Bulbophyllum malachadenia	BRA(PAR)
Bulbophyllum mentosum	BRA(SCA)
Bulbophyllum meridense	BRA(SCA)
Bulbophyllum micranthum	BRA(PAR)
Bulbophyllum napelli	ARG(MIS) / BRA(PAR, RGS, SCA)
Bulbophyllum paranaense	BRA(PAR)
Bulbophyllum perii	BRA(PAR)
Bulbophyllum plumosum	BRA(PAR)
Bulbophyllum punctatum	BRA(PAR, RGS)
Bulbophyllum regnellii	ARG(MIS) / BRA(PAR, RGS, SCA)
Bulbophyllum rupicolum	PRY(CAN)
Bulbophyllum teresense	BRA(PAR)
Bulbophyllum tessenianum	BRA(PAR)
Bulbophyllum tripetalum	ARG(MIS) / BRA(PAR) / PRY(APA, AMA, CAU)
Bulbophyllum warmingianum	BRA(SCA)
Bulbophyllum x guartelae	BRA(PAR)
Bulbostylis amambayensis	BRA(PAR) / PRY(AMA, SPE)
Bulbostylis arenaria	BRA(PAR)
Bulbostylis aspera	ARG(COS, MIS) / BRA(PAR) / PRY(AMA, CAU, CEN, PAI, SPE)
Bulbostylis brevifolia	ARG(CHA, COS, ERI, MIS) / BRA(PAR, RGS) / PRY(AMA, CON, COA, ITA, MIE, PAI, SPE) / URY(TAC)
Bulbostylis capillaris var. capillaris	ARG(BAI, CAT, CHA, COR, COS, ERI, FOR, JUJ, MIS, SAL, SLU, SFE, SDE, TUC) / BRA(PAR, RGS, SCA) / PRY(APY, PAI) / URY(ART, CLA, FLA, MON, PAY, RNO, RIV, SJO, SJO, TAC)
Bulbostylis capillaris var. microstachys	ARG(COS, JUJ, MIS)
Bulbostylis capillaris var. pyriformis	ARG(CHA, COS, ERI, FOR, MIS, SDE) / PRY(CEN, COA)
Bulbostylis communis var. scabrida	ARG(CAT, COR, COS, ERI, FOR, MIS, TUC) / BRA(RGS) / PRY(APY, CEN, COA, ITA, PAI, PHA)
Bulbostylis communis var. communis	ARG(CAT, CHA, COR, COS, ERI, FOR, MIS, SFE, SDE) / BRA(PAR, RGS) / PRY(AMA, CAU, ITA, PHA) / URY(ART, CLA, FLA, MON, PAY, RNO, RIV, SJO, TAC)
Bulbostylis consanguinea	ARG(FOR) / BRA(PAR, RGS, SCA) / PRY(AMA) / URY(TYT)
Bulbostylis contracta	ARG(BAI, COR, LRI, SLU, SDE) / URY(MON)
Bulbostylis eleocharoides	BRA(Fuera del área del proyecto) / PRY(AMA)
Bulbostylis fendleri	BRA(PAR)
Bulbostylis fimbriata	BRA(PAR)
Bulbostylis funckii	ARG(COR, TUC)
Bulbostylis guaglianoneae	ARG(MIS)
Bulbostylis hirtella	ARG(COS, MIS) / BRA(PAR, RGS, SCA) / PRY(APA, APY, AMA, BOQ, CAU, CAA, COA, GUA, SPE)
Bulbostylis jacobinae	BRA(PAR) / PRY(AMA, CAN, COA)
Bulbostylis junciformis	BRA(PAR) / PRY(APA, AMA, CAA, CAN, COA, SPE)
Bulbostylis juncoides var. juncoides	ARG(BAI, CAT, COR, COS, JUJ, LPA, LRI, MIS, SAL, SFE, SLU, TUC) / BRA(PAR, RGS, SCA) / PRY(AMA, CAU, CEN, COA, PAI) / URY(MON, PAY, SAO, TAC)
Bulbostylis juncoides f. subfimbriata	ARG(CAT, COR, COS, JUJ, MIS, SAL, TUC) / URY(TAC)
Bulbostylis juncoides var. ampliceps	ARG(BAI, CAT, COR, COS, ERI, SLU, SFE, TUC) / BRA(RGS, SCA) / URY(CLA, CLA, RIV)
Bulbostylis juncoides var. nana	ARG(CAT, COR, SLU)
Bulbostylis juncoides f. hirtella	ARG(BAI, COR) / URY(CLA, DUR, FLO, SOR, TYT)
Bulbostylis juncoides var. lorentzii	ARG(BAI, CAT, CHA, COR, COS, ERI, JUJ, LPA, LRI, MIS, RNE, SAL, SDE, SLU, TUC) / BRA(PAR, SCA) / PRY(ITA) / URY(CLA, COL, FLA, MON, PAY, SAO, SJO, TYT)
Bulbostylis loefgrenii	ARG(MIS) / BRA(PAR) / PRY(APA, AMA, CAU, CON, SPE)
Bulbostylis papillosa	PRY(AMA)
Bulbostylis paradoxa	BRA(PAR)
Bulbostylis rugosa	ARG(COS) / PRY(AMA, CEN, CON, COA, SPE)
Bulbostylis scabra	ARG(BAI, CHA, COS, ERI, JUJ, MIS, SAL) / BRA(PAR, RGS, SCA) / PRY(APY, AMA, CAU, CAN, CEN, COA, ITA, MIE, PHA, SPE) / URY(COL, MAL, RNO, RIV, SJO)
Bulbostylis sellowiana	BRA(PAR) / PRY(CAU)
Bulbostylis sphaerocephala var. sphaerocephala	ARG(MIS, TUC) / BRA(PAR, RGS, SCA) / PRY(APA, AMA, CAU, CON, COA, GUA, ITA, PAI, SPE)
Bulbostylis sphaerocephala var. brunneo-vaginata	BRA(PAR, RGS, SCA) / PRY(AMA)
Bulbostylis sphaerolepis	ARG(COS, ERI, FOR, JUJ, MIS, SFE, TUC) / BRA(PAR, RGS, SCA) / PRY(APA, AMA, CAU, CAN, COA, GUA, MIE, PAI, SPE) / URY(RIV, TAC)
Bulbostylis stenocarpa	BRA(Fuera del área del proyecto) / PRY(AMA)
Bulbostylis subtilis	ARG(CHA, COS, MIS, SAL) / BRA(PAR, RGS) / PRY(APA, AMA, CAU, ITA, MIE, PAI)
Bulbostylis svensoniana	BRA(Fuera del área del proyecto) / PRY(AMA)
Bulnesia bonariensis	ARG(CAT, CHA, COR, FOR, JUJ, LRI, SAL, SDE, SLU, TUC) / PRY(APY, BOQ, PHA)
Bulnesia chilensis	CHL(ATA, COQ)
Bulnesia foliosa	ARG(CAT, CHA, COR, FOR, JUJ, LRI, SAL, SDE, SJU, TUC) / PRY(APY)
Bulnesia retama	ARG(CAT, COR, LPA, LRI, MEN, SDE, SJU, SLU)
Bulnesia sarmientoi	ARG(CHA, FOR, SAL) / BRA(Fuera del área del proyecto) / PRY(APY, PHA)
Bulnesia schickendantzii	ARG(CAT, JUJ, LRI, SAL, TUC)
Bunchosia pallescens	ARG(COS, MIS) / BRA(PAR, SCA) / PRY(CAN, CON)
Bunchosia paraguariensis	BRA(Fuera del área del proyecto) / PRY(Desconocida)
Bupleurum tenuissimum	ARG(BAI)
Burkartia lanigera	ARG(CHU, SCR)
Burmannia alba	BRA(PAR, RGS, SCA) / PRY(APA, AMA)
Burmannia australis	BRA(RGS, SCA) / PRY(APA, CAU, COA, PAI)
Burmannia capitata	ARG(COS) / BRA(PAR, RGS) / PRY(APA, CAU, CAN, COA, GUA, PAI, SPE)
Burmannia flava	ARG(COS, MIS) / BRA(SCA) / PRY(CON, PAI)
Butia campicola	PRY(CAN, COA, SPE)
Butia capitata	BRA(PAR, RGS, SCA) / URY(MON, ROC)
Butia catarinensis	BRA(RGS, SCA)
Butia eriospatha	ARG(MIS) / BRA(PAR, RGS, SCA)
Butia exilata	BRA(RGS)
Butia exospadix	PRY(APA, AMA, CON)
Butia lallemantii	BRA(RGS)
Butia leptospatha	PRY(AMA)
Butia marmorii	ARG(MIS) / PRY(APA)
Butia microspadix	BRA(PAR)
Butia noblickii	ARG(COS)
Butia odorata	BRA(RGS) / URY(TYT)
Butia paraguayensis	ARG(COS, MIS) / BRA(PAR, RGS) / PRY(AMA, CAU, CAA, CAN, CON, COA, GUA, MIE, ÑEE, SPE) / URY(ART, RIV)
Butia witeckii	BRA(RGS)
Butia yatay	ARG(CHA, COS, ERI, MIS, SFE) / BRA(RGS) / URY(PAY, RNO)
Byrsonima brachybotrya	BRA(PAR)
Byrsonima coccolobifolia	BRA(PAR) / PRY(AMA, CON)
Byrsonima crassifolia	BRA(PAR) / PRY(CAN)
Byrsonima intermedia	BRA(PAR) / PRY(AMA, CAN, CON, SPE)
Byrsonima ligustrifolia	BRA(PAR, SCA)
Byrsonima myricifolia	BRA(PAR)
Byrsonima niedenzuiana	BRA(PAR)
Byrsonima psilandra	BRA(PAR) / PRY(AMA, CAU, CAA, CAN, CON)
Byrsonima verbascifolia	BRA(PAR)
Byttneria acalyphifolia	ARG(COR, COS, JUJ, SAL, TUC)
Byttneria australis	ARG(COS, MIS) / BRA(PAR, RGS, SCA)
Byttneria catalpifolia ssp. sidifolia	ARG(MIS) / BRA(PAR) / PRY(APA, AMA, CAU, CEN, GUA)
Byttneria dentata	BRA(Fuera del área del proyecto) / PRY(CAN, CON, COA, GUA, PAI, SPE)
Byttneria divaricata var. guaranitica	ARG(FOR) / BRA(Fuera del área del proyecto) / PRY(APY, CON, SPE)
Byttneria filipes	ARG(BAI, CHA, COS, ERI, FOR, SAL, SFE) / BRA(Fuera del área del proyecto) / PRY(APY, AMA, CEN, CON, COA, MIE, PHA)
Byttneria gracilipes	ARG(COS, MIS) / BRA(PAR, RGS) / PRY(APA, GUA)
Byttneria hatschbachii	BRA(PAR, RGS, SCA)
Byttneria implacabilis	BRA(PAR, SCA)
Byttneria oblongata	BRA(Fuera del área del proyecto) / PRY(AMA)
Byttneria oranensis	ARG(JUJ, SAL)
Byttneria ostenii	BRA(RGS) / PRY(COA, PAI)
Byttneria palustris	BRA(Fuera del área del proyecto) / PRY(AMA)
Byttneria pedersenii	ARG(COS, MIS) / BRA(RGS) / PRY(APA, AMA, CAU, CAA, CON, GUA, ITA, MIE)
Byttneria ramosissima	ARG(MIS) / BRA(Fuera del área del proyecto) / PRY(CAU, CAA, CEN, COA, GUA, PAI, SPE)
Byttneria rhamnifolia	ARG(CHA, FOR) / BRA(Fuera del área del proyecto) / PRY(ÑEE)
Byttneria rojasii	ARG(MIS) / BRA(Fuera del área del proyecto) / PRY(APA, CAA, ITA, SPE)
Byttneria scabra	ARG(CHA, COS, ERI, MIS, SFE) / BRA(PAR) / PRY(APY, APA, AMA, CAU, CAN, CEN, CON, COA, GUA, MIE, ÑEE, PAI, SPE) / URY(ART, RNO, SAO, SJO, SOR)
Byttneria stenophylla	PRY(AMA, CAU, CAN, CON, SPE)
Byttneria subsessilis	BRA(Fuera del área del proyecto) / PRY(APA, AMA, CAU, CAN, SPE)
Byttneria triadenia	BRA(PAR, SCA)
Byttneria urticifolia	ARG(BAI, COS, ERI, MIS, SFE) / BRA(RGS) / PRY(CAN, GUA, PAI) / URY(CLA, COL, LAV, MAL, SJO, TAC, TYT)
