Tabebuia aurea	ARG(COS, FOR, SAL) / BRA(PAR) / PRY(APY, AMA, BOQ, CAN, CHO, CON, COA, ÑEE, PHA)
Tabebuia cassinoides	BRA(PAR)
Tabebuia nodosa	ARG(CAT, CHA, COR, COS, FOR, JUJ, LRI, SAL, SDE, SFE, TUC) / BRA(Fuera del área del proyecto) / PRY(APY, AMA, CEN, CON, ÑEE, PAI, PHA)
Tabebuia roseo-alba	BRA(Fuera del área del proyecto) / PRY(AMA, CON)
Tabernaemontana catharinensis	ARG(CHA, COS, ERI, FOR, JUJ, MIS, SFE) / BRA(PAR, RGS, SCA) / PRY(APA, AMA, CAU, CAN, CEN, CON, COA, GUA, ITA, MIE, ÑEE, PAI, PHA, SPE) / URY(ART, PAY, RNO, SAO)
Taccarum peregrinum	ARG(MIS) / BRA(SCA) / PRY(APA)
Taccarum weddellianum	BRA(Fuera del área del proyecto) / PRY(APA, AMA, CAN, CON)
Tachigali aurea	BRA(Fuera del área del proyecto) / PRY(AMA, CON)
Tachigali denudata	BRA(PAR)
Taeniatherum caput-medusae	CHL(LBO, MAU)
Tagetes argentina	ARG(COR, MEN, SJU, SLU)
Tagetes biflora	ARG(LRI, MEN, SJU, SLU) / CHL(ATA)
Tagetes campanulata	ARG(CAT, JUJ, LRI, SAL, SJU, TUC)
Tagetes filifolia	ARG(CAT, COR, JUJ, SAL, SLU, TUC)
Tagetes laxa	ARG(CAT, JUJ, SAL, TUC)
Tagetes mendocina	ARG(CAT, LPA, LRI, MEN, SJU, SLU)
Tagetes minuta	ARG(BAI, CAT, CHA, COR, COS, DFE, ERI, FOR, JUJ, LPA, LRI, MEN, MIS, SAL, SDE, SFE, SJU, SLU, TUC) / BRA(PAR, RGS, SCA) / CHL(TAR, ANT, ATA, COQ, VAL, LBO, MAU, BIO, RME) / PRY(APY, AMA, COA, PHA) / URY(COL, LAV, MON, TAC)
Tagetes multiflora	ARG(CAT, JUJ, LRI, SAL, SJU, TUC) / CHL(TAR, ANT, ATA)
Tagetes ostenii	BRA(RGS, SCA) / URY(RNO, SAO)
Tagetes perezii	ARG(SJU)
Tagetes riojana	ARG(CAT, LRI)
Tagetes rupestris	ARG(TUC)
Tagetes terniflora	ARG(CAT, JUJ, SAL, TUC)
Talinum fruticosum	ARG(COR, COS, ERI, FOR, JUJ, LRI, MEN, SAL, SJU, SLU, SFE, SDE, TUC) / BRA(PAR) / PRY(APY, COA, PAI, PHA)
Talinum nocturnum	PRY(APY)
Talinum paniculatum	ARG(BAI, CAT, COR, COS, ERI, FOR, JUJ, LRI, MEN, MIS, SAL, SJU, SLU, SFE, TUC) / BRA(PAR, RGS, SCA) / PRY(APY, AMA, CAA, CAN, CEN, COA, GUA, PAI, PHA, SPE) / URY(RNO)
Talinum polygaloides	ARG(CAT, CHA, COR, ERI, FOR, LRI, MEN, SAL, SFE, SJU, SLU) / PRY(APY, COA, PHA)
Talinum porphyreum	PRY(APY, AMA)
Talipariti pernambucense	BRA(PAR, SCA)
Talisia angustifolia	BRA(PAR) / PRY(AMA, CAU, CON, SPE)
Talisia esculenta	BRA(Fuera del área del proyecto) / PRY(AMA, CON, SPE)
Tamarix ramosissima	ARG(BAI, CHA, CHU, JUJ, LPA, LRI, MEN, RNE, SAL, SJU, SCR)
Tamonea curassavica	PRY(APY)
Tanacetum balsamita	ARG(BAI, DFE, LPA, MEN)
Tanacetum parthenium	ARG(BAI, CAT, CHA, CHU, COR, JUJ, LRI, MEN, NEU, RNE, SAL, SJU, SLU, TDF, TUC) / BRA(RGS, SCA) / CHL(COQ, VAL, LBO, MAU, BIO, ARA, LLA, AIS, RME) / URY(MON)
Tanacetum vulgare	ARG(BAI, CHU, COR, COS, DFE, LRI, MEN, NEU, RNE, SAL, TDF, TUC) / BRA(PAR) / CHL(COQ, VAL, MAU, BIO, ARA, LLA, AIS, MAG, RME) / URY(MON)
Tanaecium cyrtanthum	ARG(SAL) / BRA(Fuera del área del proyecto) / PRY(AMA, CON, SPE)
Tanaecium mutabile	ARG(COS, FOR, MIS, SAL) / BRA(PAR, RGS, SCA) / PRY(APA, AMA, CAA, CAN, CEN, COA, GUA, ITA, MIE, PAI, PHA, SPE)
Tanaecium pyramidatum	BRA(PAR, RGS, SCA) / PRY(AMA) / URY(Desconocida)
Tanaecium selloi	ARG(CHA, COS, ERI, JUJ, MIS, SAL) / BRA(PAR, RGS, SCA) / PRY(APA, CAU, CAA, CAN, CEN, COA, GUA, ITA, PAI, SPE) / URY(ART)
Tanaecium tetramerum	PRY(APY)
Tapeinia pumila	ARG(TDF) / CHL(ARA, LLA, AIS, MAG)
Tapirira guianensis	BRA(PAR) / PRY(AMA)
Tarasa albertii	ARG(MEN, NEU)
Tarasa antofagastana	ARG(CAT, COR, JUJ, LRI, MEN, SAL, SJU, SLU, TUC) / CHL(ANT, ATA)
Tarasa capitata	ARG(CAT, COR, JUJ, SAL, TUC)
Tarasa congestiflora	CHL(TAR)
Tarasa heterophylla	ARG(JUJ, SAL)
Tarasa humilis	ARG(MEN, NEU, RNE) / CHL(MAU, BIO, ARA, RME)
Tarasa latearistata	ARG(JUJ)
Tarasa martiniana	CHL(ANT)
Tarasa meyeri	ARG(CAT, SAL, TUC)
Tarasa odonellii	ARG(JUJ, SAL, TUC)
Tarasa operculata	CHL(TAR, ANT)
Tarasa pediculata	CHL(ANT)
Tarasa reichei	CHL(MAU)
Tarasa tarapacana	ARG(JUJ, SAL, SJU) / CHL(TAR, ANT)
Tarasa tenella	ARG(CAT, JUJ, LRI, MEN, SAL, SJU, TUC) / CHL(TAR, ANT)
Tarasa trisecta	ARG(CAT, SAL, TUC)
Tarasa umbellata	CHL(MAU)
Tarasa urbaniana	ARG(TUC)
Taraxacum angustisquameum	CHL(RME)
Taraxacum copidophyllum	CHL(RME)
Taraxacum cuzcense	CHL(RME)
Taraxacum fernandezianum	BRA(PAR, SCA) / CHL(RME, JFE)
Taraxacum gilliesii	ARG(CHU, LPA, LRI, MEN, NEU, RNE, SCR, SJU, TDF) / CHL(MAG, RME)
Taraxacum laevigatum	ARG(BAI)
Taraxacum marklundii	CHL(RME)
Taraxacum officinale	ARG(BAI, CAT, CHA, CHU, COR, COS, DFE, ERI, FOR, JUJ, LPA, LRI, MEN, MIS, NEU, RNE, SAL, SCR, SDE, SFE, SJU, SLU, TDF, TUC) / BRA(RGS, SCA) / CHL(ANT, ATA, COQ, VAL, LBO, MAU, BIO, ARA, LLA, AIS, MAG, RME, IPA) / PRY(APA, CAA, GUA) / URY(MON, ROC)
Taraxacum patagonicum	CHL(MAG)
Taraxacum plumbeum	CHL(RME)
Taraxacum vatisectum	CHL(RME)
Tarenaya cordobensis	ARG(CAT, COR, COS, JUJ, LRI, MIS, SAL, SJU, SLU, SDE, TUC)
Tarenaya hassleriana	ARG(BAI, CHA, COR, COS, ERI, MIS, SAL, SFE, TUC) / BRA(PAR, RGS, SCA) / PRY(APA, CAU, CEN, ITA, PHA, SPE)
Tarenaya lilloi	ARG(CHA, FOR) / PRY(APY)
Tarenaya parviflora	ARG(BAI, COS, ERI, MIS) / BRA(PAR, RGS, SCA) / PRY(APA, COA, GUA, SPE) / URY(ART, SAO)
Tarenaya tucumanensis	ARG(COR, FOR, JUJ, SAL, SDE, TUC) / PRY(APY, BOQ)
Tartagalia roseorum	ARG(SAL)
Tassadia berteroana	BRA(PAR) / PRY(APY, CEN, SPE)
Tassadia obovata	BRA(PAR, SCA)
Tecoma capensis	ARG(COS)
Tecoma fulva	CHL(TAR)
Tecoma garrocha	ARG(CAT, JUJ, LRI, SAL, TUC)
Tecoma stans	ARG(CAT, COR, COS, ERI, JUJ, LRI, MIS, SAL, SFE, SDE, TUC) / BRA(RGS) / PRY(CEN)
Tecoma tenuiflora	ARG(CAT, JUJ, SAL, SDE)
Tecophilaea cyanocrocus	CHL(RME)
Tecophilaea violiflora f. violiflora	CHL(COQ, VAL, RME)
Tecophilaea violiflora f. polyantha	CHL(COQ)
Tectaria buchtienii	BRA(PAR, SCA)
Tectaria incisa	ARG(COS, JUJ, MIS, SAL) / BRA(PAR, RGS, SCA) / PRY(CAN, GUA)
Tectaria pilosa	BRA(PAR)
Teesdalia nudicaulis	CHL(MAG)
Temnadenia odorifera	BRA(PAR, RGS, SCA)
Temnadenia violacea	BRA(PAR)
Tephrocactus alexanderi	ARG(CAT, LRI, SJU, SLU)
Tephrocactus aoracanthus	ARG(CAT, LRI, MEN, SJU, SLU)
Tephrocactus articulatus var. articulatus	ARG(CAT, COR, LRI, MEN, SJU, SLU)
Tephrocactus articulatus var. oligacanthus	ARG(CAT, LRI, MEN, SAL, SDE, SJU, SLU)
Tephrocactus geometricus	ARG(CAT)
Tephrocactus halophilus	ARG(LRI, SJU, SLU)
Tephrocactus molinensis	ARG(SAL)
Tephrocactus weberi var. weberi	ARG(CAT, LRI, SAL, SJU, TUC)
Tephrocactus weberi var. deminutus	ARG(SAL)
Tephrosia adunca	ARG(CHA, COS, MIS, SFE) / BRA(PAR, RGS) / PRY(APA, CAU) / URY(RIV)
Tephrosia cinerea	ARG(BAI, CHA, COS, ERI, MIS, SFE, TUC) / BRA(RGS, SCA) / PRY(APY) / URY(CAS, COL, MON, RNO, SJO, SOR, TAC)
Tephrosia fertilis	ARG(MIS)
Tephrosia guaranitica	PRY(SPE)
Tephrosia hassleri	ARG(COS) / PRY(COA)
Tephrosia marginata	ARG(COS, ERI, MIS) / PRY(APY, CON) / URY(ART, MON, PAY, SAO)
Tepualia stipularis	ARG(CHU, RNE, TDF) / CHL(MAU, BIO, ARA, LLA, AIS, MAG)
Terminalia argentea	BRA(PAR) / PRY(AMA, CON)
Terminalia australis	ARG(BAI, COS, ERI, MIS) / BRA(PAR, RGS, SCA) / PRY(APA) / URY(COL, MON, PAY, RNO, SAO, SOR)
Terminalia catappa	BRA(PAR, SCA)
Terminalia glabrescens	BRA(PAR, RGS) / PRY(AMA, CAN, CON)
Terminalia reitzii	BRA(PAR, SCA)
Terminalia triflora	ARG(CAT, CHA, COS, FOR, JUJ, MIS, SAL, SFE, TUC) / BRA(PAR, SCA) / PRY(APA, APY, AMA, CAU, CAA, CAN, CEN, CON, COA, GUA, ITA, MIE, ÑEE, PAI, PHA, SPE)
Terminalia uleana	BRA(SCA)
Ternstroemia brasiliensis	BRA(PAR, SCA)
Ternstroemia congestiflora	ARG(SAL)
Terpsichore chrysleri	BRA(PAR)
Tessaria absinthioides	ARG(BAI, CAT, CHA, CHU, COR, JUJ, LPA, LRI, MEN, NEU, RNE, SAL, SJU, SLU, SDE, TUC) / BRA(RGS) / CHL(TAR, ANT, ATA, COQ, VAL, LBO, MAU, BIO, RME) / PRY(COA) / URY(MAL, MON, ROC)
Tessaria ambigua	ARG(BAI, CAT, CHA, COR, COS, FOR, JUJ, LRI, SAL, SFE, SDE, TUC) / BRA(SCA) / PRY(APY, BOQ, CEN, PHA)
Tessaria dodoneifolia ssp. dodoneifolia	ARG(BAI, CAT, CHA, COR, COS, FOR, JUJ, LRI, MEN, SAL, SJU, SLU, SFE, SDE, TUC) / PRY(CEN, PHA) / URY(COL)
Tessaria dodoneifolia ssp. plucheoides	PRY(CEN, PHA)
Tessaria fastigiata	ARG(JUJ, SAL, TUC) / PRY(APY)
Tessaria integrifolia var. integrifolia	ARG(BAI, CAT, CHA, COS, ERI, FOR, JUJ, MIS, SAL, SFE, TUC) / BRA(Fuera del área del proyecto) / PRY(APY, CEN, ÑEE, PHA) / URY(COL)
Tetilla hydrocotylifolia	CHL(COQ, VAL, LBO, MAU, ARA, RME)
Tetracera oblongata	ARG(MIS) / BRA(PAR, SCA) / PRY(APA, GUA, SPE)
Tetracera parviflora	BRA(Fuera del área del proyecto) / PRY(CAU, CAN, COA, SPE)
Tetracera sellowiana	BRA(PAR, SCA)
Tetracera volubilis	BRA(Fuera del área del proyecto) / PRY(AMA)
Tetrachondra patagonica	ARG(CHU, NEU, SCR, TDF) / CHL(MAG)
Tetraglochin acanthocarpum	ARG(CHU, SCR) / CHL(MAG)
Tetraglochin alatum var. alatum	ARG(CHU, JUJ, LRI, MEN, NEU, RNE, SJU, SLU, SCR) / CHL(ATA, COQ, VAL, LBO, MAU, BIO, RME)
Tetraglochin alatum var. patagonicum	ARG(NEU)
Tetraglochin ameghinoi	ARG(JUJ, MEN, SAL, SJU, SCR, TUC)
Tetraglochin caespitosum	ARG(CHU, MEN, NEU, RNE, SCR)
Tetraglochin cristatum	ARG(CAT, JUJ, LRI, SAL, TUC) / CHL(TAR)
Tetraglochin inerme	ARG(CAT, JUJ, SAL, TUC)
Tetraglochin paucijugatum	ARG(CAT, JUJ, TUC)
Tetragonia angustifolia	CHL(TAR, ANT, ATA, COQ)
Tetragonia copiapina	CHL(ANT, ATA, COQ)
Tetragonia crystallina	CHL(TAR)
Tetragonia espinosae	CHL(ANT, ATA, COQ)
Tetragonia macrocarpa	CHL(ANT, ATA, COQ, IDE)
Tetragonia maritima	CHL(ANT, ATA, COQ)
Tetragonia microcarpa	CHL(TAR, ANT, ATA)
Tetragonia ovata	CHL(TAR, ANT, ATA, COQ)
Tetragonia pedunculata	CHL(ATA)
Tetragonia tetragonoides	ARG(BAI, COR, ERI, FOR, TUC) / BRA(RGS) / CHL(ATA, COQ, VAL, MAU, BIO, LLA, RME, IDE, JFE) / URY(ROC)
Tetrapterys ambigua	ARG(JUJ, SAL) / BRA(Fuera del área del proyecto) / PRY(AMA, CAU, CAN, CON, COA, SPE)
Tetrapterys hassleriana	PRY(CON)
Tetrapterys mollis	ARG(MIS) / BRA(RGS)
Tetrapterys phlomoides	BRA(PAR)
Tetrapterys salicifolia	BRA(PAR) / PRY(GUA)
Tetrapterys xylosteifolia	BRA(PAR, RGS)
Tetroncium magellanicum	ARG(NEU, SCR, TDF) / CHL(ARA, LLA, AIS, MAG)
Tetrorchidium dusenii	BRA(PAR, RGS) / PRY(APY)
Tetrorchidium rubrivenium	ARG(MIS) / BRA(PAR, RGS, SCA) / PRY(APA, CAA)
Teucrium bicolor	CHL(COQ, VAL, LBO, MAU, BIO, ARA, LLA, RME)
Teucrium cubense ssp. cubense	ARG(BAI, CHA, COR, COS, ERI, MIS, SDE, SFE, TUC) / BRA(RGS) / URY(ART, CAS, CLA, FLO, MON, RNO)
Teucrium cubense ssp. cordobense	ARG(CAT, COR, COS, MEN, SAL, SDE, SFE, SLU, TUC)
Teucrium nudicaule	CHL(ANT, ATA, COQ)
Teucrium vesicarium	ARG(BAI, CHA, COS, DFE, ERI, FOR, JUJ, MIS, SAL, SFE) / BRA(RGS, SCA) / PRY(APA, CEN, COA, GUA, ÑEE, PAI, PHA) / URY(MON, SOR)
Thalia geniculata	ARG(BAI, CHA, COS, DFE, ERI, FOR, JUJ, SAL, SFE, TUC) / BRA(PAR, RGS, SCA) / PRY(APY, CEN, CHO, CON, MIE, ÑEE, PAI, PHA, SPE) / URY(ART, CLA, RIV, SAO, SOR)
Thalia multiflora	ARG(BAI, CHA, COS, ERI, FOR, SFE) / BRA(RGS) / PRY(APY, PHA) / URY(ART, CAS, CLA, ROC, SAO, TYT)
Thalictrum decipiens	ARG(CAT, COR, JUJ, SAL, SLU, TUC)
Thalictrum venturii	ARG(CAT, JUJ, LRI, SAL, TUC)
Thamnoseris lacerata f. lacerata	CHL(IDE)
Thamnoseris lacerata f. obtusifolia	CHL(IDE)
Thaumatocaryon dasyanthum	ARG(MIS) / BRA(Desconocida)
Thaumatocaryon tetraquetrum	ARG(MIS) / BRA(PAR) / PRY(APA)
Thelesperma megapotamicum	ARG(BAI, CHU, COR, ERI, LPA, MEN, NEU, RNE, SLU, SFE, SDE) / URY(PAY)
Thelocephala esmeraldana	CHL(ANT)
Thelocephala glabrescens	CHL(ATA)
Thelocephala krausii	CHL(TAR, ANT, ATA)
Thelocephala napina	CHL(ATA)
Thelocephala odieri	CHL(ATA)
Thelocephala tenebrica	CHL(ATA, COQ)
Thelocephala weisseri	
Thelypteris abbiattii	ARG(BAI, COS, ERI, MIS) / BRA(PAR, RGS, SCA) / PRY(CAN)
Thelypteris achalensis	ARG(CAT, COR, JUJ, SAL, TUC)
Thelypteris altitudinis	ARG(CAT, JUJ, MEN, SAL, SJU)
Thelypteris amambayensis	ARG(MIS) / BRA(PAR, RGS, SCA) / PRY(AMA, CAN, COA, GUA, PAI)
Thelypteris angustifolia	PRY(AMA)
Thelypteris araucariensis	BRA(PAR)
Thelypteris argentina	ARG(BAI, CAT, COR, LRI, MEN, RNE, SAL, SFE, SJU, SLU, TUC) / CHL(TAR, ATA, VAL, LBO, MAU, BIO) / URY(DUR, RNO)
Thelypteris berroi	ARG(COS, ERI, MIS) / BRA(SCA) / PRY(AMA, CON, PAI) / URY(RIV)
Thelypteris biformata	ARG(SAL)
Thelypteris browniana	ARG(SAL)
Thelypteris burkartii	ARG(BAI, ERI) / BRA(RGS)
Thelypteris cheilanthoides	BRA(PAR, SCA)
Thelypteris concinna	ARG(JUJ, SAL, TUC) / BRA(Fuera del área del proyecto) / PRY(COA, PAI)
Thelypteris confluens	ARG(BAI, CHA)
Thelypteris conspersa	ARG(COS, ERI, FOR, MIS, SAL) / BRA(PAR, RGS, SCA) / PRY(APA, AMA, CAU, CAA, CEN, COA, GUA, ITA, PAI, SPE) / URY(MAL, ROC)
Thelypteris decurtata ssp. decurtata	ARG(COS, JUJ, MIS, SAL, TUC) / BRA(PAR, RGS) / PRY(CAU, COA) / URY(CLA, ROC, TAC, TYT)
Thelypteris decurtata ssp. platensis	ARG(BAI, ERI) / URY(CLA)
Thelypteris decussata var. brasiliensis	BRA(PAR, SCA)
Thelypteris dentata	ARG(BAI, CHA, COR, COS, ERI, FOR, MIS, TUC) / BRA(PAR, RGS, SCA) / CHL(IPA) / PRY(APA, AMA, CAA, CAN, CEN, COA, GUA, PAI) / URY(PAY, RIV, ROC)
Thelypteris gardneriana	BRA(PAR, SCA)
Thelypteris glaziovii	BRA(PAR)
Thelypteris grandis var. kunzeana	ARG(JUJ, SAL) / BRA(Fuera del área del proyecto)
Thelypteris hatschbachii	BRA(PAR)
Thelypteris hispidula	ARG(BAI, CHA, COS, ERI, FOR, JUJ, MIS, SAL, SFE, TUC) / BRA(PAR, RGS, SCA) / PRY(APA, CAU, CAA, CAN, CEN, COA, ITA, PAI) / URY(PAY, RNO)
Thelypteris iguapensis	BRA(SCA)
Thelypteris interrupta	ARG(BAI, CHA, COS, ERI, JUJ, MIS, SAL, SFE) / BRA(PAR, RGS, SCA) / CHL(ATA, IPA) / PRY(APA, CEN, COA, GUA, ITA, MIE, ÑEE, PAI, PHA, SPE) / URY(RNO)
Thelypteris juergensii	ARG(BAI) / BRA(PAR, RGS, SCA)
Thelypteris jujuyensis	ARG(JUJ, SAL)
Thelypteris leprieurii	BRA(Fuera del área del proyecto) / PRY(CAN)
Thelypteris longifolia	BRA(PAR, SCA)
Thelypteris lugubris	BRA(Fuera del área del proyecto) / PRY(AMA, CAN, PAI, SPE)
Thelypteris maxoniana	BRA(PAR)
Thelypteris metteniana	ARG(MIS) / BRA(PAR, RGS, SCA) / PRY(APA, AMA, CAU)
Thelypteris mosenii	BRA(Fuera del área del proyecto) / PRY(APA, AMA, CAU)
Thelypteris nubicola	ARG(JUJ)
Thelypteris oligocarpa var. crassistipitata	ARG(JUJ, TUC) / BRA(Fuera del área del proyecto)
Thelypteris opposita	BRA(PAR, SCA) / PRY(AMA, CAA)
Thelypteris pachyrhachis	ARG(CAT, SAL, TUC) / BRA(PAR, RGS, SCA) / PRY(AMA, CAN)
Thelypteris paranaensis	BRA(PAR)
Thelypteris patens var. dissimilis	ARG(MIS) / BRA(RGS, SCA) / PRY(APA, AMA, CAU)
Thelypteris patens var. patens	ARG(CHA, JUJ, MIS, SAL, TUC) / BRA(RGS, SCA) / PRY(SPE)
Thelypteris pleiophylla	BRA(PAR, SCA)
Thelypteris podotricha	BRA(RGS)
Thelypteris ptarmica var. ptarmica	BRA(PAR, RGS, SCA)
Thelypteris ptarmica var. asplenioides	BRA(PAR, SCA)
Thelypteris raddii	BRA(PAR, RGS, SCA)
Thelypteris recumbens	ARG(MIS) / BRA(PAR, RGS, SCA) / PRY(APA)
Thelypteris regnelliana	ARG(MIS) / BRA(PAR, RGS, SCA)
Thelypteris retusa	BRA(PAR, RGS, SCA)
Thelypteris riograndensis	ARG(BAI, ERI, MIS) / BRA(PAR, RGS, SCA) / PRY(APA, CAA, COA, GUA, PAI) / URY(CLA, COL, MAL, TYT)
Thelypteris rioverdensis	BRA(PAR)
Thelypteris rivularioides	ARG(BAI, CHA, COS, ERI, FOR, JUJ, MIS, SAL) / BRA(PAR, RGS, SCA) / PRY(APA, AMA, CAU, CAA, CAN, COA, MIE, PAI) / URY(RIV)
Thelypteris salzmannii	PRY(CAU, CAA, COA)
Thelypteris sanctae-catharinae	ARG(MIS) / BRA(RGS, SCA)
Thelypteris scabra	ARG(CHA, COS, FOR, MIS) / BRA(PAR, RGS, SCA) / PRY(APA, AMA, CAA, CAN, GUA, PAI)
Thelypteris schizotis	ARG(CHA, COS, ERI, JUJ, MIS, SAL, TUC) / BRA(Fuera del área del proyecto) / PRY(GUA, PAI)
Thelypteris serrata	ARG(CHA, COS, ERI, FOR, MIS, SAL) / BRA(RGS, SCA) / PRY(APY, AMA, CAU, CAA, CAN, CON, COA, PAI, SPE)
Thelypteris stierii	ARG(COS, ERI, JUJ, SAL, TUC) / BRA(RGS) / PRY(CON) / URY(PAY, RNO, RIV)
Thelypteris tenerrima	BRA(PAR, RGS)
Thelypteris tetragona	ARG(CHA, FOR, SAL)
Thelypteris tristis	ARG(SAL)
Thelypteris vattuonei	ARG(JUJ, SAL, TUC)
Thelypteris vivipara	BRA(SCA)
Themeda quadrivalvis	ARG(JUJ, SFE) / PRY(SPE)
Thesium aphyllum	BRA(SCA)
Thevetia bicornuta	ARG(CHA, FOR) / PRY(APY, BOQ, CEN, CON, ÑEE, PHA, SPE)
Thevetia peruviana	PRY(AMA, CEN, COA)
Thinopyrum ponticum	ARG(COR, LPA, NEU, SLU, TDF)
Thinouia compressa	BRA(Fuera del área del proyecto) / PRY(GUA, SPE)
Thinouia mucronata	ARG(COS, JUJ, MIS, SAL) / BRA(PAR, RGS, SCA) / PRY(APA, CAU, CAA, COA, GUA, ITA, MIE, PAI, SPE)
Thinouia paraguayensis	BRA(Fuera del área del proyecto) / PRY(AMA, CEN, CON, COA, PAI, SPE)
Thinouia ventricosa	ARG(MIS) / BRA(PAR, RGS, SCA)
Thlaspi arvense	ARG(BAI, CHU, RNE, SCR, TDF) / CHL(MAG)
Thryallis brachystachys	BRA(PAR, SCA) / PRY(APY, AMA, CON)
Thryallis laburnum	BRA(Fuera del área del proyecto) / PRY(APY)
Thunbergia alata	ARG(JUJ, MIS) / BRA(PAR, RGS, SCA) / PRY(APY, CEN, COA, PAI, PHA)
Thunbergia fragans	BRA(SCA)
Thunbergia grandiflora	PRY(SPE)
Thymophylla pentachaeta	ARG(BAI, CAT, CHU, COR, LPA, LRI, MEN, NEU, RNE, SAL, SJU, SLU, SDE)
Thyrsacanthus boliviensis	ARG(JUJ, SAL) / BRA(Fuera del área del proyecto) / PRY(APY, CON, PAI)
Thyrsopteris elegans	CHL(JFE)
Tibouchina alpestris	ARG(JUJ, SAL, TUC)
Tibouchina asperior	BRA(RGS, SCA)
Tibouchina cerastifolia	BRA(PAR, RGS, SCA) / URY(RNO, SOR)
Tibouchina chamissoana	BRA(PAR)
Tibouchina cisplatensis	BRA(RGS, SCA)
Tibouchina clavata	BRA(PAR, SCA)
Tibouchina clinopodifolia	BRA(PAR, RGS, SCA)
Tibouchina debilis	ARG(COS, MIS) / BRA(PAR, RGS)
Tibouchina dubia	BRA(PAR, RGS, SCA)
Tibouchina dusenii	BRA(PAR, SCA)
Tibouchina floribunda	BRA(PAR)
Tibouchina frigidula	BRA(PAR)
Tibouchina glazioviana	BRA(PAR)
Tibouchina goldenbergii	BRA(PAR)
Tibouchina gracilis	ARG(COS, ERI, FOR, MIS, SFE) / BRA(PAR, RGS, SCA) / PRY(AMA, CAU, CAA, CAN, CEN, COA, GUA, MIE, PAI) / URY(CLA, TAC, TYT)
Tibouchina granulosa	BRA(PAR)
Tibouchina guimaraensis	BRA(PAR)
Tibouchina hassleri	PRY(CAN)
Tibouchina hatschbachii	BRA(PAR)
Tibouchina herbacea	ARG(CHA, COS, ERI, MIS) / BRA(PAR, RGS, SCA) / PRY(CAA, COA, GUA, PAI, SPE) / URY(CLA)
Tibouchina herincquiana	BRA(PAR)
Tibouchina hospita	BRA(PAR, RGS, SCA)
Tibouchina kleinii	BRA(PAR, SCA)
Tibouchina longipilosa	ARG(MIS) / BRA(PAR, RGS, SCA) / PRY(APA)
Tibouchina martialis	BRA(PAR)
Tibouchina martiusiana	BRA(PAR)
Tibouchina multiflora	BRA(SCA)
Tibouchina mutabilis	BRA(SCA)
Tibouchina nitida	ARG(BAI, COS, ERI, MIS) / BRA(PAR, RGS, SCA) / PRY(AMA, CON, SPE) / URY(COL)
Tibouchina ovata	BRA(PAR)
Tibouchina paratropica	ARG(CAT, CHA, COR, JUJ, MIS, SAL, TUC) / BRA(SCA)
Tibouchina parviflora	BRA(Fuera del área del proyecto) / PRY(AMA)
Tibouchina pilosa var. pilosa	BRA(PAR, RGS, SCA)
Tibouchina pilosa var. glandulosa	BRA(SCA)
Tibouchina pulchra	BRA(PAR, RGS, SCA)
Tibouchina ramboi	BRA(RGS, SCA)
Tibouchina regnellii	BRA(PAR)
Tibouchina reitzii	BRA(PAR, SCA)
Tibouchina riedeliana	BRA(PAR)
Tibouchina rojasii var. rojasii	PRY(APA, AMA)
Tibouchina rojasii var. robusta	PRY(AMA)
Tibouchina rupestris	BRA(PAR, RGS, SCA)
Tibouchina saxicola	BRA(PAR)
Tibouchina sellowiana	BRA(PAR, RGS, SCA)
Tibouchina semidecandra	BRA(SCA)
Tibouchina simplicicaulis	BRA(RGS)
Tibouchina trichopoda	BRA(PAR, RGS, SCA)
Tibouchina urbanii	BRA(RGS, SCA)
Tibouchina ursina	BRA(PAR, SCA)
Tibouchina urvilleana var. urvilleana	BRA(PAR, RGS, SCA)
Tibouchina urvilleana var. glandulifera	BRA(SCA)
Tibouchina versicolor	BRA(PAR, RGS, SCA)
Tibouchina violacea	PRY(CAA, CEN, COA, PAI)
Tigridia philippiana	CHL(TAR, ANT, ATA)
Tilesia baccata	ARG(MIS) / BRA(PAR, SCA) / PRY(AMA, CAU, CAA, CAN)
Tillandsia aëranthos var. aëranthos	ARG(BAI, CAT, COR, COS, ERI, JUJ, MIS, SAL, SDE, SFE, TUC) / BRA(RGS, SCA) / PRY(COA, PAI) / URY(CAS, FLA, LAV, MAL, MON, ROC, SJO, TAC)
Tillandsia aëranthos var. aemula	BRA(RGS)
Tillandsia afonsoana	BRA(RGS)
Tillandsia aizoides	ARG(CAT, COR, LPA, LRI, SAL, SDE, SJU, SLU, TUC)
Tillandsia albertiana	ARG(SAL)
Tillandsia andicola	ARG(BAI, CAT, MEN, SLU)
Tillandsia angulosa	ARG(LRI, MEN, SJU)
Tillandsia arequitae	URY(LAV)
Tillandsia argentina	ARG(CAT, COR, JUJ, LRI, SAL, TUC)
Tillandsia arhiza	PRY(PAI)
Tillandsia australis	ARG(JUJ, SAL, TUC)
Tillandsia bandensis	ARG(BAI, CAT, CHA, COR, COS, ERI, FOR, JUJ, LRI, SAL, SDE, SFE, TUC) / PRY(ÑEE, PHA) / URY(COL, SAO)
Tillandsia bella	BRA(RGS)
Tillandsia bergeri	ARG(BAI) / BRA(RGS)
Tillandsia brealitoensis	ARG(SAL)
Tillandsia buchlohii	PRY(Desconocida)
Tillandsia caliginosa	ARG(CAT, ERI, JUJ, SAL, TUC)
Tillandsia capillaris	ARG(BAI, CAT, COR, JUJ, LPA, LRI, MEN, SAL, SJU, SLU, SDE, TUC) / CHL(TAR, ANT, ATA, COQ, VAL) / URY(MON)
Tillandsia castellanii	ARG(COR, JUJ, LRI, SLU)
Tillandsia crocata	ARG(ERI) / BRA(PAR, RGS) / URY(SOR)
Tillandsia diaguitensis	ARG(FOR, JUJ, SAL, TUC) / PRY(APY)
Tillandsia didisticha	ARG(COS, FOR, JUJ, SAL, TUC) / BRA(Fuera del área del proyecto) / PRY(APY, CON, ÑEE, PAI)
Tillandsia dorotheae	ARG(SAL)
Tillandsia dura	BRA(SCA)
Tillandsia duratii var. duratii	ARG(CAT, CHA, COR, COS, ERI, FOR, JUJ, LRI, SAL, SDE, SFE, SJU, SLU, TUC) / PRY(APY) / URY(ART, SAO)
Tillandsia duratii var. saxatilis	ARG(CHA, COS, ERI, FOR, SFE) / BRA(RGS) / PRY(APY, AMA, CEN, CHO, COA, ÑEE, PHA)
Tillandsia erecta	ARG(LRI, MEN, SJU)
Tillandsia esseriana	PRY(AMA)
Tillandsia friesii	ARG(JUJ, SAL, TUC)
Tillandsia funebris	ARG(CAT, FOR, SAL, TUC) / PRY(APY, PHA)
Tillandsia gardneri	BRA(PAR, RGS, SCA)
Tillandsia geissei	CHL(ANT, ATA, COQ)
Tillandsia geminiflora var. geminiflora	ARG(MIS) / BRA(PAR, RGS, SCA) / PRY(CAA, GUA) / URY(LAV, TYT)
Tillandsia genseri	ARG(JUJ)
Tillandsia gilliesii ssp. gilliesii	ARG(BAI, CAT, JUJ, LPA, LRI, MEN, SAL, SJU, TUC)
Tillandsia gilliesii ssp. polysticha	ARG(JUJ, TUC)
Tillandsia guelzii	ARG(JUJ)
Tillandsia hirta	ARG(SAL)
Tillandsia itaubensis	BRA(RGS)
Tillandsia ixioides	ARG(CAT, COR, COS, ERI, JUJ, MIS, SAL, SDE, TUC) / BRA(RGS) / PRY(APY, PAI) / URY(COL, MON)
Tillandsia jonesii	BRA(RGS)
Tillandsia jucunda	ARG(JUJ, SAL, TUC)
Tillandsia landbeckii	CHL(TAR, ANT, ATA, COQ)
Tillandsia leonamiana	BRA(PAR)
Tillandsia leucopetala	BRA(RGS)
Tillandsia linearis	BRA(PAR)
Tillandsia loliacea	ARG(CHA, COR, COS, FOR, JUJ, MIS, SAL, SDE, SFE, TUC) / BRA(PAR) / PRY(APY, CAN, CEN, CON, COA, MIE, PAI, PHA, SPE)
Tillandsia lorentziana	ARG(CAT, CHA, COR, COS, FOR, JUJ, LRI, MIS, SAL, SDE, SJU, SLU, TUC) / BRA(PAR, RGS) / PRY(APY, CON, PAI)
Tillandsia mallemontii	BRA(PAR, RGS, SCA)
Tillandsia marconae	CHL(TAR)
Tillandsia mereliana	PRY(APY, CEN, PHA)
Tillandsia meridionalis	ARG(CHA, COS, ERI, FOR, JUJ, MIS, SAL, SFE, TUC) / BRA(RGS) / PRY(APY, AMA, BOQ, CEN, CHO, COA, GUA, ÑEE, PAI, PHA) / URY(ART)
Tillandsia minutiflora	ARG(BAI, CAT, CHU, COR, JUJ, LPA, LRI, MEN, RNE, SAL, SJU, SLU, SFE, SDE, TUC) / PRY(APY, CHO)
Tillandsia mollis var. reptans	ARG(JUJ)
Tillandsia montana	BRA(SCA)
Tillandsia muhriae	ARG(JUJ, SAL)
Tillandsia myosura	ARG(CAT, COR, JUJ, LRI, MEN, SAL, SJU, SLU, TUC) / URY(Desconocida)
Tillandsia pedicellata	
Tillandsia peiranoi var. alba	ARG(SAL)
Tillandsia peiranoi var. peiranoi	ARG(SAL)
Tillandsia pfeufferi	ARG(JUJ)
Tillandsia pohliana	ARG(COS, MIS, SAL) / BRA(PAR) / PRY(AMA, CAA, CAN, CEN, GUA, ITA, SPE)
Tillandsia polystachia	BRA(PAR)
Tillandsia porongoensis	ARG(LRI)
Tillandsia pseudomontana	BRA(SCA)
Tillandsia ramellae	PRY(APY)
Tillandsia rectangula	ARG(CAT, COR, LRI, SAL, SDE, SLU, TUC)
Tillandsia recurvata	ARG(BAI, CHA, COS, ERI, FOR, JUJ, LRI, MIS, SAL, SDE, SFE, TUC) / BRA(PAR, RGS, SCA) / PRY(APY, AMA, CAU, CEN, CON, GUA, MIE, ÑEE, PAI, PHA) / URY(ART, CLA, MON, SOR)
Tillandsia reichenbachii	ARG(CAT, CHA, COS, FOR, JUJ, SAL, SDE, TUC) / PRY(APY, PHA)
Tillandsia retorta	ARG(BAI, COR, LPA, MEN, SAL, SDE, SJU, SLU, TUC)
Tillandsia rohdenardini	BRA(RGS)
Tillandsia schreiteri	ARG(JUJ, SAL, TUC)
Tillandsia seideliana	BRA(SCA)
Tillandsia sphaerocephala	ARG(JUJ, TUC)
Tillandsia sphaerocephala var. tarijensis	ARG(JUJ)
Tillandsia streptocarpa	ARG(COS, MIS) / BRA(PAR, RGS) / PRY(APY, CEN, CON, COA, GUA, PAI, SPE)
Tillandsia stricta var. stricta	ARG(COS, MIS, SFE) / BRA(PAR, RGS, SCA) / PRY(APY, GUA, PAI) / URY(TYT)
Tillandsia stricta var. disticha	BRA(PAR, SCA)
Tillandsia tenebra	ARG(LRI)
Tillandsia tenuifolia var. tenuifolia	ARG(COS, JUJ, MIS, SAL, SJU, TUC) / BRA(PAR, RGS, SCA) / PRY(APA, APY, BOQ, CAA, CAN, GUA, MIE, ÑEE, PAI)
Tillandsia tenuifolia var. vaginata	BRA(PAR, RGS, SCA) / PRY(CAA, CEN, CON, GUA)
Tillandsia toropiensis	BRA(RGS)
Tillandsia tragophoba	CHL(ANT)
Tillandsia tricholepis	ARG(CAT, CHA, COR, COS, ERI, FOR, JUJ, MIS, SAL, SJU, SLU, SFE, SDE, TUC) / BRA(PAR, RGS) / PRY(APY, AMA, CEN, CON, COA, GUA, MIE, ÑEE, PAI, PHA, SPE) / URY(SAO)
Tillandsia usneoides	ARG(BAI, CAT, CHA, COR, COS, ERI, FOR, JUJ, MIS, SAL, TUC) / BRA(PAR, RGS, SCA) / CHL(COQ, VAL, BIO, ARA, LLA) / PRY(CAU, CAA, CON, GUA, ITA, ÑEE, PHA) / URY(ART, FLA, SOR)
Tillandsia vernicosa	ARG(CHA, COR, COS, FOR, JUJ, SAL) / PRY(APY, BOQ, CEN, CON, COA, ÑEE, PAI, PHA, SPE)
Tillandsia virescens	ARG(BAI, CAT, CHA, COR, JUJ, LRI, MEN, SAL, SLU, SDE, TUC) / CHL(TAR, COQ, VAL, LBO)
Tillandsia winkleri	BRA(RGS)
Tillandsia xiphioides var. xiphioides	ARG(BAI, CAT, COR, JUJ, LPA, LRI, MEN, MIS, SAL, SDE, SJU, SLU, TUC) / BRA(RGS) / URY(SJO)
Tillandsia xiphioides var. minor	ARG(COR, SLU)
Tillandsia xiphioides var. tafiensis	ARG(SAL, TUC)
Tillandsia zecheri var. zecheri	ARG(SAL)
Tillandsia zecheri f. brealitoensis	ARG(SAL)
Tillandsia zecheri var. cafayatensis	ARG(JUJ, SAL)
Tinantia erecta	ARG(CAT, JUJ, SAL, TUC) / BRA(Fuera del área del proyecto)
Tipuana tipu	ARG(ERI, JUJ, SAL, TUC) / BRA(RGS) / URY(CAS, MON)
Tiquilia atacamensis	CHL(TAR, ANT, ATA)
Tiquilia grandiflora	CHL(TAR, ANT, ATA)
Tiquilia litoralis	CHL(TAR, ANT, ATA)
Tiquilia nuttallii	ARG(MEN, NEU, SJU)
Tiquilia paronychioides	CHL(TAR, ANT, ATA)
Tiquilia tacnensis	CHL(TAR)
Tithonia rotundifolia	ARG(CHA, COR, JUJ, LPA, LRI, MIS, SAL, SDE)
Tithonia tubiformis	ARG(CHA, COR, JUJ, SAL, SDE)
Tocoyena formosa	BRA(Fuera del área del proyecto) / PRY(APY, AMA, CAN, CON, COA, PAI, SPE)
Tocoyena sellowiana	BRA(PAR, SCA)
Tolpis barbata	CHL(LBO, MAU, BIO, RME)
Tomostima australis	ARG(BAI, CHU, ERI, LPA, MEN, NEU, RNE, SCR, TDF) / CHL(COQ, MAG) / URY(PAY)
Tontelea micrantha	BRA(PAR) / PRY(AMA, CAU, CAN, CON, SPE)
Tontelea miersii	BRA(PAR)
Tordylium maximum	ARG(BAI, COR, LPA, SFE)
Torenia thouarsii	BRA(PAR)
Torilis arvensis	ARG(BAI) / BRA(PAR, RGS, SCA) / CHL(MAU) / URY(CLA, LAV, RIV)
Torilis nodosa	ARG(BAI, LPA, MEN, SFE) / BRA(RGS, SCA) / CHL(COQ, VAL, LBO, MAU, BIO, ARA, RME, JFE) / URY(CAS, CLA, FLO, MAL, MON, RNO, SJO, SOR)
Toulicia tomentosa	BRA(Fuera del área del proyecto) / PRY(AMA, CON)
Tournefortia bicolor	BRA(PAR, RGS, SCA) / PRY(CAN)
Tournefortia gardneri	BRA(SCA)
Tournefortia lilloi	ARG(JUJ, SAL, TUC)
Tournefortia membranacea	BRA(RGS, SCA)
Tournefortia salicifolia	BRA(PAR, RGS)
Tourrettia lappacea	ARG(SAL)
Trachycarpus fortunei	ARG(BAI, TUC)
Trachypogon macroglossus	BRA(PAR, RGS, SCA)
Trachypogon spicatus	ARG(BAI, CHA, COR, COS, ERI, MIS, SAL) / BRA(PAR, RGS, SCA) / PRY(APA, AMA) / URY(MAL)
Trachypteris pinnata	ARG(CHA, FOR, JUJ, SAL, SDE, TUC) / BRA(Fuera del área del proyecto) / PRY(APY)
Tradescantia ambigua	ARG(CAT, CHA, COR, JUJ, LRI, SAL, SDE, TUC) / BRA(Fuera del área del proyecto) / PRY(APY, COA, PAI)
Tradescantia anagallidea	ARG(BAI, COS, ERI, MIS, SFE) / BRA(RGS, SCA) / PRY(APA, CAN) / URY(CLA, LAV, TAC)
Tradescantia blossfeldiana	ARG(MIS) / BRA(PAR)
Tradescantia boliviana	ARG(COR, JUJ, SAL, TUC) / PRY(APY, COA, GUA)
Tradescantia cerinthoides	BRA(PAR, RGS, SCA)
Tradescantia chrysophylla	BRA(PAR, SCA)
Tradescantia crassula	ARG(MIS) / BRA(PAR, RGS, SCA) / PRY(PAI) / URY(CLA, MON, ROC, TYT)
Tradescantia cymbispatha	ARG(BAI, CHA, COS, MIS, SAL) / BRA(RGS) / PRY(COA, SPE)
Tradescantia fluminensis	ARG(BAI, CHA, COR, COS, ERI, FOR, JUJ, MIS, SAL, SFE, TUC) / BRA(PAR, RGS, SCA) / CHL(LLA) / PRY(APA, CEN, COA, ITA, PAI) / URY(CLA, MON, ROC, TYT)
Tradescantia mundula	ARG(CHA, COS) / BRA(PAR, RGS)
Tradescantia pallida	ARG(MIS)
Tradescantia seubertiana	BRA(PAR, RGS, SCA)
Tradescantia tenella	ARG(BAI, COS, MIS, SFE) / BRA(PAR) / URY(TAC)
Tradescantia umbraculifera	ARG(COS, MIS) / BRA(PAR, RGS, SCA)
Tradescantia zebrina	ARG(BAI, MIS, SAL, TUC) / BRA(RGS) / PRY(PAI)
Tragia alienata	ARG(COS, MIS, SAL) / BRA(PAR, SCA) / PRY(APA, CAA, CAN, CON, COA, GUA, PAI)
Tragia bahiensis	ARG(COS, ERI, SDE) / BRA(PAR, RGS, SCA) / PRY(AMA, CAA, CON) / URY(RIV)
Tragia caperonioides	PRY(APY)
Tragia chlorocaulon	BRA(Fuera del área del proyecto) / PRY(AMA, CAU, CEN, COA)
Tragia dodencandra	ARG(CHA, COR, LRI, SDE, SLU)
Tragia friesii	ARG(JUJ, SAL) / BRA(Fuera del área del proyecto)
Tragia geraniifolia	ARG(BAI, CAT, CHA, COR, COS, ERI, FOR, JUJ, LRI, SAL, SFE, SJU, SLU) / BRA(RGS) / PRY(APY, ÑEE) / URY(ART, COL, CLA, FLA, MON, PAY, RNO, SAO, SJO, SJO)
Tragia giardelli	ARG(MIS) / BRA(SCA)
Tragia hassleriana	PRY(CAN)
Tragia hieronymii	ARG(CHA, COR, FOR, JUJ, LRI, SAL, SDE, SJU, SLU) / BRA(Fuera del área del proyecto) / PRY(APY, PHA)
Tragia incana	URY(CAS, CLA, FLA, LAV, MON, RIV, ROC, TAC)
Tragia melochioides	ARG(CAT, COR, COS, ERI, JUJ, MIS, SAL, SLU, TUC) / BRA(RGS) / PRY(CEN, CON, GUA, PAI, SPE) / URY(RNO, SOR)
Tragia paxii	ARG(MIS) / BRA(Fuera del área del proyecto) / PRY(GUA, PAI)
Tragia pinnata	ARG(BAI, COR, COS, ERI) / BRA(RGS) / URY(CAS, FLA, MAL, MON, SOR)
Tragia polyandra	ARG(MIS) / BRA(PAR, RGS, SCA) / PRY(AMA, CAN, COA, GUA)
Tragia uberabana var. uberabana	ARG(CHA, COS, ERI, FOR, MIS) / BRA(PAR, RGS, SCA) / PRY(APY, AMA, CON, MIE, PAI) / URY(CLA, LAV, RIV, ROC, SAO, SJO, TAC, TYT)
Tragia uberabana var. discolor	ARG(COS, MIS) / BRA(RGS, SCA) / PRY(AMA, CAA, CAN, CON, PAI, SPE)
Tragia volubilis	ARG(BAI, CAT, CHA, COR, COS, ERI, FOR, JUJ, MIS, SAL, SDE, SFE, TUC) / BRA(PAR, RGS, SCA) / PRY(APA, APY, AMA, BOQ, CAU, CAA, CAN, CON, ÑEE, PAI, SPE) / URY(ART, RIV, TYT)
Tragopogon dubius	ARG(BAI, CHU, COR, LPA, MEN, NEU, RNE, SLU, SCR)
Tragopogon porrifolius	ARG(BAI, CHU, JUJ, MEN, NEU, RNE) / CHL(COQ, VAL, LBO, BIO, AIS, RME)
Tragopogon pratensis	ARG(BAI, LPA, TDF)
Tragus andicola	ARG(CAT, JUJ, SAL, TUC)
Tragus australianus	ARG(FOR, LPA, LRI, SAL, SJU, SLU) / PRY(APY)
Tragus berteronianus	ARG(BAI, CAT, CHA, COR, FOR, JUJ, LPA, LRI, MEN, SAL, SJU, SLU, SDE, TUC)
Tragus racemosus	ARG(BAI)
Traubia modesta	CHL(COQ, VAL, LBO)
Trema micrantha	ARG(CHA, COS, FOR, JUJ, MIS, SAL, TUC) / BRA(PAR, RGS, SCA) / PRY(APA, AMA, CAA, CAN, COA, GUA, ITA, PAI, SPE)
Trembleya parviflora	BRA(PAR)
Trembleya phlogiformis	BRA(PAR)
Trevoa quinquenervia	CHL(COQ, VAL, LBO, MAU, RME)
Trianthema argentina	ARG(CAT, COR, LRI, SJU)
Trianthema portulacastrum	ARG(CAT, COR, FOR, JUJ, SAL, SDE, TUC) / PRY(APY)
Tribeles australis	ARG(RNE, SCR, TDF) / CHL(LLA, AIS, MAG)
Tribulus terrestris	ARG(BAI, CAT, COR, ERI, JUJ, LPA, LRI, MEN, RNE, SAL, SDE, SFE, SJU, SLU, TUC) / CHL(TAR, ANT, ATA) / URY(CAS, FLA, MON)
Trichanthecium caaguazuense	ARG(MIS) / BRA(Fuera del área del proyecto) / PRY(CAU)
Trichanthecium cyanescens	BRA(PAR, RGS, SCA) / PRY(AMA)
Trichanthecium parvifolium	ARG(COS, MIS, SFE) / BRA(PAR, RGS, SCA) / PRY(APA, AMA, CAU, CAA, CAN, COA, GUA, PAI, SPE)
Trichanthecium pseudisachne	BRA(PAR)
Trichanthecium schwackeanum	ARG(BAI, COS, ERI, MIS) / BRA(PAR, RGS, SCA) / PRY(APA, AMA, CAU, CAN, CEN, COA, ÑEE, PAI, SPE) / URY(CAS, MON)
Trichanthecium wettsteinii	BRA(PAR)
Trichilia casaretti	BRA(PAR, RGS, SCA)
Trichilia catigua	ARG(CHA, COS, FOR, MIS, SDE) / BRA(PAR, RGS, SCA) / PRY(APA, APY, AMA, CAU, CAA, CAN, CEN, CON, COA, GUA, ÑEE, PAI, PHA, SPE)
Trichilia claussenii	ARG(COS, JUJ, MIS, SAL) / BRA(PAR, RGS, SCA) / PRY(APA, AMA, CON)
Trichilia elegans	ARG(CHA, COS, FOR, MIS) / BRA(PAR, RGS, SCA) / PRY(APA, AMA, CAU, CAA, CAN, CEN, CON, COA, GUA, ÑEE, PAI, PHA, SPE) / URY(ART, SOR)
Trichilia hirta	BRA(Fuera del área del proyecto) / PRY(CEN, COA, PAI)
Trichilia lepidota ssp. schumanniana	BRA(PAR, RGS, SCA)
Trichilia pallens	BRA(PAR, RGS, SCA) / PRY(AMA, CAN)
Trichilia pallida	ARG(COS, FOR, MIS) / BRA(PAR) / PRY(APA, AMA, CAN, CEN, CON, COA, PAI)
Trichilia pseudostipularis	BRA(PAR, SCA)
Trichilia silvatica	BRA(PAR, SCA)
Trichilia stellato-tomentosa	PRY(AMA, CON)
Trichilia tetrapetala	BRA(PAR)
Trichloris crinita	ARG(BAI, CAT, CHA, COR, COS, ERI, FOR, JUJ, LPA, LRI, MEN, RNE, SAL, SJU, SLU, SFE, SDE, TUC) / PRY(APY) / URY(RNO)
Trichloris pluriflora f. pluriflora	ARG(BAI, CAT, CHA, COR, DFE, ERI, FOR, JUJ, LRI, MEN, SAL, SDE, SFE, SJU, SLU, TUC) / PRY(APY)
Trichloris pluriflora f. macra	ARG(COR)
Trichocentrum cebolleta	ARG(COS, FOR, MIS) / BRA(PAR) / PRY(AMA)
Trichocentrum fuscum	BRA(PAR, SCA)
Trichocentrum jonesianum	ARG(CHA, COS, MIS) / BRA(PAR) / PRY(CEN, GUA)
Trichocentrum morenoi	PRY(APA)
Trichocentrum pumilum	ARG(CHA, COS, FOR, MIS, SFE) / BRA(PAR, RGS, SCA) / PRY(CAA, CAN, ITA, ÑEE, PAI, SPE) / URY(TYT)
Trichocereus andalgalensis	ARG(CAT)
Trichocereus angelesii	ARG(SAL)
Trichocereus arboricola	ARG(SAL)
Trichocereus atacamensis	ARG(CAT, JUJ, SAL, TUC) / CHL(ANT)
Trichocereus cabrerae	ARG(CAT, LRI)
Trichocereus candicans	ARG(BAI, COR, LPA, LRI, MEN, SJU, SLU)
Trichocereus chiloensis ssp. chiloensis	CHL(ANT, COQ, VAL, LBO, MAU, RME)
Trichocereus chiloensis ssp. litoralis	CHL(COQ, VAL, LBO, MAU, BIO)
Trichocereus coquimbanus	CHL(COQ)
Trichocereus deserticola	CHL(ANT, ATA)
Trichocereus fabrisii	ARG(JUJ)
Trichocereus glaucus f. pendens	CHL(TAR)
Trichocereus huascha var. huascha	ARG(CAT, LRI, SJU)
Trichocereus huascha var. pecheretianus	ARG(CAT, LRI)
Trichocereus lamprochlorus	ARG(COR, LRI)
Trichocereus nigripilis	CHL(COQ)
Trichocereus pseudocandicans	ARG(LRI)
Trichocereus rowleyi	ARG(CAT)
Trichocereus schickendantzii	ARG(JUJ, SAL, TUC)
Trichocereus skottsbergii	CHL(COQ)
Trichocereus smrzianus	ARG(SAL)
Trichocereus strigosus	ARG(CAT, LRI, MEN, SAL, SJU)
Trichocereus tarijensis	ARG(JUJ)
Trichocereus terscheckii	ARG(CAT, JUJ, LRI, SAL, SJU, TUC)
Trichocereus thelegonoides	ARG(JUJ, SAL)
Trichocereus thelegonus	ARG(JUJ, SAL, TUC)
Trichocereus vatteri	ARG(LRI)
Trichocline aurea	CHL(COQ, VAL, LBO, MAU, BIO, ARA, RME)
Trichocline auriculata var. auriculata	ARG(JUJ, LRI, SAL)
Trichocline auriculata var. breviscapa	ARG(CAT, JUJ, SAL)
Trichocline boecheri	ARG(MEN, SJU)
Trichocline catharinensis var. catharinensis	BRA(PAR, RGS, SCA) / URY(ROC)
Trichocline caulescens	CHL(TAR, ANT)
Trichocline cineraria	ARG(MEN, SJU) / CHL(COQ, VAL)
Trichocline cisplatina	BRA(RGS) / URY(ROC)
Trichocline dealbata	ARG(MEN, NEU) / CHL(LBO, RME)
Trichocline deserticola	CHL(TAR, ANT)
Trichocline exscapa	ARG(CAT, COR, JUJ, SAL, TUC)
Trichocline heterophylla	ARG(ERI) / URY(CAS, FLA, MAL, MON)
Trichocline humilis	ARG(COS, ERI, SFE) / BRA(RGS) / PRY(PAI) / URY(ART, CAS, MAL, ROC, SAO, SOR, TAC)
Trichocline incana	ARG(ERI, SAL) / BRA(RGS) / URY(ART, COL, MAL, MON, PAY, ROC, SJO)
Trichocline linearifolia	BRA(PAR)
Trichocline macrocephala	ARG(MIS) / BRA(PAR, RGS, SCA)
Trichocline macrorhiza	ARG(JUJ, SAL)
Trichocline maxima	BRA(RGS) / URY(RIV, TAC)
Trichocline plicata	ARG(COR, SLU)
Trichocline reptans	ARG(BAI, CAT, CHA, COR, JUJ, LPA, LRI, MEN, RNE, SAL, SJU, SLU, SFE, SDE, TUC) / PRY(APY)
Trichocline sinuata	ARG(BAI, COR, ERI, LPA, MEN, RNE, SLU, SFE)
Trichocline speciosa	ARG(COS, MIS) / BRA(PAR, SCA) / PRY(APA, AMA, CAU, COA, GUA, SPE)
Trichogonia chodatii	PRY(AMA, CAU)
Trichogonia hassleri	BRA(Fuera del área del proyecto) / PRY(APY, AMA, CAU, CON, COA, GUA)
Trichogonia phlebodes	PRY(AMA)
Trichogonia salviifolia	BRA(Fuera del área del proyecto) / PRY(APY, AMA, CHO, CON, COA, GUA, PAI, PHA)
Trichomanes anadromum	ARG(MIS, TUC) / BRA(PAR, RGS, SCA) / URY(CLA, TAC)
Trichomanes angustifrons	PRY(PAI)
Trichomanes capillaceum	BRA(PAR) / URY(Desconocida)
Trichomanes collariatum	BRA(PAR) / PRY(PAI)
Trichomanes cristatum	BRA(PAR, RGS, SCA) / PRY(APA, AMA, CAU, CAN, COA)
Trichomanes elegans	BRA(PAR, SCA)
Trichomanes exsectum	CHL(MAU, LLA, JFE)
Trichomanes fontanum	BRA(RGS)
Trichomanes ingae	CHL(JFE)
Trichomanes mosenii	BRA(SCA) / PRY(COA)
Trichomanes pellucens	ARG(MIS) / BRA(PAR, SCA)
Trichomanes philippianum	CHL(JFE)
Trichomanes pilosum	ARG(MIS) / BRA(PAR, RGS, SCA) / PRY(AMA, COA, GUA, PAI) / URY(TAC)
Trichomanes polypodioides	BRA(PAR, SCA) / PRY(COA) / URY(TAC)
Trichomanes punctatum	BRA(RGS, SCA)
Trichomanes rigidum	BRA(PAR, RGS, SCA) / PRY(CAN, PAI, SPE)
Trichomanes rupestre	BRA(PAR, RGS, SCA) / PRY(AMA, PAI)
Trichoneura weberbaueri	CHL(TAR)
Trichopetalum chosmalensis	ARG(NEU)
Trichopetalum plumosum	CHL(COQ, VAL, LBO, MAU, BIO, ARA, RME)
Trichophorum rigidum	ARG(CAT, JUJ, SAL)
Trichosalpinx montana	BRA(PAR, SCA)
Trichostigma octandrum	ARG(MIS, SAL) / BRA(PAR, SCA) / PRY(SPE)
Trichotolinum deserticola	ARG(CHU, SCR)
Tricomaria usillo	ARG(CAT, COR, LRI, MEN, SAL, SJU, SLU, TUC)
Tridax procumbens	ARG(COR, FOR, JUJ, SAL, TUC) / BRA(PAR)
Tridens brasiliensis	ARG(BAI, CHA, COR, COS, ERI, FOR, MIS, SFE) / BRA(RGS) / PRY(CEN, CON, ÑEE, PAI, PHA, SPE) / URY(FLA, SAO, TAC)
Tridens hackelii	ARG(COS, ERI) / BRA(RGS) / URY(ART)
Tridens nicorae	ARG(COR, SLU)
Tridens riograndensis	BRA(RGS)
Trifolium amabile var. amabile	ARG(CAT, COR, JUJ, SAL, TUC)
Trifolium amabile var. hemsleyi	ARG(COR, JUJ)
Trifolium angustifolium	CHL(VAL, LBO, MAU, BIO, ARA, RME) / URY(CAS)
Trifolium antucoense	CHL(LBO, BIO, LLA)
Trifolium arvense	ARG(BAI, NEU, RNE) / CHL(LBO, MAU, BIO, ARA, LLA, AIS, MAG) / URY(FLA, MON)
Trifolium aureum	ARG(NEU, RNE) / CHL(MAG)
Trifolium campestre	ARG(NEU, RNE) / BRA(PAR, RGS) / CHL(COQ, VAL, LBO, MAU, BIO, LLA, MAG, JFE) / URY(CAS, CLA, FLA, MON)
Trifolium chilense	CHL(VAL, BIO, LLA, RME)
Trifolium depauperatum	CHL(VAL, LBO, MAU, BIO, ARA, RME)
Trifolium dubium	ARG(BAI, CHU, DFE, NEU, RNE, TDF) / BRA(RGS, SCA) / CHL(VAL, LBO, MAU, BIO, ARA, LLA, AIS, MAG, RME, JFE) / URY(FLO, MON, SOR, TAC)
Trifolium fragiferum ssp. fragiferum	ARG(BAI, NEU, RNE) / CHL(MAG)
Trifolium fragiferum ssp. bonanni	ARG(BAI) / URY(COL, MON)
Trifolium glomeratum	ARG(CHU, NEU) / CHL(MAU) / URY(TYT)
Trifolium hybridum var. anatolicum	ARG(BAI, CHU, NEU, RNE, SCR, TDF)
Trifolium hybridum var. hybridum	ARG(CHU, NEU, RNE) / CHL(BIO, MAG) / URY(FLA, MON, SOR)
Trifolium incarnatum	CHL(VAL, MAU, BIO, ARA, LLA, RME)
Trifolium lappaceum	URY(CLA, FLA, MON, TAC)
Trifolium macraei	CHL(LBO, MAU, BIO, RME)
Trifolium microdon	CHL(BIO, ARA, LLA, RME)
Trifolium pallidum	URY(DUR, FLA)
Trifolium physanthum	CHL(VAL, LBO, MAU, BIO, LLA)
Trifolium polymorphum var. polymorphum	ARG(BAI, CHA, COR, COS, ERI, LPA, MIS, RNE, SFE) / BRA(RGS) / CHL(ANT, ATA, COQ, VAL, LBO, MAU, BIO, LLA, RME) / PRY(CAU, GUA) / URY(ART, CAS, CLA, COL, DUR, FLA, LAV, MAL, MON, PAY, ROC, SAO, SJO, SOR, TAC, TYT)
Trifolium polymorphum var. grandiflorum	ARG(ERI) / CHL(MAU, BIO, RME) / URY(CAS, CLA, COL, DUR, FLA, RNO, SJO, SOR, TYT)
Trifolium polymorphum var. neuquenense	ARG(NEU)
Trifolium pratense	ARG(BAI, CHA, CHU, LPA, MEN, NEU, RNE, SCR, SFE, TDF) / BRA(PAR, RGS, SCA) / CHL(COQ, VAL, MAU, BIO, ARA, LLA, AIS, MAG, RME, JFE) / URY(COL, MON)
Trifolium repens	ARG(BAI, CAT, CHU, COR, DFE, ERI, JUJ, LPA, MEN, NEU, RNE, SAL, SCR, SFE, SJU, SLU, TDF, TUC) / BRA(RGS) / CHL(COQ, VAL, LBO, MAU, BIO, ARA, LLA, AIS, MAG, RME, JFE, IPA) / URY(CLA, MAL, MON, PAY)
Trifolium resupinatum	ARG(BAI) / URY(FLA, MON)
Trifolium riograndense ssp. riograndense	ARG(MIS) / BRA(PAR, RGS, SCA) / URY(CLA, SOR)
Trifolium riograndense ssp. pseudocalyculatum	URY(CLA, TYT)
Trifolium spadiceum	ARG(TDF) / CHL(MAG)
Trifolium squamosum	URY(FLA, MON)
Trifolium striatum	CHL(LBO, MAU, BIO, ARA, RME)
Trifolium subterraneum	ARG(BAI) / BRA(PAR) / CHL(MAU, BIO, ARA) / URY(MON, SOR)
Trifolium suffocatum	CHL(LBO, RME)
Trifolium tomentosum	CHL(VAL, LBO, BIO, RME)
Trifolium triaristatum	CHL(VAL, LBO, BIO, LLA)
Trifolium vernum	CHL(VAL, LBO)
Trifolium vestitum	CHL(COQ, RME)
Triglochin concinna	ARG(BAI, CAT, CHU, JUJ, LRI, MEN, NEU, SAL, SCR, SJU, TDF) / CHL(TAR, ANT, ATA, VAL, MAG)
Triglochin maritima	ARG(MEN, NEU, SCR)
Triglochin palustris	ARG(BAI, CAT, JUJ, MEN, RNE, SAL, SCR, SJU, TDF, TUC) / CHL(ANT, ATA, COQ, MAU, LLA, MAG, RME)
Triglochin scilloides	ARG(BAI, CHU, COR, COS, ERI, LRI, RNE, SAL) / CHL(MAU, MAG, RME) / URY(CAS, FLA, MAL, MON, SJO, SJO)
Triglochin striata	ARG(BAI, CAT, COR, ERI, MEN, RNE, SJU, SFE, TDF) / BRA(PAR) / CHL(TAR, ANT, ATA, COQ, VAL, MAU, BIO, ARA, LLA, AIS, RME) / URY(CAS, COL, FLA, MON, ROC)
Trigonella monspeliaca	ARG(MEN) / CHL(VAL, LBO, RME)
Trigonia boliviana	PRY(SPE)
Trigonia nivea var. nivea	ARG(MIS) / BRA(PAR, SCA) / PRY(APA, AMA, CAN, CON, SPE)
Trigonia nivea var. pubescens	BRA(PAR, SCA)
Trigonidium latifolium	BRA(PAR)
Trigonidium macranthum	BRA(PAR)
Trigonidium obtusum	BRA(PAR, SCA)
Trimezia bauensis	BRA(SCA)
Trimezia juncifolia	BRA(PAR)
Trimezia martinicensis	BRA(PAR, SCA)
Trimezia spathata ssp. martii	ARG(COS, MIS) / BRA(PAR, RGS) / PRY(CAU, CAA, CAN, CEN, CON, GUA, ITA, PAI, SPE)
Trimezia spathata ssp. grandis	BRA(Fuera del área del proyecto) / PRY(AMA)
Triodanis perfoliata ssp. biflora	ARG(CAT, CHA, CHU, COR, COS, ERI, JUJ, LPA, LRI, MEN, MIS, NEU, RNE, SAL, SJU, SLU, SFE, TUC) / BRA(PAR, RGS, SCA) / CHL(ANT, VAL, BIO, LLA) / PRY(APA, PAI) / URY(CAS, CLA, COL, FLO, FLA, LAV, MAL, MON, PAY, RNO, SAO, SJO, SOR, TAC)
Triphora hassleriana	ARG(COS, MIS, SAL) / PRY(PAI, SPE)
Triplaris americana	BRA(PAR)
Triplaris gardneriana	BRA(PAR) / PRY(APY, APA, CEN, CON, ITA, PAI, PHA, SPE)
Tripleurospermum inodorum	ARG(CHU, ERI, NEU, RNE, SCR, TDF, TUC) / CHL(MAG) / URY(CAS, MON)
Tripodanthus acutifolius	ARG(CAT, CHA, COS, FOR, JUJ, LRI, MIS, SAL, SDE, TUC) / BRA(PAR, RGS, SCA) / PRY(APY) / URY(ART, DUR, RIV, ROC, TAC)
Tripodanthus flagellaris	ARG(CAT, COR, COS, ERI, LRI, SDE, SLU) / URY(RNO)
Tripogandra diuretica	ARG(BAI, COS, ERI, FOR, MIS, SFE) / BRA(PAR, RGS, SCA) / PRY(CAA, CAN, CEN, GUA) / URY(MON)
Tripogandra glandulosa	ARG(BAI, CAT, CHA, COR, COS, ERI, FOR, JUJ, MIS, SAL, SFE, TUC) / BRA(PAR, RGS) / PRY(APY, AMA, CEN, CON, COA, GUA, ÑEE, PHA, SPE) / URY(CLA, RIV, TYT)
Tripogandra multiflora	ARG(JUJ, SAL)
Tripogandra purpurascens ssp. australis	ARG(CAT, JUJ, MIS, SAL, TUC)
Tripogon ekmanii	ARG(MIS) / PRY(AMA) / URY(TYT)
Tripogon nicorae	ARG(CAT, LRI) / CHL(TAR)
Tripogon spicatus	ARG(BAI, CAT, CHA, COR, COS, ERI, FOR, JUJ, LRI, MEN, MIS, SAL, SJU, SLU, SFE, SDE, TUC) / BRA(PAR, RGS) / CHL(TAR) / PRY(APY, AMA, CEN, CON, COA, ITA, PAI, SPE) / URY(ART, FLO, LAV, MAL, MON, RNO, SAO, SOR, TAC)
Tripsacum australe	PRY(AMA)
Triptilion achilleae	ARG(CHU, NEU, RNE, SCR) / CHL(LBO, BIO, ARA, LLA, RME)
Triptilion benaventei	CHL(ARA)
Triptilion berteroi	CHL(LBO, MAU, BIO, RME)
Triptilion capillatum	ARG(MEN) / CHL(COQ, VAL, LBO, RME)
Triptilion cordifolium	CHL(COQ, VAL, LBO, RME)
Triptilion gibbosum	CHL(ATA, COQ)
Triptilion spinosum	CHL(ANT, COQ, VAL, LBO, MAU, BIO, ARA, LLA, RME)
Trisetum ambiguum	ARG(SCR, TDF) / CHL(MAG)
Trisetum barbinode var. barbinode	ARG(MEN, NEU, RNE) / CHL(MAU, BIO, ARA)
Trisetum barbinode var. sclerophyllum	ARG(CHU, MEN, NEU, RNE)
Trisetum bulbosum	ARG(BAI) / CHL(BIO)
Trisetum caudulatum	ARG(CHU, NEU, RNE) / CHL(ANT, COQ, VAL, LBO, MAU, BIO, ARA, LLA, AIS, MAG, RME, JFE)
Trisetum cernuum	ARG(CHU, NEU, RNE, TDF) / CHL(ARA, LLA, AIS, MAG)
Trisetum flavescens	ARG(NEU, RNE) / CHL(MAG)
Trisetum johnstonii	ARG(MEN, NEU, SJU) / CHL(ATA, COQ, RME)
Trisetum juergensii	BRA(RGS, SCA)
Trisetum longiglume var. longiglume	ARG(CHU, MEN, NEU) / CHL(RME)
Trisetum longiglume var. glabratum	ARG(CHU, NEU)
Trisetum mattheii	CHL(TAR)
Trisetum nancaguense	CHL(LBO, MAU, BIO, RME)
Trisetum preslei	ARG(CHU, MEN, NEU, RNE, SJU) / CHL(COQ, VAL, BIO, ARA, LLA, MAG, RME)
Trisetum pyramidatum	ARG(RNE) / CHL(AIS, MAG)
Trisetum spicatum ssp. spicatum	ARG(CHU, COR, NEU, RNE, SCR, TDF) / CHL(ANT, VAL, MAU, BIO, ARA, LLA, AIS, MAG, RME)
Trisetum spicatum ssp. phleoides	ARG(SCR, TDF) / CHL(AIS, MAG)
Trisetum spicatum ssp. cumingii	ARG(CHU, NEU, RNE, SCR, TDF) / CHL(VAL, BIO, LLA, MAG, RME)
Trisetum spicatum ssp. dianthemum	ARG(CHU) / CHL(LLA)
Tristachya leiostachya	BRA(Fuera del área del proyecto) / PRY(AMA)
Tristagma ameghinoi	ARG(CHU, MEN, NEU, SCR) / CHL(MAU, AIS)
Tristagma anemophilum	ARG(MEN, NEU)
Tristagma berteroi	
Tristagma bivalve	CHL(COQ, VAL, LBO, MAU, BIO, ARA, RME)
Tristagma circinatum	ARG(MEN, NEU) / CHL(LBO)
Tristagma gracile	CHL(BIO)
Tristagma graminifolium	CHL(VAL, RME)
Tristagma leichtlinii	CHL(RME)
Tristagma lineatum	CHL(RME)
Tristagma nivale f. australe	ARG(CHU, SCR) / CHL(MAG)
Tristagma nivale f. nivale	ARG(CHU, NEU, RNE, SCR, TDF) / CHL(COQ, LBO, BIO, ARA, MAG, RME)
Tristagma patagonicum	ARG(CHU, MEN, NEU, RNE, SCR) / CHL(AIS)
Tristagma peregrinans	URY(RIV)
Tristagma poeppigianum	CHL(RME)
Tristagma porrifolia	CHL(VAL, BIO)
Tristagma staminosum	CHL(LBO, MAU)
Tristagma subbiflorum	CHL(VAL)
Tristagma violaceum	CHL(BIO)
Tristerix aphyllus	CHL(ATA, COQ, VAL, LBO, RME)
Tristerix corymbosus	ARG(NEU, RNE) / CHL(ATA, COQ, VAL, LBO, MAU, BIO, ARA, LLA, RME, JFE)
Tristerix verticillatus	ARG(CAT, JUJ, LRI, MEN, SAL, SJU, TUC) / CHL(ATA, COQ, VAL, LBO, MAU, BIO, LLA, RME)
Tristicha trifaria	ARG(COS, ERI, MIS) / BRA(PAR, RGS, SCA) / PRY(APA, AMA, CON, ITA) / URY(RNO, SAO)
Trithrinax brasiliensis var. brasiliensis	BRA(PAR, RGS, SCA) / PRY(APA)
Trithrinax brasiliensis var. acanthocoma	BRA(PAR, RGS) / PRY(APA)
Trithrinax campestris	ARG(CHA, COR, COS, ERI, SLU, SFE, SDE, TUC) / URY(PAY, RNO, SJO, SJO)
Trithrinax schizophylla var. schizophylla	ARG(JUJ, SAL)
Trithrinax schizophylla var. biflabellata	ARG(CHA, FOR) / PRY(APA, PHA)
Trithrinax schyzophylla	ARG(CAT, CHA, FOR, JUJ, SAL) / BRA(Fuera del área del proyecto) / PRY(APY, CON, PHA)
Triumfetta bogotensis	ARG(COS, JUJ, MIS, SAL) / BRA(PAR, RGS) / PRY(CAU, CEN, GUA)
Triumfetta guaranitica	ARG(MIS) / BRA(PAR, RGS, SCA) / PRY(GUA)
Triumfetta obscura	ARG(MIS) / BRA(PAR, RGS)
Triumfetta rhomboidea	BRA(PAR, RGS, SCA) / PRY(AMA, SPE)
Triumfetta semitriloba	ARG(BAI, CHA, COS, FOR, JUJ, MIS, SAL) / BRA(PAR, RGS, SCA) / PRY(APA, AMA, CAU, CAA, CAN, CEN, CON, COA, GUA, ITA, MIE, ÑEE, PAI)
Trixis cacalioides	ARG(CAT, CHA, COR, COS, JUJ, LPA, LRI, MEN, RNE, SAL, SJU, SLU, SDE, TUC) / CHL(TAR, ANT, ATA) / PRY(APY)
Trixis divaricata ssp. discolor	ARG(CAT, CHA, COR, ERI, FOR, LRI, SJU, SLU, SFE, SDE) / PRY(APY, CEN, CON, COA, PAI)
Trixis divaricata ssp. divaricata	ARG(CHA, COR, COS, FOR, JUJ, MEN, MIS, SAL, SFE, TUC) / BRA(PAR) / PRY(APY, AMA, CAU, CEN, CON, COA, GUA, ITA, PAI, PHA) / URY(RNO)
Trixis glaziovii	BRA(PAR)
Trixis grisebachii	ARG(CAT, JUJ, LRI, SAL, SDE, TUC)
Trixis hassleri	PRY(AMA)
Trixis lessingii	BRA(PAR, RGS, SCA) / PRY(AMA, CAU, CAN, COA, PAI) / URY(CLA, RIV, TAC, TYT)
Trixis nobilis	ARG(BAI, COS, ERI, MIS, SFE) / BRA(PAR, RGS, SCA) / PRY(APA, AMA, CON, COA, GUA, ITA, MIE, PAI, SPE) / URY(CLA, COL, FLA, LAV, MAL, MON, PAY, RIV, ROC, SJO, SOR, TAC)
Trixis ophiorhiza ssp. ophiorhiza	BRA(Fuera del área del proyecto) / PRY(APY)
Trixis ophiorhiza ssp. glandulifera	PRY(AMA)
Trixis pallida	ARG(CHA, COS, ERI, FOR, MIS) / BRA(RGS) / PRY(APY, AMA, CAU, CAA, CAN, CEN, CON, COA, PAI, PHA, SPE) / URY(ART, RNO, RIV, SAO, SOR)
Trixis praestans	ARG(BAI, CHA, COS, ERI, MIS, SFE) / BRA(RGS, SCA) / PRY(APA, COA) / URY(COL, MAL, MON, PAY, RNO, RIV, ROC, SAO, TYT)
Trixis proustioides	ARG(JUJ, SAL)
Trixis spicata	BRA(Fuera del área del proyecto) / PRY(AMA)
Trixis thyrsoidea	BRA(PAR, RGS, SCA)
Trizeuxis falcata	BRA(PAR, SCA)
Tropaeolum argentinum	ARG(CAT, JUJ, SAL, TUC)
Tropaeolum atrocapillare	ARG(SAL)
Tropaeolum austropurpureum	CHL(COQ)
Tropaeolum azureum	CHL(ANT, ATA, COQ, VAL, RME)
Tropaeolum beuthii	CHL(TAR, ANT)
Tropaeolum brachyceras	CHL(COQ, VAL, LBO, MAU, RME)
Tropaeolum capillare	ARG(CAT, JUJ, MIS, SAL, TUC)
Tropaeolum ciliatum ssp. septentrionale	CHL(VAL, LBO, MAU, RME)
Tropaeolum ciliatum ssp. ciliatum	CHL(VAL, MAU, BIO, ARA, RME)
Tropaeolum hookerianum ssp. hookerianum	CHL(COQ)
Tropaeolum hookerianum ssp. pilosum	CHL(COQ)
Tropaeolum incisum	ARG(CHU, MEN, NEU, RNE) / CHL(LBO, MAU, BIO, ARA, LLA)
Tropaeolum jilesii	CHL(COQ, VAL)
Tropaeolum kingii	CHL(ATA, COQ)
Tropaeolum leptophyllum ssp. leptophyllum	ARG(MEN, NEU) / CHL(VAL, LBO, MAU, BIO, ARA, RME)
Tropaeolum leptophyllum ssp. gracile	CHL(MAU, BIO, ARA)
Tropaeolum looseri	CHL(COQ)
Tropaeolum majus	ARG(SFE) / BRA(PAR, RGS, SCA) / CHL(VAL, RME, JFE) / URY(CAS, MON)
Tropaeolum meyeri	ARG(CAT, TUC)
Tropaeolum myriophyllum	CHL(MAU, BIO)
Tropaeolum nubigenum	CHL(RME)
Tropaeolum nuptae-jucundae	CHL(MAU, BIO, ARA)
Tropaeolum patagonicum	ARG(CHU, SCR, TDF)
Tropaeolum pentaphyllum ssp. pentaphyllum	ARG(BAI, CHA, COR, COS, ERI, FOR, MIS, SFE) / BRA(PAR, RGS, SCA) / PRY(APA, CEN, COA, GUA, ITA, PAI) / URY(COL, MAL, MON, ROC, SJO)
Tropaeolum pentaphyllum ssp. megapetaloides	BRA(PAR, SCA)
Tropaeolum polyphyllum	ARG(MEN, SJU) / CHL(COQ, VAL, LBO, MAU, RME)
Tropaeolum porifolium	ARG(CHU, MEN, NEU, SCR) / CHL(AIS)
Tropaeolum rhomboideum	CHL(RME)
Tropaeolum sanctae-catharinae	BRA(SCA)
Tropaeolum sessilifolium	CHL(COQ, VAL, LBO, RME)
Tropaeolum slanisii	ARG(SAL)
Tropaeolum speciosum	CHL(BIO, ARA, LLA, AIS)
Tropaeolum trialatum	ARG(CHU, LPA, NEU, RNE)
Tropaeolum tricolor	CHL(ANT, ATA, COQ, VAL, LBO, MAU, BIO, ARA, LLA, RME)
Tropaeolum tuberosum ssp. silvestre	ARG(CAT, JUJ)
Tropaeolum warmingianum	ARG(MIS) / BRA(PAR) / PRY(APA)
Tropaeolum willinkii	ARG(JUJ, SAL)
Tropidocarpum lanatum	CHL(COQ, VAL, RME)
Tropidococcus pinnatipartitus	BRA(RGS)
Tunilla chilensis	CHL(TAR)
Tunilla corrugata	ARG(CAT, LRI, MEN, SAL, SJU)
Tunilla tilcarensis	ARG(JUJ)
Turnera aurelii	ARG(FOR) / PRY(CEN, COA, PHA)
Turnera blanchetiana var. subspicata	BRA(Fuera del área del proyecto) / PRY(APY)
Turnera capitata	BRA(SCA)
Turnera concinna	BRA(Fuera del área del proyecto) / PRY(CON, SPE)
Turnera dolichostigma	BRA(Fuera del área del proyecto) / PRY(AMA, CON)
Turnera fernandezii	BRA(Fuera del área del proyecto) / PRY(AMA, CON)
Turnera grandidentata	PRY(CAU, CEN, CON, COA, MIE, PAI, SPE)
Turnera grandiflora	ARG(CHA, COS, FOR, SAL, SFE) / BRA(Fuera del área del proyecto) / PRY(APY, AMA, CAU, CAN, CEN, CON, COA, GUA, ITA, MIE, ÑEE, PAI, PHA, SPE)
Turnera hassleriana	ARG(MIS, SAL) / BRA(Fuera del área del proyecto) / PRY(AMA, CEN, CON, COA, GUA, MIE, PAI, PHA, SPE)
Turnera hilaireana	BRA(PAR)
Turnera krapovickasii	ARG(JUJ, SAL, TUC) / PRY(APY, PHA)
Turnera melochioides	BRA(Fuera del área del proyecto) / PRY(AMA)
Turnera nervosa	ARG(COS, MIS) / PRY(CAU, CAA, CON, GUA, ITA, MIE, PAI, PHA, SPE)
Turnera oblongifolia	BRA(PAR, SCA)
Turnera orientalis	ARG(CHA, COS, FOR, MIS) / BRA(PAR) / PRY(APA, CAU, CAN, CON, ITA, MIE, ÑEE, PHA, SPE)
Turnera pumilea	ARG(COS) / BRA(Fuera del área del proyecto) / PRY(APY, CEN, CHO, CON, COA, NAS, PHA)
Turnera serrata var. brevifolia	BRA(PAR)
Turnera sidoides ssp. pinnatifida	ARG(BAI, CAT, CHA, COR, COS, ERI, FOR, JUJ, LPA, LRI, RNE, SAL, SLU, SFE, SDE, TUC) / PRY(APY) / URY(ART, CAS, COL, DUR, FLA, MON, PAY, RNO, SAO, SJO, SOR)
Turnera sidoides ssp. carnea	ARG(COS, MIS) / BRA(RGS) / PRY(GUA, ITA, MIE) / URY(ART, CLA, CLA, FLO, FLA, MON, PAY, RIV, SAO, SJO, SJO, TAC)
Turnera sidoides ssp. integrifolia	ARG(COS, ERI) / BRA(RGS) / PRY(APA, MIE) / URY(ART, DUR, FLA, PAY, RNO, RIV, SAO, SOR, TAC)
Turnera sidoides ssp. sidoides	BRA(RGS) / URY(CAS, FLA, LAV, MAL, MON, TAC)
Turnera sidoides ssp. holosericea	BRA(RGS) / URY(ART, CLA, FLA, PAY, RIV, TAC, TYT)
Turnera weddelliana	ARG(MIS, SAL) / BRA(Fuera del área del proyecto) / PRY(APY, AMA, CEN, CON, COA, MIE, ÑEE, PAI, PHA)
Tweedia andina	CHL(VAL, LBO, MAU, BIO, ARA, RME)
Tweedia aucaensis	ARG(MEN, NEU)
Tweedia birostrata	CHL(ANT, ATA, COQ, VAL, LBO, MAU, BIO, RME)
Tweedia brunonis	ARG(BAI, CAT, COR, COS, ERI, FOR, LPA, LRI, MEN, NEU, RNE, SAL, SJU, SLU, SFE, SDE, TUC) / PRY(APY)
Tweedia echegarayi	ARG(MEN, SJU)
Tweedia stipitata	CHL(COQ, VAL, RME)
Tynanthus cognatus	BRA(PAR, RGS, SCA)
Tynanthus elegans	BRA(PAR, RGS, SCA)
Tynanthus labiatus	BRA(RGS, SCA)
Tynanthus micranthus	ARG(MIS) / BRA(PAR) / PRY(APA, CAN)
Typha angustifolia	ARG(CHA, RNE) / CHL(TAR, VAL, MAU, ARA)
Typha domingensis	ARG(BAI, CHA, COR, COS, ERI, FOR, JUJ, LPA, LRI, MEN, RNE, SAL, SFE, SJU, SLU, TUC) / BRA(SCA) / CHL(TAR, ANT) / PRY(APY, AMA, BOQ, CEN, CHO, CON, COA, ÑEE, PAI, PHA) / URY(CLA, COL, MON, ROC, SJO)
Typha latifolia	ARG(BAI, COS, ERI, LPA, MIS, SFE, SJU) / BRA(Fuera del área del proyecto) / PRY(APA, AMA, CON, PHA)
Typha subulata	ARG(BAI, CHU, COR, COS, ERI, JUJ, LPA, MEN, RNE, SJU, SLU) / URY(MON, ROC)
