Vaccaria pyramidata	ARG(BAI, COR, ERI, NEU, RNE, SCR, SFE, TUC) / URY(PAY)
Vaccinium floribundum	ARG(SAL)
Vachellia albicorticata 	ARG(JUJ, SAL, TUC)
Vachellia aroma	ARG(CAT, CHA, COR, COS, FOR, JUJ, LRI, MIS, SAL, SJU, SLU, SFE, SDE, TUC) / PRY(APY, BOQ, NAS, PHA)
Vachellia astringens	ARG(BAI, CHA, COR, COS, ERI, FOR, JUJ, MEN, SAL, SJU, SLU, SFE, SDE, TUC) / URY(PAY)
Vachellia caven	ARG(BAI, CAT, CHA, COR, COS, ERI, FOR, JUJ, LPA, LRI, MEN, MIS, SAL, SJU, SLU, SFE, SDE, TUC) / BRA(RGS) / CHL(ATA, COQ, VAL, LBO, MAU, BIO, ARA, LLA, RME) / PRY(APY, BOQ, CAU, CAN, CEN, CON, COA, GUA, ÑEE, PAI, PHA, SPE) / URY(ART, CAS, COL, CLA, FLA, MON, PAY, RNO, ROC, SAO, SJO, SJO, TAC)
Vachellia curvifructa 	ARG(CHA, FOR, SAL, SDE) / PRY(APY, BOQ, PHA)
Vachellia farnesiana	ARG(CHA, COR, FOR, MIS) / BRA(RGS) / PRY(AMA, CAN, PAI, PHA) / URY(CAS, MON, SAO)
Vachellia ibirocayensis	BRA(RGS)
Vahlodea atropurpurea	ARG(CHU, MEN, NEU, RNE, SCR, TDF) / CHL(LLA, AIS, MAG, RME)
Valdivia gayana	CHL(LLA)
Valeriana aequiloba	CHL(COQ)
Valeriana atacamensis	CHL(ANT, ATA, COQ)
Valeriana boelckei	ARG(NEU) / CHL(ARA)
Valeriana bornmuelleri	BRA(RGS)
Valeriana borsinii	ARG(NEU)
Valeriana bracteosa	CHL(VAL, LBO, BIO, RME)
Valeriana bridgesii	CHL(COQ, VAL, LBO, RME)
Valeriana calvescens	ARG(JUJ, SAL)
Valeriana carnosa	ARG(CHU, MEN, NEU, RNE, SCR, TDF) / CHL(LBO, MAU, BIO, ARA, LLA, AIS, MAG)
Valeriana castellanosii	ARG(CAT, JUJ, SAL) / CHL(ANT)
Valeriana catharinensis	BRA(RGS, SCA)
Valeriana chamaedryfolia	BRA(RGS)
Valeriana chilensis	ARG(CHU, NEU) / CHL(MAU)
Valeriana clarionifolia	ARG(CHU, MEN, NEU, RNE, SCR) / CHL(MAU)
Valeriana clematitis	ARG(JUJ, SAL)
Valeriana condamoana	ARG(JUJ)
Valeriana corymbulosa	ARG(JUJ, SAL)
Valeriana corynodes	ARG(SJU)
Valeriana crispa	ARG(NEU) / CHL(COQ, VAL, LBO, MAU, BIO, ARA, RME)
Valeriana descolei	ARG(MEN, SJU)
Valeriana dinorrhiza	ARG(CAT, LRI, MEN, SAL, SJU, TUC)
Valeriana effusa	ARG(CAT, COR, JUJ, LRI, SAL, TUC)
Valeriana eichleriana	BRA(PAR, RGS, SCA)
Valeriana eupatoria	BRA(RGS)
Valeriana ferax	ARG(COR)
Valeriana fonckii	ARG(CHU, NEU, RNE, SCR) / CHL(MAU, BIO, ARA, LLA, AIS)
Valeriana fragilis	CHL(ANT, ATA, COQ)
Valeriana gaimanensis	ARG(CHU)
Valeriana gilgiana	BRA(PAR, SCA)
Valeriana glechomifolia	BRA(RGS, SCA)
Valeriana graciliceps	CHL(COQ, VAL, LBO, MAU, RME)
Valeriana grandifolia	CHL(VAL, MAU, BIO, ARA, RME)
Valeriana hebecarpa	ARG(NEU) / CHL(BIO, ARA)
Valeriana hornschuchiana	ARG(MEN) / CHL(VAL, LBO, MAU, RME)
Valeriana humahuacensis	ARG(JUJ)
Valeriana hunzikeri	ARG(LRI)
Valeriana hyalinorrhiza	CHL(VAL, LBO, MAU, BIO, RME)
Valeriana interrupta	CHL(TAR)
Valeriana kurtziana	ARG(MIS) / BRA(RGS)
Valeriana lapathifolia	ARG(CHU, NEU, RNE, SCR) / CHL(ARA, LLA, AIS, MAG)
Valeriana lasiocarpa	ARG(CAT, TUC)
Valeriana laxiflora	ARG(CHU, NEU, RNE, SCR) / CHL(VAL, LBO, BIO, ARA, LLA, AIS, RME)
Valeriana lepidota	CHL(VAL, LBO, RME)
Valeriana leucocarpa	ARG(CHU, NEU, RNE) / CHL(LBO, MAU, BIO, ARA, MAG)
Valeriana macrorhiza	ARG(CHU, MEN, NEU, RNE, SCR) / CHL(LBO, MAU, BIO, ARA, LLA)
Valeriana moyanoi	ARG(CHU, NEU, RNE, SCR) / CHL(AIS)
Valeriana muelleri	BRA(PAR, RGS, SCA)
Valeriana munozii	ARG(MEN)
Valeriana nivalis	ARG(JUJ, SAL) / CHL(TAR, ANT, ATA)
Valeriana obtusifolia	CHL(VAL, BIO, ARA, LLA)
Valeriana papilla	CHL(COQ, VAL, LBO, RME)
Valeriana peltata	CHL(ATA, COQ, VAL)
Valeriana petersenii	CHL(TAR)
Valeriana philippiana	ARG(CHU, NEU, RNE) / CHL(BIO, LLA, AIS, MAG)
Valeriana polemoniifolia	ARG(CHU, NEU, RNE) / CHL(MAU, BIO, ARA, LLA)
Valeriana polybotrya	ARG(CAT, JUJ, SAL, TUC)
Valeriana polystachya	ARG(BAI, DFE, RNE, SFE, TUC) / BRA(RGS) / URY(CAS, CLA, COL, DUR, FLA, MON, RIV, SJO)
Valeriana pycnantha	ARG(CAT, JUJ, LRI, SAL, TUC) / CHL(TAR, ANT)
Valeriana pyricarpa	ARG(JUJ, SAL, TUC)
Valeriana radicalis	CHL(RME)
Valeriana reitziana	BRA(PAR, RGS, SCA)
Valeriana ruizlealii	ARG(LRI, MEN, SAL, SJU)
Valeriana salicariifolia	ARG(BAI) / BRA(PAR, RGS, SCA) / PRY(CAU) / URY(CLA, RNO, RIV, SJO)
Valeriana samolifolia	ARG(CHU) / CHL(VAL, LBO, MAU, BIO, ARA, RME)
Valeriana scandens var. scandens	ARG(BAI, ERI, JUJ, MIS, SAL) / BRA(PAR, RGS, SCA) / PRY(APA, AMA, CON) / URY(COL)
Valeriana scandens var. candolleana	BRA(SCA) / PRY(APA)
Valeriana sedifolia	ARG(SCR, TDF) / CHL(MAG)
Valeriana senecioides	CHL(ATA)
Valeriana serratifolia	ARG(SAL)
Valeriana sphaerocarpa	CHL(VAL)
Valeriana stricta	ARG(MEN) / CHL(ATA, COQ, VAL, LBO, MAU, RME)
Valeriana stuckertii	ARG(COR, SLU)
Valeriana tafiensis	ARG(JUJ, SAL, TUC)
Valeriana tajuvensis	BRA(RGS, SCA)
Valeriana tucumana	ARG(CAT, JUJ, SAL, TUC)
Valeriana tunuyanense	ARG(MEN)
Valeriana ulei	BRA(PAR, RGS, SCA)
Valeriana urbanii	ARG(CAT, JUJ, SAL, TUC) / CHL(TAR, ANT)
Valeriana vaga	CHL(ATA, COQ, VAL, RME)
Valeriana valdiviana	CHL(VAL, MAU, BIO, ARA, LLA)
Valeriana velutina	CHL(COQ, VAL)
Valeriana verticillata	CHL(VAL, LBO, RME)
Valeriana virescens	ARG(CHU, NEU, RNE, SCR) / CHL(MAU, BIO, ARA, LLA, AIS)
Valerianella eriocarpa	CHL(BIO, ARA)
Valerianella locusta	ARG(BAI, CHU, DFE, NEU, TDF) / CHL(LBO, MAU, BIO, ARA, LLA)
Valerianella rimosa	CHL(ARA)
Valerianella vesicaria	ARG(BAI)
Vallea stipularis	ARG(JUJ, SAL)
Vallesia glabra	ARG(CAT, CHA, COR, FOR, JUJ, LRI, SAL, SDE, SJU, TUC) / PRY(APY, PHA)
Vandenboschia radicans	ARG(MIS) / BRA(PAR, RGS, SCA) / PRY(CAN, COA, PAI)
Vanilla angustipetala	ARG(COS, MIS) / BRA(PAR) / PRY(APA, SPE)
Vanilla bertoniensis	PRY(APA)
Vanilla chamissonis var. longifolia	BRA(PAR, SCA)
Vanilla edwallii	ARG(MIS) / BRA(PAR, RGS, SCA)
Vanilla organensis	BRA(PAR) / PRY(APY)
Vanilla palmarum	BRA(PAR)
Vanilla parvifolia	BRA(PAR) / PRY(APA, GUA)
Vanilla vellozii	ARG(CHA, FOR, MIS) / BRA(PAR, RGS, SCA) / PRY(SPE)
Vanilla verrucosa	ARG(MIS) / BRA(RGS)
Vantanea compacta	BRA(PAR, SCA)
Varronia axillaris	ARG(MIS) / BRA(RGS)
Varronia curassavica	ARG(CAT, COS, FOR, JUJ, LRI, MIS, SAL, TUC) / BRA(PAR, RGS, SCA) / PRY(APY, MIE) / URY(MAL, ROC)
Varronia dichotoma	ARG(BAI, CHA, COS, ERI, FOR, JUJ, MIS, SAL, TUC) / BRA(RGS) / PRY(CAN, COA, GUA, PAI, SPE) / URY(COL, RNO, SJO, TAC)
Varronia guaranitica	ARG(COS, SAL) / PRY(CAA, COA, PAI)
Varronia paucidentata	ARG(COS, MIS) / BRA(PAR, RGS) / PRY(APA, CAU, MIE) / URY(ART, SAO)
Varronia polycephala	ARG(FOR) / BRA(RGS) / PRY(CAA, COA, PAI)
Varronia villicaulis	BRA(PAR) / PRY(APA, CAU, COA)
Vassobia breviflora	ARG(BAI, CAT, CHA, COR, COS, DFE, ERI, FOR, JUJ, LRI, MIS, SAL, SDE, SFE, SLU, TUC) / BRA(PAR, RGS, SCA) / PRY(APA, AMA, CAU, CAA, CAN, CEN, COA, GUA, ITA, MIE, ÑEE, PAI, SPE) / URY(PAY, SAO)
Velloziella westermanii	BRA(PAR, SCA)
Verbascum densiflorum	CHL(ARA)
Verbascum thapsus	ARG(BAI, CHU, ERI, MEN, MIS, NEU, RNE, SCR, SJU, SLU) / CHL(MAU, ARA)
Verbascum virgatum	ARG(BAI, CAT, CHU, COR, COS, DFE, ERI, JUJ, LPA, MEN, MIS, NEU, RNE, SAL, SJU, SLU, SFE, SDE, TUC) / BRA(PAR, RGS, SCA) / CHL(COQ, VAL, LBO, MAU, BIO, ARA, LLA, RME, JFE, IPA) / PRY(CAA) / URY(CAS, CLA, COL, FLA, LAV, MON, RNO, RIV, SAO, SOR, TAC)
Verbena alata	BRA(PAR, RGS, SCA)
Verbena bonariensis var. bonariensis	ARG(BAI, CAT, CHA, COR, COS, ERI, FOR, JUJ, LPA, LRI, MEN, MIS, NEU, RNE, SAL, SJU, SLU, SFE, SDE, TUC) / BRA(PAR, RGS, SCA) / CHL(ANT, VAL, MAU, BIO, LLA, RME) / PRY(APA, APY, CAA, CEN, GUA, ITA, MIE, ÑEE, PAI, PHA, SPE) / URY(COL, FLA, MON)
Verbena bonariensis var. conglomerata	ARG(BAI, COS, ERI, MIS, SFE) / BRA(RGS) / PRY(CAA, GUA, SPE) / URY(PAY, ROC, SAO, SJO)
Verbena caniuensis	BRA(PAR)
Verbena cuneifolia	CHL(RME)
Verbena ephedroides	ARG(COS, ERI, MIS, SFE) / BRA(PAR, RGS, SCA) / PRY(ÑEE)
Verbena filicaulis	ARG(MIS) / BRA(PAR, RGS, SCA)
Verbena gracilescens var. gracilescens	ARG(BAI, CAT, CHA, COR, COS, ERI, FOR, JUJ, LPA, LRI, MEN, RNE, SAL, SDE, SFE, SJU, SLU, TUC) / PRY(APY, CON, PAI, PHA) / URY(ART, CLA, FLA, PAY, SJO, TAC)
Verbena gracilescens var. swiftiana	ARG(MIS) / BRA(RGS)
Verbena hirta var. hirta	ARG(MIS) / BRA(PAR, RGS, SCA)
Verbena hirta var. gracilis	BRA(PAR, RGS, SCA)
Verbena hispida var. hispida	ARG(CAT, CHA, COR, COS, FOR, JUJ, LRI, MEN, MIS, SAL, SJU, SLU, SFE, SDE, TUC) / CHL(TAR, VAL) / PRY(APY)
Verbena hispida var. obovata	ARG(JUJ, SAL, TUC)
Verbena intercedens	ARG(COS) / BRA(RGS) / PRY(GUA, PAI)
Verbena intermedia	ARG(BAI, CHA, COR, COS, ERI, FOR, LPA, LRI, MEN, MIS, SAL, SDE, SFE, SJU, SLU) / BRA(RGS, SCA) / PRY(MIE) / URY(CAS, CLA, COL, FLA, LAV, MON, RNO, TAC)
Verbena lindbergii	ARG(MIS) / BRA(PAR, RGS, SCA)
Verbena litoralis var. litoralis	ARG(BAI, CAT, CHA, COR, COS, ERI, FOR, JUJ, LPA, LRI, MEN, MIS, NEU, RNE, SAL, SDE, SFE, SJU, SLU, TUC) / BRA(PAR, RGS, SCA) / CHL(COQ, VAL, LBO) / PRY(APA, AMA, CAU, CAA, CAN, CEN, CON, COA, GUA, ITA, MIE, ÑEE, PAI, SPE) / URY(PAY, SAO)
Verbena litoralis var. subglabrata	ARG(BAI, CHA, COR, COS, ERI, JUJ, LPA, LRI, MEN, NEU, RNE, SAL, SJU, SLU, SFE, SDE)
Verbena montevidensis	ARG(BAI, COR, COS, ERI, MIS, SLU, SFE) / BRA(PAR, RGS, SCA) / PRY(APY, CAU, CAA, CEN, COA, GUA, ITA, MIE, PAI, PHA) / URY(CAS, CLA, FLA, MON, PAY, SAO)
Verbena ovata	ARG(COS, MIS) / BRA(PAR, RGS, SCA) / PRY(APA, AMA, CAA, ITA, PAI, SPE)
Verbena rectiloba	BRA(RGS)
Verbena rigida var. rigida	ARG(BAI, CHA, COR, COS, ERI, FOR, JUJ, MIS, SFE, TUC) / BRA(PAR, RGS, SCA) / PRY(APA, CAU, CAA, COA, GUA, MIE, PAI) / URY(CAS, LAV, MAL, SJO, TAC)
Verbena sagittalis	ARG(MIS) / BRA(PAR, RGS, SCA)
Verbesina aurita	ARG(CAT, SAL, TUC) / CHL(ANT, ATA)
Verbesina caleaefolia	PRY(AMA)
Verbesina encelioides	ARG(BAI, CAT, CHA, COR, COS, ERI, FOR, JUJ, LPA, LRI, MEN, NEU, RNE, SAL, SJU, SLU, SFE, SDE, TUC) / CHL(ANT, ATA) / PRY(APY) / URY(PAY, RNO, SJO, SOR)
Verbesina glabrata	BRA(PAR, RGS, SCA)
Verbesina guaranitica	PRY(CAN)
Verbesina lilloi	ARG(CAT, JUJ, SAL, TUC)
Verbesina macrophylla var. nelidae	ARG(JUJ, SAL, TUC)
Verbesina rugosa	PRY(CAN)
Verbesina saubinetia	CHL(COQ)
Verbesina sordescens var. sordescens	ARG(COS) / BRA(PAR, RGS, SCA) / PRY(AMA, CAU, CAA, CAN, CEN, COA, MIE, PAI, PHA)
Verbesina sordescens var. glabrata	PRY(Desconocida)
Verbesina subcordata	ARG(BAI, CHA, COS, ERI, FOR, MIS, SFE) / BRA(RGS) / PRY(AMA, CAA, CAN, CEN, CON, COA, ITA, PAI) / URY(ART, CLA, COL, MAL, MON, PAY, RNO, RIV, SAO, SOR, TAC, TYT)
Verbesina subdiscoidea	PRY(AMA)
Verbesina suncho	ARG(CAT, JUJ, SAL, TUC)
Vernicia fordii	ARG(MIS)
Vernonanthura amplexicaulis	ARG(JUJ, SAL) / PRY(AMA)
Vernonanthura brasiliana	ARG(FOR, SAL) / BRA(Fuera del área del proyecto) / PRY(APY, AMA, CEN, CON, COA, SPE)
Vernonanthura chamaedrys	ARG(CHA, COS, ERI, FOR, MIS, SFE, SDE) / BRA(PAR, RGS, SCA) / PRY(AMA, CAU, CEN, CON, COA, GUA, MIE, ÑEE, PAI, PHA, SPE)
Vernonanthura chaquensis	ARG(CHA, COS, FOR, MIS) / PRY(APA, CAU, CAA, GUA)
Vernonanthura cupularis	ARG(COS, MIS) / PRY(CAN, CON, COA, PAI)
Vernonanthura densiflora	BRA(PAR) / PRY(AMA, CAU, ITA)
Vernonanthura hilariana	BRA(PAR)
Vernonanthura lipeoensis	ARG(JUJ, SAL)
Vernonanthura loretensis	ARG(COS, MIS) / PRY(APA, CEN, COA, GUA, PAI, PHA)
Vernonanthura lucida	ARG(COS, MIS) / BRA(PAR, RGS, SCA) / PRY(APA, AMA, CAU, CAA, CAN, ITA, PHA, SPE)
Vernonanthura montevidensis	ARG(BAI, CHA, COS, ERI, FOR, MIS, SFE) / BRA(PAR, RGS, SCA) / PRY(APA, APY, AMA, CAU, CEN, CON, COA, ITA, MIE, SPE) / URY(ART, COL, MAL, MON, PAY, RNO, SAO, SJO, TAC)
Vernonanthura nudiflora f. nudiflora	ARG(BAI, COR, COS, ERI, LPA, SJU, SLU, TUC) / BRA(PAR, RGS, SCA) / URY(ART, COL, FLA, RNO, RIV, SAO, SJO, TAC)
Vernonanthura nudiflora f. albiflora	BRA(RGS)
Vernonanthura oligactoides	ARG(MIS) / BRA(PAR, SCA) / PRY(APA, AMA, CAN, SPE)
Vernonanthura perangusta	BRA(PAR)
Vernonanthura petiolaris	ARG(MIS) / BRA(PAR, RGS, SCA) / PRY(APA, CAN)
Vernonanthura pinguis	ARG(JUJ, SAL) / PRY(AMA)
Vernonanthura polyanthes	BRA(PAR, SCA)
Vernonanthura pseudolinearifolia	BRA(RGS) / URY(CLA, PAY, RIV, TAC, TYT)
Vernonanthura schulziana	ARG(CHA) / BRA(RGS)
Vernonanthura squamulosa	ARG(CAT, JUJ, LRI, SAL, TUC) / PRY(COA)
Vernonanthura tweedieana	ARG(COS, FOR, MIS) / BRA(PAR, RGS, SCA) / PRY(APA, APY, AMA, CAU, CEN, COA, GUA, ITA, MIE, PAI, PHA, SPE)
Vernonia amambaia	BRA(Fuera del área del proyecto) / PRY(AMA, CAU, CEN)
Vernonia apiculata	PRY(APY)
Vernonia arachniolepis	BRA(PAR)
Vernonia argentea	BRA(PAR) / PRY(APA, AMA, CAN)
Vernonia asteriflora	BRA(PAR) / PRY(AMA, CAU, GUA)
Vernonia bardanoides	BRA(PAR) / PRY(AMA, SPE)
Vernonia bellula	PRY(CAN)
Vernonia beyrichii	BRA(PAR)
Vernonia brunneri	PRY(CON)
Vernonia catharinensis	BRA(RGS, SCA)
Vernonia cichoriiflora	PRY(CAN, SPE)
Vernonia constricta	BRA(RGS)
Vernonia crassa	BRA(PAR)
Vernonia cuneifolia	BRA(PAR) / PRY(APA, AMA, CAU, CAA, CAN, CEN, COA, GUA, PAI, PHA, SPE)
Vernonia cupularis var. oligocephala	PRY(COA)
Vernonia decumbens	BRA(SCA)
Vernonia diffusa	BRA(PAR)
Vernonia discolor	BRA(PAR, RGS, SCA)
Vernonia echioides	ARG(BAI, CHA, COS, ERI, FOR, MIS, SFE) / BRA(PAR, RGS, SCA) / PRY(APY, APA, AMA, CAU, CEN, CON, GUA, ITA, PHA, SPE) / URY(DUR, FLO, MON, SJO, TAC)
Vernonia elsieae	BRA(PAR)
Vernonia eriolepis	BRA(PAR, SCA)
Vernonia exigua	BRA(PAR, SCA)
Vernonia ferruginea	BRA(Fuera del área del proyecto) / PRY(AMA)
Vernonia flexuosa var. ensifolia	BRA(RGS)
Vernonia florida	BRA(RGS, SCA) / PRY(APA, CAU, GUA)
Vernonia glabrata var. cuneifolia	PRY(AMA, CEN)
Vernonia glanduloso-dentata	BRA(RGS)
Vernonia grandiflora	BRA(PAR) / PRY(APA, AMA, CAN, CON, COA, SPE)
Vernonia hassleriana	PRY(AMA, CAN, ITA)
Vernonia hexantha var. balansae	PRY(CAA)
Vernonia hexantha var. eleagnoides	PRY(CAN)
Vernonia hexantha var. nivea	PRY(COA, MIE, PAI)
Vernonia hexantha var. paraguariensis	PRY(CAN)
Vernonia hypochaeris	BRA(PAR, RGS, SCA) / PRY(AMA, CAN)
Vernonia hystricosa	PRY(AMA, CEN, COA, ITA, PHA, SPE)
Vernonia hystrix	PRY(AMA, CAA, CAN, COA, MIE, PAI)
Vernonia incana	ARG(BAI, CAT, CHA, COR, COS, ERI, FOR, JUJ, MIS, SAL, SDE, SFE, SLU, TUC) / BRA(RGS) / PRY(APA, AMA, CEN, ÑEE, PAI, PHA) / URY(CLA, RNO)
Vernonia lanata	PRY(COA, GUA, PAI)
Vernonia laxa	BRA(PAR)
Vernonia leonensis	PRY(APY)
Vernonia macrocephala	BRA(RGS) / URY(CLA, MON, RIV, TAC)
Vernonia macrophylla	BRA(PAR)
Vernonia magnifica	BRA(RGS) / URY(Desconocida)
Vernonia mucronulata	BRA(PAR, SCA)
Vernonia oligolepis	BRA(PAR, SCA) / PRY(AMA, CAN, CEN, CON, COA, PAI, SPE)
Vernonia palustris	BRA(Fuera del área del proyecto) / PRY(APA, AMA, CEN)
Vernonia parvifolia	BRA(Fuera del área del proyecto) / PRY(CEN, COA, PAI)
Vernonia platyphylla	PRY(APA, AMA, CAN)
Vernonia profusa	PRY(AMA)
Vernonia psilophylla	BRA(PAR, RGS)
Vernonia puberula var. puberula	BRA(PAR, RGS, SCA)
Vernonia puberula var. serrulata	BRA(SCA) / PRY(CAN)
Vernonia quinqueflora	BRA(PAR, SCA)
Vernonia ramellae	PRY(PAI)
Vernonia reitziana	BRA(PAR, SCA)
Vernonia rojasii	PRY(APY, CEN)
Vernonia salzmannii	BRA(PAR) / PRY(APY)
Vernonia sessilifolia	BRA(PAR) / PRY(APA, AMA, CAN, CON)
Vernonia subpaludosa	BRA(PAR)
Vernonia ulei	BRA(SCA)
Vernonia valenzuelae	PRY(COA, PAI)
Vernonia varroniifolia	BRA(Fuera del área del proyecto) / PRY(AMA)
Vernonia viminea	BRA(PAR)
Vernonia viscidula	BRA(SCA)
Vernonia westermanii	BRA(PAR)
Vernonia westiniana	BRA(PAR, SCA)
Veronica anagallis-aquatica	ARG(BAI, CAT, CHU, COR, JUJ, LPA, LRI, MEN, NEU, RNE, SAL, SJU, SLU, TDF, TUC) / CHL(AYP, TAR, ATA, COQ, VAL, LBO, MAU, BIO, ARA, LLA, AIS, RME, JFE) / URY(CAS, MON)
Veronica arvensis	ARG(BAI, CHU, COR, COS, ERI, JUJ, LPA, MEN, MIS, NEU, RNE, SAL, SFE, TDF) / BRA(PAR, RGS, SCA) / CHL(ATA, VAL, LBO, BIO, ARA, LLA, MAG, RME, JFE) / URY(CAS, CLA, DUR, FLO, FLA, LAV, MON, PAY, SOR)
Veronica beccabunga	CHL(LLA)
Veronica chamaedrys	ARG(COS, MIS)
Veronica longifolia	ARG(LPA)
Veronica officinalis	CHL(ARA, LLA)
Veronica peregrina ssp. xalapensis	ARG(BAI, CAT, CHA, CHU, COR, COS, DFE, ERI, JUJ, LPA, LRI, MEN, MIS, NEU, RNE, SAL, SCR, SFE, TDF, TUC) / BRA(RGS, SCA) / CHL(COQ, LBO, MAU, BIO, ARA, LLA, AIS, MAG, RME) / URY(ART, CAS, CLA, DUR, FLO, FLA, LAV, MAL, MON, RNO, SJO, SOR, TAC)
Veronica persica	ARG(BAI, CAT, COR, COS, DFE, ERI, JUJ, LPA, LRI, MEN, MIS, NEU, RNE, SAL, SLU, SFE, TUC) / BRA(PAR, RGS, SCA) / CHL(ANT, ATA, COQ, VAL, LBO, MAU, BIO, ARA, LLA, RME, JFE) / URY(CAS, MON, SOR)
Veronica polita	ARG(BAI, COR, SFE) / BRA(RGS) / URY(CAS, MON)
Veronica scutellata	ARG(BAI, DFE)
Veronica serpyllifolia	ARG(BAI, CHU, LPA, MEN, NEU, RNE, SCR, TDF) / BRA(RGS, SCA) / CHL(MAU, ARA)
Vestia foetida	CHL(VAL, LBO, BIO, ARA, LLA)
Veyretia hassleri	ARG(COS) / BRA(RGS, SCA) / PRY(APY, MIE)
Veyretia neuroptera	ARG(COS, MIS) / BRA(PAR)
Veyretia sagittata	ARG(COS, MIS) / BRA(Fuera del área del proyecto)
Veyretia undulata	BRA(SCA)
Viburnum seemenii f. minus	ARG(JUJ, SAL)
Vicia andicola	ARG(JUJ, SAL, TUC)
Vicia araucana	CHL(MAU, BIO)
Vicia benghalensis	CHL(TAR, COQ, VAL, MAU, BIO, ARA, LLA, RME) / URY(CAS, CLA, FLA, LAV, MON, PAY, SJO, SOR)
Vicia berteroana	CHL(LBO, RME)
Vicia bijuga	ARG(CHU, MEN, NEU, RNE, SCR, TDF) / CHL(BIO, LLA, AIS, MAG, RME)
Vicia coquimbensis	CHL(COQ)
Vicia cracca	ARG(TDF)
Vicia disperma	ARG(BAI, CHU) / URY(COL, MON)
Vicia diversifolia	CHL(LLA)
Vicia epetiolaris var. epetiolaris	ARG(BAI, CHA, COS, ERI, FOR, MIS, SFE) / BRA(RGS) / PRY(MIE, PHA) / URY(ART, CAS, CLA, DUR, FLO, FLA, LAV, MON, PAY, RNO, SAO, SJO, SOR, TYT)
Vicia epetiolaris var. microcarpa	ARG(CHA, COS, MIS) / BRA(RGS)
Vicia faba	ARG(TDF) / BRA(SCA) / URY(SOR)
Vicia graminea var. transiens	ARG(BAI, COS, ERI, FOR, SFE) / URY(CLA, COL, FLO, LAV, PAY, ROC, SJO, SOR)
Vicia graminea var. graminea	ARG(BAI, CHA, CHU, COR, COS, DFE, ERI, FOR, MIS, RNE, SCR, SFE) / BRA(RGS) / CHL(AIS, MAG, RME) / PRY(MIE) / URY(ART, CAS, CLA, COL, DUR, FLA, LAV, MAL, MON, PAY, RNO, SAO, SJO, SOR, TYT)
Vicia graminea var. nigricarpa	BRA(RGS, SCA)
Vicia hatschbachii	BRA(PAR)
Vicia hirsuta	ARG(CHU) / BRA(RGS) / CHL(LBO, MAU, BIO, ARA, LLA)
Vicia hybrida	URY(MON)
Vicia inconspicua	CHL(ARA, LLA)
Vicia lanceolata	CHL(MAU)
Vicia linearifolia	ARG(BAI, COR, COS, ERI, LPA, SFE) / BRA(RGS) / CHL(VAL, BIO, ARA, LLA, AIS) / URY(ART, CAS, CLA, COL, DUR, FLO, FLA, LAV, MAL, MON, PAY, RIV, SAO, SJO, SOR, TYT)
Vicia macrograminea	ARG(CHA, COS, ERI, FOR, MIS, SFE) / BRA(PAR, RGS) / PRY(CEN, COA, PAI, PHA) / URY(MON, RIV, SAO, TAC)
Vicia magellanica var. magellanica	ARG(CHU, MEN, NEU, RNE, SCR, TDF) / CHL(COQ, LBO, MAU, BIO, AIS, MAG, RME)
Vicia magellanica var. dianthes	CHL(ARA)
Vicia modesta	CHL(ANT)
Vicia montevidensis	ARG(BAI, ERI, SFE) / BRA(RGS, SCA) / URY(CAS, CLA, LAV, MAL, MON, SJO, TAC)
Vicia mucronata	CHL(VAL, LBO, BIO, ARA, LLA, RME)
Vicia nana	ARG(BAI, CHA, COS, ERI, FOR, MIS, SFE) / BRA(RGS) / CHL(BIO, LLA) / URY(ART, CAS, CLA, COL, CLA, LAV, MAL, MON, RNO, RIV, SAO, SJO, TYT)
Vicia nigricans	ARG(CHU, NEU, RNE) / CHL(VAL, LBO, MAU, BIO, ARA, LLA, AIS, RME)
Vicia pallida	CHL(VAL, RME)
Vicia pampicola var. pampicola	ARG(BAI, CAT, CHU, COR, COS, ERI, FOR, JUJ, LPA, LRI, MEN, RNE, SJU, SLU, SFE, TDF, TUC) / BRA(RGS) / URY(MON, RNO, SJO)
Vicia pampicola var. burkartii	ARG(BAI, CHU, RNE, SCR) / URY(CAS, FLA, MON, SJO)
Vicia parviflora	CHL(ARA)
Vicia platensis	ARG(BAI, ERI) / URY(MAL, MON, PAY, SJO)
Vicia sativa ssp. sativa	ARG(BAI, CHU, COR, DFE, NEU, RNE, SFE) / BRA(SCA) / CHL(VAL, LBO, MAU, BIO, ARA, LLA, RME) / URY(MON, SOR)
Vicia sativa ssp. nigra	ARG(BAI, CHU, COR, LPA, NEU, RNE) / BRA(PAR, RGS) / CHL(LLA, RME) / URY(COL, LAV, MON, TYT)
Vicia sativa ssp. cordata	ARG(BAI, MEN, NEU)
Vicia sessiliflora	CHL(LLA)
Vicia setifolia var. bonariensis	ARG(BAI)
Vicia setifolia var. setifolia	ARG(CAT, COR, LRI, NEU, SAL, SLU, SFE, TUC) / CHL(BIO, LLA, RME) / URY(CAS, COL, FLA, LAV, MON, PAY, SAO, SJO)
Vicia stenophylla	BRA(PAR, RGS, SCA) / PRY(COA) / URY(PAY, RIV, SJO)
Vicia subserrata	CHL(COQ, RME)
Vicia tephrosoides	ARG(COS, MIS) / BRA(RGS) / PRY(ITA)
Vicia tetrasperma	CHL(TAR, VAL, LBO, MAU, MAG, RME)
Vicia vicina	CHL(TAR, ANT, COQ, VAL, LBO, MAU, BIO, ARA, RME)
Vicia villosa ssp. villosa	ARG(BAI, ERI, LPA, SAL, SCR) / CHL(LBO, MAU, BIO, ARA, RME)
Vicia villosa ssp. eriocarpa	BRA(RGS) / URY(CAS, COL, MON, PAY, SOR)
Vicia villosa ssp. varia	URY(MON, PAY)
Victoria cruziana	ARG(CHA, COS, ERI, FOR, SFE) / PRY(CEN, ÑEE, PHA)
Vigna adenantha	ARG(BAI, CHA, COS, ERI, FOR, JUJ, MIS, SAL, SFE) / BRA(PAR, RGS) / PRY(CEN, COA, GUA, PAI) / URY(ART, CAS, COL, MAL, MON, SAO, SOR)
Vigna candida	ARG(CHA, COS, ERI, JUJ, MIS, TUC) / BRA(PAR, RGS, SCA) / PRY(APA, COA, PAI) / URY(SAO)
Vigna caracalla	ARG(CAT, COR, COS, FOR, JUJ, MIS, SAL, SFE, TUC) / BRA(PAR, RGS, SCA) / PRY(APA) / URY(MON)
Vigna firmula	BRA(Fuera del área del proyecto) / PRY(COA, GUA)
Vigna hookeri	ARG(BAI, ERI) / BRA(RGS) / URY(SAO, SOR, TAC)
Vigna lasiocarpa	ARG(COS, MIS) / BRA(PAR, RGS) / PRY(APY, CAU, PAI)
Vigna linearis	BRA(PAR) / PRY(CEN, CON, GUA)
Vigna longifolia	ARG(BAI, CHA, COS, ERI, MIS) / BRA(PAR, RGS, SCA) / PRY(APY, CHO, MIE, ÑEE, PHA) / URY(CAS, MAL, MON, RIV, ROC, SJO)
Vigna luteola	ARG(BAI, CHA, COR, COS, ERI, FOR, JUJ, MIS, SAL, SFE, SDE, TUC) / BRA(PAR, RGS, SCA) / PRY(APY, CEN) / URY(ART, CAS, COL, MAL, MON, ROC, SAO, SJO, TAC, TYT)
Vigna peduncularis var. clitorioides	ARG(CHA, COS, MIS) / BRA(PAR, RGS, SCA) / PRY(APA, CAN, ITA, MIE, SPE) / URY(CLA, RIV, TAC)
Vigna peduncularis var. peduncularis	BRA(PAR, RGS) / PRY(CAN)
Vigna speciosa	BRA(PAR)
Viguiera simulans	PRY(CAN)
Viguiera trichophylla	BRA(PAR, SCA)
Villanova oppositifolia	CHL(ANT)
Villanova robusta	CHL(TAR)
Vinca major	ARG(BAI, CHU, JUJ, NEU, RNE, SAL) / BRA(SCA) / CHL(ANT, COQ, VAL, LBO, MAU, BIO, ARA, LLA, RME, JFE) / URY(MON, SOR)
Viola acanthophylla	CHL(RME)
Viola aizoon	CHL(BIO, ARA)
Viola angustifolia	CHL(LBO, RME)
Viola araucaniae	CHL(ARA)
Viola argentina	ARG(COR, LRI, SJU)
Viola arvensis ssp. andina	CHL(LLA)
Viola arvensis ssp. arvensis	ARG(BAI, COR, LPA, MEN, NEU, RNE, SLU, SFE, TDF, TUC) / CHL(BIO, ARA, LLA)
Viola atropurpurea	ARG(MEN, NEU, SJU) / CHL(VAL, LBO, MAU, RME)
Viola aurantiaca	CHL(RME)
Viola aurata	CHL(COQ)
Viola auricolor	ARG(CHU, SCR)
Viola auricula	CHL(RME)
Viola beckeriana	ARG(MEN)
Viola boliviana	ARG(JUJ)
Viola brachypetala	CHL(VAL)
Viola bustillosia	CHL(LBO)
Viola calchaquiensis	ARG(TUC)
Viola calderensis	CHL(ANT, ATA)
Viola cano-barbata var. cano-barbata	ARG(MEN) / CHL(COQ, LBO, RME)
Viola cano-barbata var. albiflora	
Viola capillaris var. capillaris	CHL(LBO, MAU, BIO, ARA)
Viola capillaris var. araucana	CHL(BIO, ARA)
Viola capillaris var. dumetorum	CHL(BIO)
Viola castillonii	ARG(JUJ, SAL, TUC)
Viola cerasifolia	BRA(PAR, RGS, SCA)
Viola chamaedrys	CHL(VAL, RME)
Viola columnaris	ARG(CHU, MEN, NEU, RNE)
Viola comberi	ARG(NEU)
Viola commersonii	ARG(SCR, TDF) / CHL(MAG)
Viola congesta	CHL(MAU, RME)
Viola coronifera	ARG(NEU)
Viola corralensis	CHL(LLA)
Viola cotyledon	ARG(CHU, MEN, NEU, RNE) / CHL(LBO, MAU, BIO, ARA)
Viola curicoensis	CHL(MAU)
Viola cyathiformis	CHL(BIO)
Viola dasyphylla	ARG(NEU)
Viola decipiens	CHL(COQ, VAL, BIO, RME)
Viola domeykoana	ARG(MEN, SJU) / CHL(COQ, VAL, LBO, RME)
Viola escarapela	CHL(COQ, VAL, MAU)
Viola escondidaensis	ARG(NEU)
Viola evae	ARG(LRI, SAL)
Viola exsul	ARG(SJU)
Viola flos-evae var. flossdorfii	ARG(LRI)
Viola flos-evae var. flos-evae	ARG(SJU)
Viola flos-idae	ARG(MEN, SAL, SJU, TUC)
Viola fluehmannii	ARG(NEU, RNE) / CHL(BIO, ARA, LLA)
Viola friderici	CHL(RME)
Viola frigida	ARG(LRI, MEN, SJU) / CHL(ANT, ATA, COQ, VAL)
Viola germainii	CHL(RME)
Viola glacialis	CHL(LBO, MAU, BIO, RME)
Viola glechomoides	CHL(RME)
Viola godoyae	CHL(ATA)
Viola gracillima	BRA(PAR, RGS, SCA)
Viola granulosa	CHL(TAR)
Viola hieronymi	ARG(JUJ, LRI)
Viola huesoensis	CHL(ANT)
Viola huidobrii	ARG(CHU, NEU, RNE) / CHL(BIO, ARA, LLA)
Viola joergensenii	ARG(CAT)
Viola johnstonii	CHL(ANT)
Viola karlreicheana	CHL(RME)
Viola lanifera	CHL(COQ)
Viola leyboldiana	CHL(VAL, MAU)
Viola lilloana	ARG(CAT, TUC)
Viola llullaillacoensis	CHL(ANT)
Viola lologensis	ARG(NEU)
Viola maculata var. maculata	ARG(CHU, NEU, RNE, SCR, TDF) / CHL(LBO, MAU, BIO, ARA, LLA, AIS, MAG, RME)
Viola maculata var. microphyllos	ARG(CHU, NEU, RNE, SCR, TDF) / CHL(AIS, MAG)
Viola maculata var. popetae	CHL(LBO)
Viola magellanica	ARG(SCR, TDF) / CHL(LLA, MAG)
Viola metajaponica	ARG(BAI, CAT, COR, LPA, SAL, SFE, SJU, SLU, TUC)
Viola micranthella	ARG(JUJ, SAL)
Viola minutiflora	CHL(BIO, ARA)
Viola montagnei var. glandulosa	CHL(COQ, RME)
Viola montagnei var. montagnei	ARG(CAT, LRI, MEN, SJU) / CHL(ATA, COQ, VAL, LBO, MAU, RME)
Viola munozensis	ARG(TUC)
Viola muscoides	CHL(AIS)
Viola nassauvioides	
Viola niederleinii	ARG(LRI)
Viola nubigena	CHL(RME)
Viola odorata	ARG(BAI, CAT, COR, COS, LPA, SAL, SFE, SLU, TUC) / CHL(VAL, LBO, BIO)
Viola ovalleana	CHL(COQ)
Viola philippii var. philippii	ARG(MEN) / CHL(MAU, RME)
Viola philippii var. arbuscula	CHL(RME)
Viola polypoda	CHL(TAR, ANT, ATA, COQ)
Viola portalesia var. integerrima	CHL(COQ, VAL, LBO, MAU)
Viola portalesia var. portalesia	CHL(VAL, LBO, MAU, BIO, ARA, LLA)
Viola portulacea	ARG(MEN, NEU) / CHL(RME)
Viola pseudovulcanica	ARG(MEN, NEU, RNE)
Viola pulvinata	CHL(RME)
Viola pusilla	CHL(ATA, COQ, VAL, LBO, MAU, BIO, RME)
Viola pygmaea	ARG(JUJ, SAL)
Viola reichei	ARG(CHU, NEU, RNE, SCR, TDF) / CHL(MAU, BIO, ARA, LLA, AIS, MAG)
Viola rhombifolia	CHL(ATA, COQ, VAL, RME)
Viola rodriguezii	ARG(CAT, JUJ, SAL, TUC)
Viola roigii	ARG(SJU)
Viola rossowiana	ARG(NEU)
Viola rosulata	CHL(LBO, BIO)
Viola rubella	CHL(BIO, ARA, LLA)
Viola rudolphii	CHL(LLA)
Viola rugosa	CHL(MAU)
Viola sacculus	ARG(CHU, NEU, RNE, SCR) / CHL(MAG)
Viola santiagoensis	CHL(RME)
Viola sempervivum	ARG(MEN) / CHL(COQ, VAL, RME)
Viola singularis	ARG(CAT)
Viola skottsbergiana	CHL(LBO, MAU, BIO)
Viola spegazzinii	ARG(SAL)
Viola subandina	ARG(CHU, MEN, NEU) / CHL(LBO, MAU, BIO, RME)
Viola subdimidiata	BRA(PAR, RGS)
Viola taltalensis var. glaberrima	CHL(ANT)
Viola taltalensis var. taltalensis	CHL(ANT)
Viola tectiflora	ARG(MEN, NEU)
Viola toroensis	CHL(COQ)
Viola tricolor	ARG(BAI, CHU, COR, MEN, SAL, SCR, TUC) / BRA(PAR) / CHL(VAL, MAU, BIO, ARA, LLA, RME)
Viola tridentata	ARG(CHU, SCR, TDF) / CHL(LLA, AIS, MAG)
Viola triflabellata	ARG(CAT, JUJ, LRI, SAL, TUC)
Viola truncata var. glaberrima	CHL(RME)
Viola truncata var. glandulifera	ARG(NEU) / CHL(MAU)
Viola truncata var. truncata	CHL(LBO)
Viola tucumanensis	ARG(TUC)
Viola vallenarensis	CHL(ATA)
Viola volcanica var. chillanensis	CHL(BIO)
Viola volcanica var. exilis	CHL(RME)
Viola volcanica var. volcanica	ARG(MEN, NEU, SJU, TUC) / CHL(LBO, MAU, BIO)
Viola werdermannii var. werdermannii	CHL(ANT)
Viola werdermannii var. glaberrima	CHL(TAR, ANT)
Virola bicuhyba	BRA(PAR, RGS, SCA)
Vitex cymosa	ARG(FOR, MIS) / BRA(Fuera del área del proyecto) / PRY(APY, APA, CEN, CON, COA, PAI)
Vitex megapotamica	ARG(COS, MIS) / BRA(PAR, RGS, SCA) / PRY(APA, AMA, CAU, CAA) / URY(ROC, TAC, TYT)
Vitex polygama var. polygama	BRA(SCA)
Vitex polygama var. bakeri	BRA(PAR)
Vitex polygama var. dusenii	BRA(PAR)
Vitis vinifera	ARG(LPA)
Vittaria graminifolia	ARG(COS, MIS) / BRA(PAR, RGS, SCA) / URY(CLA, LAV, MAL, RIV, ROC)
Vittaria lineata	ARG(CHA, MIS, SAL) / BRA(PAR, RGS, SCA) / PRY(CAU, CAN, GUA, PAI, SPE)
Vittaria scabrida	BRA(PAR, RGS, SCA) / PRY(CAU)
Viviania crenata	CHL(COQ, VAL, LBO, RME)
Viviania marifolia	ARG(NEU, SJU) / CHL(ATA, COQ, VAL, LBO, MAU, BIO, RME)
Viviania ovata	ARG(NEU) / CHL(VAL, LBO, MAU, BIO, RME)
Viviania paranensis	BRA(PAR)
Vochysia bifalcata	BRA(PAR)
Vochysia cinnamomea	BRA(Fuera del área del proyecto) / PRY(AMA)
Vochysia magnifica	BRA(PAR, SCA)
Vochysia tucanorum	BRA(PAR) / PRY(APY, AMA, CAN, CON, PHA, SPE)
Volutaria tubuliflora	CHL(ATA)
Voyria aphylla	BRA(PAR, SCA) / PRY(CEN)
Voyria tenella	BRA(SCA)
Vriesea altodaserrae	BRA(PAR, SCA)
Vriesea biguassuensis	BRA(SCA)
Vriesea brusquensis	BRA(SCA)
Vriesea carinata	BRA(PAR, RGS, SCA)
Vriesea corcovadensis	BRA(PAR, SCA)
Vriesea declinata	BRA(SCA)
Vriesea drepanocarpa	BRA(PAR, SCA)
Vriesea eltoniana	BRA(PAR)
Vriesea ensiformis var. ensiformis	BRA(PAR, SCA)
Vriesea ensiformis var. striata	BRA(SCA)
Vriesea erythrodactylon	BRA(PAR, RGS, SCA)
Vriesea flammea	BRA(PAR, RGS, SCA)
Vriesea flava	BRA(PAR, SCA)
Vriesea friburgensis var. tucumanensis	ARG(CAT, CHA, COS, FOR, JUJ, MIS, SAL, TUC) / BRA(PAR, RGS, SCA) / PRY(APA, CAU, CAA, CEN, GUA, PAI, SPE)
Vriesea friburgensis var. friburgensis	BRA(PAR, RGS) / PRY(CAU, CAA, GUA)
Vriesea friburgensis var. paludosa	BRA(PAR, RGS, SCA)
Vriesea gigantea	BRA(PAR, RGS, SCA)
Vriesea guttata var. guttata	BRA(PAR, SCA)
Vriesea guttata var. striata	BRA(SCA)
Vriesea guttata var. eguttata	BRA(SCA)
Vriesea hieroglyphica	BRA(PAR)
Vriesea hoehneana	BRA(SCA)
Vriesea incurvata	BRA(PAR, RGS, SCA)
Vriesea inflata	BRA(PAR, SCA)
Vriesea jonghei	BRA(PAR, SCA)
Vriesea longicaulis	BRA(SCA)
Vriesea lubbersii	BRA(SCA)
Vriesea maxoniana	ARG(SAL)
Vriesea morreniana	BRA(PAR, SCA)
Vriesea muelleri	BRA(PAR, SCA)
Vriesea paratiensis	BRA(PAR)
Vriesea pauperrima	BRA(PAR)
Vriesea philippocoburgii	BRA(PAR, RGS, SCA)
Vriesea pinottii	BRA(PAR, SCA)
Vriesea platynema var. platynema	ARG(MIS) / BRA(PAR, RGS, SCA)
Vriesea platynema var. flava	BRA(SCA)
Vriesea platynema var. striata	BRA(SCA)
Vriesea platynema var. variegata	BRA(PAR, SCA)
Vriesea platzmannii	BRA(PAR, RGS, SCA)
Vriesea procera var. procera	ARG(Desconocida) / BRA(PAR, RGS, SCA) / PRY(ITA)
Vriesea procera var. debilis	BRA(PAR)
Vriesea psittacina var. decolor	BRA(RGS, SCA) / PRY(CAU)
Vriesea rastrensis	BRA(SCA)
Vriesea reitzii	BRA(PAR, RGS, SCA)
Vriesea rodigasiana	BRA(PAR, RGS, SCA)
Vriesea rubens	BRA(SCA)
Vriesea scalaris	BRA(RGS, SCA)
Vriesea triangularis	BRA(SCA)
Vriesea unilateralis	BRA(PAR, SCA)
Vriesea vagans	BRA(PAR, RGS, SCA)
Vulpia antucensis	ARG(BAI, CHU, LPA, MEN, NEU, RNE, SCR) / CHL(ANT, COQ, VAL, BIO, ARA, LLA, MAG, RME)
Vulpia australis	ARG(BAI, COS, DFE, ERI, FOR, LPA, MIS, RNE, SLU) / BRA(RGS, SCA) / URY(CAS, CLA, COL, FLA, LAV, MAL, MON, PAY, RNO, SJO, SOR)
Vulpia bromoides	ARG(BAI, CAT, CHU, COR, COS, DFE, ERI, JUJ, NEU, RNE, SCR, SLU, TDF, TUC) / BRA(RGS, SCA) / CHL(ATA, COQ, VAL, LBO, MAU, BIO, ARA, LLA, AIS, MAG, RME, JFE) / URY(CAS, CLA, COL, DUR, FLO, FLA, LAV, MAL, MON, RIV, ROC, SAO, SJO, SOR, TYT)
Vulpia muralis	ARG(BAI) / CHL(COQ, VAL, ARA, RME, JFE)
Vulpia myuros f. myuros	ARG(BAI, CAT, CHU, COR, DFE, ERI, LPA, MEN, NEU, RNE, SLU, SCR, SFE, TUC) / BRA(RGS, SCA) / CHL(TAR, ANT, COQ, VAL, LBO, MAU, BIO, ARA, LLA, MAG, RME, JFE, IPA) / URY(CLA, COL, DUR, FLO, FLA, LAV, MAL, MON, PAY, RNO, ROC, SOR)
Vulpia myuros var. hirsuta	CHL(ANT, COQ, VAL, LBO, MAU, BIO, ARA, LLA, RME, JFE)
Vulpia myuros f. megalura	ARG(BAI, CHU, COR, DFE, ERI, JUJ, LPA, MEN, NEU, RNE, SLU, SCR, TUC) / BRA(RGS) / CHL(ANT, ATA, COQ, VAL, LBO, MAU, BIO, ARA, LLA, RME, JFE) / URY(CLA, COL, CLA, FLO, LAV, MAL, MON, RNO, RIV, SAO, SJO, SJO, TYT)
Vulpia octoflora	ARG(BAI, ERI, LPA, MEN, RNE, SLU, SCR) / CHL(ANT, COQ)
