Aa achalensis	ARG(COR, SLU)
Aa fiebrigii	ARG(CAT, JUJ, SAL, TUC)
Aa hieronymi	ARG(CAT, COR, JUJ, SLU, TUC) / BRA(Desconocida)
Aa weddelliana	ARG(CAT, JUJ, SAL, TUC)
AAA bbb	
Abarema brachystachya	BRA(PAR)
Abarema langsdorffii	BRA(PAR, RGS, SCA)
Abatia angeliana	ARG(MIS) / BRA(PAR, RGS, SCA)
Abatia stellata	ARG(CAT, JUJ, SAL, TUC)
Abildgaardia ovata	ARG(CHA, COS, ERI, FOR, JUJ, MIS, SAL, SFE, TUC) / BRA(RGS, SCA) / PRY(APY, AMA, CAU, CON, GUA, PHA, SPE) / URY(ART, CAS, CLA, DUR, MON, PAY, RNO, ROC, SAO, SOR, TAC, TYT)
Abobra tenuifolia	ARG(BAI, COR, COS, ERI, SDE, SFE, SLU) / URY(CAS)
Abrotanella diemii	ARG(NEU)
Abrotanella emarginata	ARG(SCR, TDF) / CHL(AIS, MAG)
Abrotanella linearifolia	CHL(LLA, MAG, JFE)
Abrotanella purpurea	CHL(LLA, MAG)
Abrotanella submarginata	CHL(MAG)
Abrotanella trichoachaenia	ARG(NEU, RNE) / CHL(AIS, MAG)
Abrotanella trilobata	ARG(TDF) / CHL(MAG)
Abuta selloana	BRA(PAR, SCA)
Abutilon affine	ARG(COS, MIS) / BRA(RGS) / URY(MAL, ROC, TAC)
Abutilon amoenum	ARG(MIS) / BRA(PAR, SCA) / PRY(ITA)
Abutilon bedfordianum ssp. discolor	BRA(PAR)
Abutilon costicalyx	BRA(PAR)
Abutilon cyclonervosum	ARG(SAL)
Abutilon darwinii	BRA(PAR, SCA)
Abutilon fluviatile	BRA(PAR, SCA)
Abutilon grandifolium	ARG(BAI, CAT, CHA, COR, COS, ERI, FOR, JUJ, LRI, MIS, SAL, SDE, SFE, SJU, SLU, TUC) / BRA(RGS, SCA) / CHL(ANT) / PRY(PAI, PHA) / URY(MAL, MON, TAC)
Abutilon herzogianum	ARG(SAL) / PRY(APY)
Abutilon jujuyense	ARG(JUJ, SAL, TUC)
Abutilon malachroides	ARG(MIS) / BRA(RGS) / URY(MON, RIV)
Abutilon megapotamicum	BRA(PAR, RGS, SCA)
Abutilon muelleri-friderici	BRA(SCA)
Abutilon niveum	ARG(JUJ, SAL, TUC)
Abutilon pauciflorum	ARG(BAI, CHA, COR, COS, ERI, FOR, JUJ, MIS, SAL, SDE, SFE, SLU, TUC) / BRA(PAR, RGS) / PRY(CEN, COA, GUA, ÑEE, PAI, PHA) / URY(ROC)
Abutilon pictum	ARG(COS, ERI, MIS) / BRA(PAR) / PRY(COA) / URY(ART, CAS, SAO)
Abutilon ramiflorum	ARG(CHA, FOR, MIS, SAL) / BRA(PAR) / PRY(CAA, CEN, COA, PAI)
Abutilon rufinerve	BRA(PAR, SCA)
Abutilon sellowianum	BRA(SCA)
Abutilon terminale	ARG(BAI, COR, COS, ERI, LPA, MIS, SFE, SLU) / BRA(RGS) / URY(FLA, LAV, MAL, RIV)
Abutilon thyrsodendron	ARG(JUJ, SAL)
Abutilon umbelliflorum	ARG(COS, MIS, SAL, TUC) / BRA(PAR, RGS, SCA) / PRY(APA, GUA, ITA) / URY(ROC, TAC)
Abutilon vexillarium	BRA(RGS, SCA)
Acacia amambayensis	PRY(AMA)
Acacia catharinensis	BRA(SCA)
Acacia dealbata	ARG(COR) / BRA(RGS) / CHL(VAL, LBO, MAU, BIO, ARA, RME, JFE, IPA) / URY(LAV, MAL, MON, SOR)
Acacia emilioana	PRY(APY)
Acacia fiebrigii	PRY(CAN)
Acacia grandistipula	BRA(PAR)
Acacia horrida	CHL(ATA, RME) / URY(MON)
Acacia karroo	CHL(TAR, RME)
Acacia lacerans	BRA(PAR, SCA)
Acacia longifolia	ARG(BAI) / BRA(PAR, RGS, SCA) / URY(CAS, COL, MAL, MON, ROC)
Acacia macracantha	CHL(TAR)
Acacia magnibracteosa	BRA(RGS, SCA)
Acacia martiusiana	BRA(PAR, SCA)
Acacia melanoxylon	ARG(BAI) / BRA(RGS) / CHL(VAL, MAU, BIO, ARA, LLA, RME, JFE, IPA) / URY(MAL, MON, SOR)
Acacia paniculata	PRY(AMA, CAA, CEN, CON, COA, GUA, PAI)
Acacia paradoxa	CHL(VAL)
Acacia plumosa	BRA(PAR, RGS, SCA)
Acacia riparia	PRY(CEN, COA, GUA, PAI)
Acacia velutina f. ferox	PRY(COA, GUA)
Acacia velutina f. subinermis	PRY(CAN)
Acaciella angustissima	ARG(JUJ, SAL)
Acaena alpina	ARG(MEN, NEU) / CHL(VAL, LBO, MAU, BIO, ARA, LLA, RME)
Acaena antarctica	ARG(NEU, RNE, SCR, TDF) / CHL(ARA, LLA, AIS, MAG)
Acaena argentea	ARG(CHU, NEU, RNE) / CHL(VAL, LBO, MAU, BIO, ARA, LLA)
Acaena caespitosa	ARG(CHU, MEN, NEU, RNE, SCR) / CHL(MAG)
Acaena confertissima	ARG(CHU, SCR)
Acaena eupatoria	ARG(MIS) / BRA(PAR, RGS, SCA) / URY(CAS, CLA, FLO, FLA, LAV, MON, SOR, TAC)
Acaena integerrima	ARG(CHU, MEN, NEU, RNE, SCR, TDF) / CHL(MAU, BIO, ARA, AIS, MAG, RME)
Acaena leptacantha	ARG(MEN, NEU, RNE) / CHL(LBO, MAU, BIO, ARA, LLA, RME)
Acaena lucida	ARG(SCR, TDF) / CHL(MAG)
Acaena macrocephala	ARG(MEN, NEU, RNE) / CHL(MAU, BIO, ARA, LLA)
Acaena magellanica	ARG(CAT, CHU, LRI, MEN, NEU, RNE, SAL, SCR, SJU, TDF) / CHL(TAR, ANT, ATA, COQ, VAL, LBO, MAU, BIO, ARA, LLA, AIS, MAG, RME)
Acaena masafuerana	CHL(JFE)
Acaena myriophylla	ARG(BAI, CAT, COR, ERI, LPA, MEN, RNE, SFE, SLU, TUC)
Acaena ovalifolia	ARG(BAI, CAT, CHU, JUJ, NEU, RNE, SAL, SCR, TDF, TUC) / CHL(COQ, VAL, LBO, MAU, BIO, ARA, LLA, AIS, MAG, JFE)
Acaena patagonica	ARG(SCR, TDF) / CHL(MAG)
Acaena pinnatifida	ARG(CAT, CHU, COR, LPA, MEN, NEU, RNE, SCR, SJU, TDF) / CHL(COQ, VAL, LBO, MAU, BIO, ARA, LLA, AIS, MAG, RME)
Acaena platyacantha	ARG(CHU, MEN, NEU, RNE, SCR, SJU, TDF) / CHL(ARA, AIS, MAG)
Acaena poeppigiana	ARG(CHU, MEN, NEU, RNE, SCR, SJU, TDF) / CHL(COQ, LBO, MAU, MAG)
Acaena pumila	ARG(TDF) / CHL(LLA, AIS, MAG)
Acaena sericea	ARG(CHU, MEN, SCR, SJU, TDF) / CHL(VAL, MAG, RME)
Acaena splendens	ARG(CHU, MEN, NEU, RNE) / CHL(COQ, VAL, LBO, MAU, RME)
Acaena stricta	ARG(CAT, JUJ, LRI, SAL, TUC)
Acaena tenera	ARG(TDF) / CHL(MAG)
Acaena trifida var. glabrescens	CHL(ANT, ATA, RME)
Acaena trifida var. trifida	CHL(COQ, VAL, LBO, MAU, BIO, ARA, RME)
Acalypha amblyodonta	ARG(JUJ, MIS, SAL) / BRA(Fuera del área del proyecto) / PRY(APY, CEN, COA, PAI, PHA)
Acalypha apetiolata	BRA(RGS)
Acalypha boliviensis	ARG(CAT, COR, JUJ, SAL, SLU, SDE, TUC)
Acalypha brasiliensis	ARG(JUJ, MIS) / BRA(SCA)
Acalypha communis ssp. saltensis	ARG(JUJ, SAL, TUC)
Acalypha communis ssp. tracheliifolia	ARG(ERI) / URY(CAS, CLA, FLA, MON, PAY, ROC, SAO, SJO, TAC)
Acalypha communis	ARG(BAI, CHA, COR, COS, ERI, FOR, JUJ, LPA, MIS, SAL, SLU, SFE, SDE, TUC) / BRA(PAR, RGS, SCA) / PRY(APA, APY, AMA, BOQ, CAA, CEN, CON, COA, ITA, MIE, ÑEE, PAI, PHA) / URY(ART, CAS, CLA, COL, LAV, PAY, RNO, RIV, SAO, SJO, SJO, TAC)
Acalypha communis ssp. apicalis	ARG(COS, FOR, MIS) / BRA(Fuera del área del proyecto) / PRY(APA, APY, AMA, CAN, CEN, CON, GUA, ITA, MIE, PAI, PHA)
Acalypha communis ssp. paraguariensis	ARG(COS, FOR, MIS) / PRY(APY, AMA, CEN, PAI, PHA, SPE)
Acalypha gracilis	ARG(BAI, COS, ERI, MIS, SAL, TUC) / BRA(PAR, RGS, SCA) / PRY(APA, CAA, CAN, GUA, ITA) / URY(ART, PAY, SAO)
Acalypha hassleriana	PRY(CAN, COA, SPE)
Acalypha herzogiana	ARG(MIS) / PRY(APY, AMA, CAU, CAN, CEN, COA, GUA, PAI, SPE)
Acalypha lycioides	ARG(CAT, JUJ, LRI, SAL, SDE, TUC)
Acalypha multicaulis	ARG(BAI, CHA, COR, COS, ERI, JUJ, MIS, SAL) / BRA(PAR, RGS) / PRY(APA, APY, AMA, CAU, CAN, CEN, CON, COA, GUA, ITA, MIE, ÑEE, PAI, PHA) / URY(COL, CLA, SAO, TYT)
Acalypha plicata	ARG(CAT, JUJ, SAL, TUC)
Acalypha poiretii	ARG(CAT, CHA, COR, JUJ, LRI, SAL, SJU, SLU, SDE, TUC) / BRA(SCA)
Acalypha schreiteri	ARG(JUJ, TUC)
Acalypha sehnemii	BRA(RGS)
Acalypha senilis	ARG(COS, MIS) / PRY(AMA, CAU) / URY(DUR, LAV, MAL, MON, PAY, RNO, RIV, SAO, TAC, TYT)
Acalypha striolata	ARG(COS, MIS) / PRY(APA, CAA, CAN, GUA, ITA)
Acalypha uleana	BRA(SCA)
Acalypha variabilis	ARG(BAI, CHA, COR, COS, ERI, FOR, SLU, SFE, SDE) / PRY(AMA, CAU, COA, MIE, PHA, SPE) / URY(ART, CAS, COL, FLO, LAV, MON, PAY, RNO, RIV, SJO, SJO)
Acalypha vellamea	ARG(COS) / PRY(AMA)
Acalypha villosa	ARG(JUJ, SAL) / PRY(APA, AMA, CON)
Acalypha wilkesiana	PRY(CEN)
Acanthocalycium ferrarii	ARG(TUC)
Acanthocalycium glaucum	ARG(CAT, LRI)
Acanthocalycium klimpelianum	ARG(CAT, COR, SDE)
Acanthocalycium spiniflorum	ARG(COR, SLU)
Acanthocalycium thionanthum	ARG(SAL, TUC)
Acanthocladus albicans	ARG(CHA, COS, FOR, MIS) / BRA(Fuera del área del proyecto) / PRY(APY, AMA, CEN, CON, COA, ÑEE, PHA)
Acanthocladus brasiliensis	BRA(PAR)
Acantholippia seriphioides	ARG(BAI, CHU, LPA, LRI, MEN, NEU, RNE, SJU, SLU, SCR)
Acanthospermum australe	ARG(BAI, COR, COS, ERI, MIS, SFE, SLU) / BRA(PAR, RGS, SCA) / PRY(AMA, CAU, CAA, CAN, CEN, COA, ITA, MIE, PAI, SPE) / URY(ART, CAS, CLA, COL, DUR, FLA, MAL, MON, RNO, ROC, SJO, SOR, TAC, TYT)
Acanthospermum consobrinum	PRY(CEN)
Acanthospermum hispidum	ARG(BAI, CAT, CHA, COR, COS, DFE, ERI, FOR, JUJ, LPA, LRI, MEN, MIS, SAL, SDE, SFE, SJU, SLU, TUC) / BRA(PAR, RGS, SCA) / PRY(APY, BOQ, CEN, CON, COA, ÑEE, PAI, PHA)
Acanthostachys strobilacea	ARG(MIS) / BRA(PAR) / PRY(APA, AMA)
Acanthostyles buniifolius	ARG(BAI, CAT, COR, COS, ERI, JUJ, LPA, LRI, MEN, MIS, RNE, SAL, SJU, SLU, TUC) / BRA(RGS) / URY(ART, CAS, COL, FLA, LAV, MAL, MON, PAY, RIV, SAO, SJO, SJO, TAC, TYT)
Acanthosyris falcata	ARG(CHA, COR, COS, FOR, JUJ, SAL, SFE, TUC) / PRY(APA, APY, CEN, COA, PHA)
Acanthosyris spinescens	ARG(BAI, CHA, COS, ERI, MIS, SFE) / BRA(RGS) / URY(CAS, DUR, FLA, LAV, MAL, PAY, RIV, SAO, SJO)
Acaulimalva nubigena	ARG(CAT, JUJ, SAL, TUC)
Acca sellowiana	ARG(MIS) / BRA(PAR, RGS, SCA) / URY(CAS, CLA, PAY, RIV, TAC, TYT)
Acer negundo	ARG(BAI, LPA)
Acer pseudoplatanus	ARG(NEU, RNE)
Achatocarpus balansae	ARG(MIS) / PRY(CAU, GUA, ÑEE)
Achatocarpus brevipedicellatus	PRY(CEN, COA)
Achatocarpus hasslerianus	PRY(CAU)
Achatocarpus microcarpus	PRY(CON, GUA, ÑEE)
Achatocarpus praecox var. praecox	ARG(CAT, CHA, COS, FOR, JUJ, MIS, SAL, SFE, SDE, TUC) / PRY(APY, PAI)
Achatocarpus praecox f. obovatus	ARG(CHA, FOR, MIS, SAL, SFE, TUC) / PRY(CEN, COA)
Achatocarpus praecox f. spinolosus	ARG(JUJ, MIS, TUC)
Achatocarpus praecox var. bicornutus	ARG(COS, ERI, FOR, MIS, SAL) / BRA(PAR, SCA) / PRY(APY, GUA, PHA)
Achetaria ocymoides	BRA(PAR, SCA)
Achillea millefolium	ARG(BAI, CHU, COR, DFE, LPA, LRI, MIS, NEU, RNE, SAL, SCR, SFE, TDF, TUC) / BRA(PAR, SCA) / CHL(COQ, MAU, BIO, ARA, LLA, AIS, MAG, RME) / URY(CAS, FLA, MON, SAO)
Achillea ptarmica	CHL(LLA)
Achyrocline alata	ARG(BAI, CAT, CHA, COR, COS, ERI, JUJ, LRI, MIS, SAL, SLU, TUC) / BRA(PAR, RGS, SCA) / PRY(APA, AMA, CAU, CAA, CEN, COA, GUA) / URY(ART, CAS, CLA, MON, ROC, SJO, TAC, TYT)
Achyrocline anabelae	BRA(RGS)
Achyrocline crassiuscula	BRA(RGS)
Achyrocline flaccida	ARG(CAT, CHA, COR, COS, ERI, FOR, JUJ, LRI, MIS, SAL, SJU, TUC) / BRA(PAR, RGS, SCA) / PRY(AMA, CAU, CAA, COA, GUA, PAI) / URY(ART, CAS, MAL, RNO, RIV, ROC, SAO)
Achyrocline gardnerii	BRA(SCA)
Achyrocline gertiana	BRA(Fuera del área del proyecto) / PRY(AMA, COA)
Achyrocline hyperchlora	ARG(CAT, JUJ, LRI, SAL, TUC)
Achyrocline luisiana	BRA(RGS)
Achyrocline macella	BRA(PAR)
Achyrocline marchiorii	BRA(RGS)
Achyrocline ramosissima	ARG(JUJ, LRI, SAL)
Achyrocline rupestris	ARG(CAT, COR, JUJ, LRI, SAL, SJU, TUC)
Achyrocline satureioides	ARG(BAI, CAT, CHA, COR, COS, ERI, JUJ, LPA, LRI, MIS, SAL, SLU, SFE, SDE, TUC) / BRA(PAR, RGS, SCA) / PRY(CAU, CAA, COA, GUA, PAI) / URY(CAS, COL, DUR, FLA, MAL, MON, PAY, RNO, RIV, ROC, SJO, TAC, TYT)
Achyrocline tomentosa	ARG(CAT, COR, COS, JUJ, LRI, MEN, MIS, SAL, SJU, TUC) / BRA(RGS) / CHL(TAR) / PRY(AMA, PAI)
Achyrocline venosa	ARG(COR, JUJ, SAL, TUC) / PRY(AMA, CAU, CAA, CEN, COA, GUA, MIE, PAI, PHA)
Aciachne acicularis	ARG(CAT, SAL)
Acianthera acuminatipetala	BRA(PAR)
Acianthera adirii	BRA(PAR)
Acianthera albo-rosea	BRA(PAR, SCA)
Acianthera antennata	BRA(PAR)
Acianthera aphthosa	ARG(MIS) / BRA(PAR, RGS, SCA) / PRY(APA, AMA, COA, PAI)
Acianthera aurantio-lateritia	ARG(JUJ, MIS, SAL)
Acianthera bicarinata	BRA(SCA)
Acianthera bidentula	BRA(Fuera del área del proyecto)
Acianthera boliviana	ARG(SAL)
Acianthera brachiloba	BRA(PAR, SCA)
Acianthera calopedilon	BRA(PAR, RGS)
Acianthera capanemae	BRA(PAR)
Acianthera crinita	ARG(JUJ, SAL) / BRA(PAR)
Acianthera dutrai	BRA(RGS)
Acianthera echinosa	BRA(SCA)
Acianthera exarticulata	BRA(PAR, RGS, SCA)
Acianthera glanduligera	BRA(PAR, RGS, SCA)
Acianthera glumacea	BRA(PAR, RGS, SCA)
Acianthera gracilisepala	BRA(PAR)
Acianthera hoffmannseggiana	BRA(PAR, RGS, SCA)
Acianthera karlii	BRA(PAR, RGS)
Acianthera klingelfusii	ARG(MIS) / BRA(PAR)
Acianthera klotzcheana	ARG(MIS) / BRA(PAR, RGS, SCA) / PRY(APA)
Acianthera luteola	ARG(MIS) / BRA(PAR, RGS, SCA)
Acianthera macropoda	BRA(PAR, RGS, SCA)
Acianthera macuconensis	ARG(MIS) / BRA(SCA)
Acianthera marumbyana	BRA(PAR)
Acianthera murexoidea	BRA(SCA)
Acianthera nemorosa	BRA(PAR, RGS)
Acianthera oligantha	BRA(PAR, RGS, SCA)
Acianthera panduripetala	BRA(PAR, SCA)
Acianthera papillosa	BRA(RGS)
Acianthera pardipes	BRA(PAR, SCA)
Acianthera pubescens	ARG(MIS) / BRA(PAR, RGS, SCA) / PRY(APA, APY, AMA, CAU, GUA, PAI) / URY(CLA)
Acianthera raduliglossa	ARG(MIS) / BRA(PAR, RGS, SCA)
Acianthera ramosa	BRA(PAR)
Acianthera recurva	ARG(CHA, COS, FOR, MIS) / BRA(PAR, RGS, SCA) / PRY(GUA, ÑEE)
Acianthera renipetala	BRA(PAR, SCA)
Acianthera saundersiana	ARG(MIS) / BRA(PAR, RGS, SCA) / PRY(APA, SPE)
Acianthera saurocephala	BRA(PAR, RGS, SCA)
Acianthera serpentula	
Acianthera sonderana	ARG(MIS) / BRA(PAR, RGS, SCA) / PRY(APA, SPE) / URY(CLA)
Acianthera spilantha	BRA(SCA)
Acianthera strupifolia	BRA(PAR, SCA)
Acianthera translucida	BRA(SCA)
Acianthera tricarinata	BRA(PAR, SCA)
Acianthera tristis	BRA(PAR, RGS)
Acianthera violaceomaculata	BRA(PAR)
Acianthera wageneriana	BRA(PAR, RGS, SCA)
Acicarpha obtusisepala	URY(ROC)
Acicarpha procumbens	ARG(BAI, COS, ERI) / BRA(RGS, SCA) / URY(ART, CLA, SAO, SJO, SOR, TAC)
Acicarpha runcinata	URY(FLO)
Acicarpha spathulata	BRA(PAR, RGS, SCA)
Acicarpha tribuloides	ARG(BAI, CAT, CHA, COR, COS, ERI, FOR, JUJ, MIS, RNE, SAL, SDE, SFE, SLU, TUC) / BRA(PAR, RGS, SCA) / PRY(COA, GUA, MIE, ÑEE, PAI) / URY(MON, SAO, SJO)
Acilepidopsis echitifolia	ARG(COS, MIS) / BRA(PAR) / PRY(APA, AMA, CAU, CAA, CAN, CEN, CON, COA, GUA, ITA, MIE, PAI, SPE)
Aciotis paludosa	BRA(PAR)
Acisanthera alata	PRY(COA)
Acisanthera alsinaefolia var. parvifolia	BRA(SCA) / PRY(PAI)
Acisanthera alsinaefolia var. glazioviana	BRA(SCA) / PRY(CAN, COA)
Acisanthera alsinaefolia var. alsinaefolia	ARG(COS, MIS) / BRA(PAR, RGS, SCA) / PRY(AMA, CAA, CAN, CEN, CON, COA, GUA, PAI, SPE)
Acisanthera paraguayensis	ARG(COS, MIS) / PRY(AMA, CAU, CAA, CEN, CON, COA, PAI)
Acisanthera variabilis	BRA(PAR, SCA)
Acmella alpestris	ARG(CAT, CHA, COS, FOR, JUJ, SAL, SDE, TUC) / BRA(PAR) / PRY(PAI, PHA)
Acmella bellidioides	ARG(BAI, CHA, COS, ERI, FOR, MIS, SFE, SDE) / BRA(PAR, RGS, SCA) / PRY(APY, AMA, CAU, CAN, CEN, CON, COA, GUA, MIE, PHA, SPE) / URY(MON, TAC)
Acmella brachyglossa	BRA(PAR) / PRY(APY, APA, AMA)
Acmella ciliata	ARG(CHA, JUJ)
Acmella decumbens var. decumbens	ARG(BAI, CHA, COR, COS, DFE, ERI, LPA, MIS, SFE) / BRA(PAR, RGS) / PRY(APY, BOQ, ÑEE) / URY(CAS, MON, ROC)
Acmella decumbens var. affinis	ARG(BAI, CAT, COR, JUJ, LPA, LRI, RNE, SDE, SLU, TUC)
Acmella glaberrima	ARG(CHA, COS, FOR, SDE, SFE) / CHL(MAU) / PRY(AMA, CAA, CEN, CON, MIE, SPE)
Acmella grisea	ARG(COS, ERI, MIS, SFE) / BRA(PAR) / PRY(CEN, COA, GUA, PAI, PHA)
Acmella leptophylla	ARG(MIS) / BRA(PAR, RGS) / PRY(APA, CAA, GUA, PHA)
Acmella oppositifolia	ARG(JUJ, SAL) / PRY(APY)
Acmella psilocarpa	ARG(ERI) / BRA(RGS)
Acmella pusilla	ARG(BAI, CHA, COS, ERI, FOR, MIS, SDE, SFE) / BRA(PAR, RGS) / PRY(AMA, CAA, CAN, CEN, COA, PAI, PHA) / URY(RNO)
Acmella serratifolia	ARG(COS, MIS) / BRA(PAR, RGS, SCA) / PRY(PHA) / URY(COL, RIV, TYT)
Acnistus arborescens	BRA(PAR, SCA)
Acosmium cardenasii	PRY(APY)
Acosmium subelegans	ARG(MIS) / BRA(PAR) / PRY(APA, CAU, CAA, CAN, CON, COA, PAI, SPE)
Acrisione cymosa	CHL(VAL, BIO, ARA, LLA, AIS)
Acrisione denticulata var. denticulata	ARG(NEU) / CHL(COQ, VAL, LBO, MAU, BIO, ARA, LLA, RME)
Acroceras excavatum	ARG(MIS) / BRA(PAR, RGS, SCA) / PRY(APA, AMA, CAU, GUA, MIE, PAI, SPE)
Acroceras nueva	
Acroceras zizanioides	ARG(CHA, COS, ERI, FOR, MIS, SAL, SFE) / BRA(PAR, RGS, SCA) / PRY(APA, AMA, CAU, CEN, COA, GUA, ÑEE, PAI, PHA, SPE) / URY(ART, SAO)
Acrocomia aculeata	ARG(COS, FOR, MIS, SAL) / BRA(PAR) / PRY(AMA, CAN, CEN, CON, COA, GUA, MIE, ÑEE, PAI, SPE)
Acrocomia hassleri	BRA(PAR) / PRY(AMA, CAN)
Acronia alopex	PRY(APA)
Acrostichum aureum	BRA(PAR, SCA)
Acrostichum danaeifolium	ARG(CHA, FOR, MIS) / BRA(PAR, RGS, SCA) / PRY(CEN)
Actinocephalus polyanthus	BRA(PAR, RGS, SCA)
Actinoseris radiata	BRA(PAR)
Actinostachys pennula	BRA(PAR)
Actinostachys subtrijuga	BRA(RGS, SCA)
Actinostemon concepcionis	ARG(COS) / BRA(Fuera del área del proyecto) / PRY(AMA, CAA, CAN, CEN, CON, COA, PAI, SPE)
Actinostemon concolor	ARG(COS, MIS) / BRA(PAR, RGS, SCA) / PRY(APA, AMA, CAA, CAN, CEN, COA, GUA, MIE, PAI) / URY(TYT)
Actinostemon roselii	BRA(PAR, SCA)
Adelia membranifolia	ARG(FOR, MIS) / PRY(CEN, CON, COA, ÑEE, PHA, SPE)
Adenaria floribunda	ARG(JUJ, MIS, SAL) / PRY(AMA, CON)
Adenocalymma apterospermum	BRA(RGS, SCA)
Adenocalymma bracteatum	BRA(PAR) / PRY(AMA, CAN)
Adenocalymma bracteolatum	BRA(PAR)
Adenocalymma comosum	BRA(PAR, SCA)
Adenocalymma dusenii	BRA(PAR, SCA)
Adenocalymma hatschbachii	BRA(PAR)
Adenocalymma marginatum	ARG(COS, ERI, MIS) / BRA(PAR, RGS, SCA) / PRY(APY, APA, AMA, CAU, CAA, CAN, CEN, CON, COA, GUA, PAI, SPE) / URY(SAO)
Adenocalymma paulistarum	ARG(MIS) / BRA(PAR) / PRY(APY, APA)
Adenocalymma peregrinum	BRA(PAR) / PRY(AMA)
Adenocalymma scansile	ARG(MIS) / BRA(PAR, SCA) / PRY(APA, ITA)
Adenocarpus complicatus	URY(RIV)
Adenocaulon chilense	ARG(CHU, NEU, RNE, SCR, TDF) / CHL(VAL, MAU, BIO, ARA, LLA, AIS, MAG)
Adenopeltis serrata	CHL(COQ, VAL, MAU, BIO, RME)
Adenostemma brasilianum	ARG(BAI, ERI, JUJ, MIS, SAL, TUC) / BRA(PAR, RGS, SCA) / PRY(APA, AMA, CAU, GUA, PAI) / URY(CLA, MAL, MON, RIV, ROC, SJO, TAC, TYT)
Adenostemma verbesina	ARG(MIS) / BRA(PAR, SCA) / PRY(APA, AMA, CAU, GUA)
Adesmia aconcaguensis	ARG(LRI, MEN, SJU)
Adesmia acuta	ARG(MEN, NEU)
Adesmia adrianii	ARG(NEU, RNE)
Adesmia aegiceras	ARG(LRI, MEN, NEU, SJU) / CHL(TAR, ATA, COQ, VAL, RME)
Adesmia ameghinoi	ARG(CHU, NEU, SCR)
Adesmia aphanantha	ARG(CHU, RNE, SCR)
Adesmia aphylla	CHL(ATA, COQ)
Adesmia arachnipes	CHL(COQ, VAL, RME)
Adesmia araucana	CHL(COQ, VAL, LBO, MAU, BIO, ARA)
Adesmia araujoi	BRA(PAR, RGS, SCA)
Adesmia arenicola	ARG(JUJ)
Adesmia argentea	CHL(ATA, COQ, VAL)
Adesmia argyrophylla	CHL(ATA, COQ)
Adesmia arillata	BRA(PAR, SCA)
Adesmia aromatica	CHL(COQ)
Adesmia aspera	ARG(MEN, NEU) / CHL(COQ, VAL, LBO, MAU, BIO, RME)
Adesmia atacamensis	CHL(TAR, ANT, ATA, COQ)
Adesmia aueri	ARG(RNE, SCR)
Adesmia aurantiaca	ARG(SCR) / CHL(MAG)
Adesmia australis	ARG(SCR)
Adesmia balsamica	CHL(VAL, BIO, RME)
Adesmia bedwellii	CHL(COQ, RME)
Adesmia bicolor	ARG(BAI, COR, COS, DFE, ERI, RNE, SLU, SFE, TUC) / BRA(RGS) / CHL(VAL, BIO, ARA, RME) / URY(ART, CAS, CLA, COL, FLO, FLA, LAV, MAL, MON, PAY, RNO, RIV, ROC, SAO, SOR, TAC)
Adesmia bijuga	CHL(MAU)
Adesmia boelckeana	ARG(NEU)
Adesmia bonariensis	ARG(BAI) / URY(LAV)
Adesmia boronioides	ARG(CHU, MEN, NEU, RNE, SCR, TDF) / CHL(AIS, MAG)
Adesmia brachysemeon	CHL(LBO, MAU, BIO, RME)
Adesmia bracteata	CHL(ATA, COQ, VAL)
Adesmia brevivexillata	CHL(VAL, BIO, ARA, RME)
Adesmia burkartii	ARG(SCR) / CHL(MAG)
Adesmia calycicomosa	CHL(COQ)
Adesmia candida var. candida	ARG(BAI, CHU, MEN, NEU, RNE, SCR)
Adesmia candida var. cabrerae	ARG(CHU, NEU, RNE)
Adesmia capitellata	ARG(LRI, MEN, NEU, SJU) / CHL(ATA, COQ, VAL, RME)
Adesmia ciliata	BRA(PAR, RGS, SCA)
Adesmia colinensis	CHL(COQ, RME)
Adesmia coluteoides	ARG(MEN, SAL)
Adesmia concinna	CHL(MAU, BIO, ARA)
Adesmia conferta	CHL(COQ, VAL, LBO, MAU, BIO, RME)
Adesmia confusa	CHL(COQ, VAL, LBO, RME)
Adesmia coquimbensis	CHL(COQ)
Adesmia cordobensis var. appendiculata	ARG(SLU)
Adesmia cordobensis var. cordobensis	ARG(CAT, COR, SAL)
Adesmia coronilloides	ARG(MEN) / CHL(MAU, RME)
Adesmia corymbosa var. sinepenna	ARG(SCR)
Adesmia corymbosa var. corymbosa	ARG(BAI, CHU, MEN, NEU, RNE, SCR) / CHL(VAL, LBO, MAU, ARA, AIS, MAG)
Adesmia crassicaulis	ARG(CAT, LRI, SJU)
Adesmia cuneata	CHL(LBO, RME)
Adesmia curvifolia	CHL(ATA, COQ)
Adesmia cytisoides	ARG(CAT, JUJ, LRI, SAL, SJU, TUC)
Adesmia darapskyana	CHL(VAL, RME)
Adesmia davilae	CHL(RME)
Adesmia denticulata	CHL(MAU, BIO, ARA)
Adesmia denudata	CHL(COQ)
Adesmia dessaueri	CHL(LBO)
Adesmia dichotoma	CHL(ATA, COQ)
Adesmia digitata	ARG(MEN, SJU)
Adesmia disperma	CHL(VAL)
Adesmia dumosa	CHL(RME)
Adesmia echinus	ARG(CAT, LRI, MEN, SJU) / CHL(ANT, ATA, COQ)
Adesmia elata	CHL(ATA, COQ)
Adesmia elegans	CHL(MAU)
Adesmia emarginata	ARG(NEU) / CHL(MAU, BIO, ARA, LLA, AIS)
Adesmia eremophila	CHL(ANT, ATA, COQ)
Adesmia erinacea	ARG(CAT, JUJ, LRI, SAL) / CHL(ANT, ATA)
Adesmia exilis	ARG(MEN) / CHL(COQ, VAL, LBO, MAU, RME)
Adesmia filicaulis	CHL(BIO, ARA)
Adesmia filifolia	CHL(ANT, ATA, COQ, VAL, LBO, RME)
Adesmia filipes	ARG(BAI, CAT, CHU, LPA, MEN, NEU, RNE, SJU, SCR)
Adesmia friesii	ARG(JUJ, SAL)
Adesmia frigida	CHL(ANT, ATA)
Adesmia fuentesii	CHL(COQ, VAL, RME)
Adesmia glandulifolia	ARG(MEN, NEU)
Adesmia glaucescens	CHL(BIO, ARA)
Adesmia globosa	ARG(ERI, MIS) / URY(ART, SAO)
Adesmia glomerula var. australior	ARG(MEN, NEU, RNE) / CHL(MAU, BIO)
Adesmia glomerula var. glomerula	ARG(MEN, NEU, RNE, SJU) / CHL(MAU, BIO, ARA, RME)
Adesmia glutinosa	CHL(ATA, COQ, VAL)
Adesmia godoyae	CHL(ATA, RME)
Adesmia gracilis	ARG(CHU, MEN, NEU, SCR) / CHL(COQ, MAU, RME)
Adesmia gracillima	CHL(ANT)
Adesmia graminidea	ARG(CHU, RNE, SCR)
Adesmia grandiflora	ARG(LPA, MEN, SJU)
Adesmia guttulifera	ARG(CHU, MEN, NEU, RNE, SCR)
Adesmia hemisphaerica	ARG(MEN) / CHL(RME)
Adesmia hirsuta	CHL(RME)
Adesmia horrida	ARG(CAT, JUJ, LRI, MEN, SAL, SJU, TUC) / CHL(TAR, ANT, COQ)
Adesmia hunzikeri	ARG(CAT, LRI, SJU)
Adesmia hystrix	CHL(ANT, ATA, COQ)
Adesmia incana var. oblata	URY(LAV, MAL, RIV, SOR, TYT)
Adesmia incana var. grisea	ARG(BAI, COR, COS, ERI, LPA, RNE, SFE) / URY(COL, FLA, MON, PAY, RNO, SAO, SJO)
Adesmia incana var. incana	ARG(BAI, CAT, COR, ERI, LPA, MIS, SAL, SLU) / BRA(RGS) / URY(CLA, COL, DUR, FLA, PAY, RNO, SAO, TAC)
Adesmia inflexa	ARG(CAT, JUJ, LRI, SAL, TUC)
Adesmia jilesiana	ARG(SJU) / CHL(COQ)
Adesmia karraikensis	ARG(SCR)
Adesmia lanata	ARG(CHU, NEU, RNE, SCR) / CHL(ARA, MAG)
Adesmia landbecki	CHL(VAL, LBO, MAU, BIO, ARA, RME)
Adesmia latifolia	ARG(BAI, COS, ERI) / BRA(RGS, SCA) / URY(CAS, CLA, COL, FLA, LAV, MAL, MON, RNO, RIV, ROC, SJO, SOR, TAC)
Adesmia laxa	CHL(COQ, RME)
Adesmia leiocarpa	CHL(ATA, COQ, VAL)
Adesmia leptobotrys	ARG(LPA, MEN, NEU, RNE)
Adesmia lihuelensis	ARG(LPA)
Adesmia littoralis	CHL(ATA, COQ)
Adesmia longipes	ARG(MEN, NEU, RNE) / CHL(LBO, MAU, BIO, ARA, LLA, RME)
Adesmia longiseta	CHL(COQ, LBO, BIO, ARA, RME)
Adesmia lotoides	ARG(CHU, NEU, RNE, SCR, TDF) / CHL(MAG)
Adesmia loudonia	CHL(COQ, VAL, RME)
Adesmia macrostachya	ARG(CAT, CHA, COR, COS, ERI, SLU, SFE)
Adesmia medinae	CHL(MAU, RME)
Adesmia melanocaulos	CHL(ANT, ATA)
Adesmia melanthes	CHL(TAR, ANT)
Adesmia mendozana	ARG(MEN)
Adesmia micrantha	CHL(ATA)
Adesmia microcalyx var. calvescens	CHL(BIO)
Adesmia microcalyx var. microcalyx	CHL(BIO, ARA)
Adesmia microphylla	CHL(COQ, VAL, RME)
Adesmia minor var. riojana	ARG(CAT, LRI, SAL)
Adesmia minor var. minor	ARG(MEN)
Adesmia minor var. caespitosa	ARG(CAT, JUJ, LRI, SAL, SJU) / CHL(ANT)
Adesmia miraflorensis	ARG(JUJ)
Adesmia monosperma	CHL(ATA, COQ)
Adesmia montana	CHL(COQ, RME)
Adesmia mucronata	CHL(COQ, VAL, LBO, MAU, BIO, RME)
Adesmia multicuspis	CHL(ATA, COQ)
Adesmia muricata var. muricata	ARG(BAI, CHU, COR, ERI, LPA, RNE, SFE, TUC) / BRA(RGS) / URY(CAS, MON, SJO, SOR)
Adesmia muricata var. affinis	ARG(BAI) / BRA(RGS) / URY(COL, FLA, MAL, MON, RIV, SJO, SOR, TAC)
Adesmia muricata var. gilliesii	ARG(BAI, COR, LPA, MEN, RNE, SFE, SLU)
Adesmia muricata var. rionegrensis	ARG(RNE)
Adesmia muricata var. dentata	ARG(BAI, CAT, CHA, COR, ERI, JUJ, LPA, LRI, SAL, SDE, SFE, SLU, TUC)
Adesmia nanolignea	ARG(CAT, LRI, SJU)
Adesmia neglecta	ARG(CHU)
Adesmia neuquenensis	ARG(NEU)
Adesmia obcordata	ARG(CHU, MEN, NEU, RNE, SCR) / CHL(LBO, RME)
Adesmia obovata	ARG(MEN, NEU, RNE) / CHL(LBO, MAU, BIO, RME)
Adesmia obscura	CHL(ATA, COQ)
Adesmia occulta	ARG(CAT, JUJ, LRI, MEN, SAL, TUC) / CHL(TAR, ANT)
Adesmia odontophylla	CHL(ATA)
Adesmia ovallensis	CHL(COQ)
Adesmia pampeana	ARG(BAI)
Adesmia papposa var. papposa	ARG(MEN, NEU) / CHL(COQ, VAL, LBO, MAU, BIO, ARA, RME)
Adesmia papposa var. radicifolia	ARG(NEU) / CHL(COQ, VAL, LBO, MAU, BIO, RME)
Adesmia paranensis	BRA(PAR, SCA)
Adesmia parviflora	CHL(ANT, ATA, COQ, VAL, LBO, RME)
Adesmia parvifolia	ARG(CHU, MEN, NEU, RNE, SCR) / CHL(MAU, BIO, ARA, LLA, AIS, MAG)
Adesmia patagonica	ARG(CHU, LPA, NEU, RNE, SCR)
Adesmia pauciflora	CHL(RME)
Adesmia pearcei	CHL(BIO)
Adesmia pedicellata	CHL(ATA, COQ)
Adesmia pentaphylla	ARG(MEN) / CHL(RME)
Adesmia peraltae	CHL(ATA, COQ)
Adesmia phylloidea	CHL(COQ, VAL, RME)
Adesmia pinifolia	ARG(MEN, NEU, SJU) / CHL(RME)
Adesmia pirionii	CHL(COQ, VAL)
Adesmia polyphylla	CHL(TAR, ANT)
Adesmia propinqua	CHL(BIO, ARA)
Adesmia prostrata var. prostrata	CHL(LBO, MAU)
Adesmia prostrata var. eglandulosa	CHL(COQ, LBO, MAU, RME)
Adesmia pseudogrisea	ARG(BAI)
Adesmia pseudoincana	ARG(CAT, LRI)
Adesmia psoraleoides	BRA(PAR, RGS, SCA)
Adesmia pumahuasiana	ARG(JUJ)
Adesmia pumila	ARG(SCR, TDF) / CHL(MAG)
Adesmia punctata var. hilariana	ARG(BAI, COR, COS, ERI, SFE) / BRA(RGS, SCA) / URY(ART, COL, MON, PAY, RNO, RIV, SAO, SJO, TAC)
Adesmia punctata var. sessiliflora	URY(PAY, SJO, SOR, TAC)
Adesmia punctata var. punctata	ARG(BAI, COR, COS, ERI, MIS, SFE) / BRA(RGS, SCA) / URY(CAS, CLA, COL, FLA, LAV, MAL, MON, RNO, RIV, SJO, SOR, TAC, TYT)
Adesmia pungens	CHL(ANT, ATA, COQ)
Adesmia pusilla	CHL(TAR, ANT, ATA)
Adesmia quadripinnata	ARG(CHU, MEN, NEU) / CHL(MAU)
Adesmia ragonesei	ARG(NEU)
Adesmia rahmeri	ARG(CAT, SAL) / CHL(ANT)
Adesmia ramosissima	CHL(COQ, LBO)
Adesmia reclinata	CHL(COQ)
Adesmia reitziana	BRA(SCA)
Adesmia renjifoana	ARG(MEN, NEU) / CHL(LBO)
Adesmia resinosa	CHL(VAL, RME)
Adesmia retrofracta	ARG(CAT, COR, LPA, LRI, MEN, NEU, RNE, SJU, SLU)
Adesmia retusa	ARG(CHU, NEU, RNE) / CHL(LLA)
Adesmia riograndensis	BRA(RGS)
Adesmia rocinhensis	BRA(PAR, RGS, SCA)
Adesmia rubroviridis	CHL(COQ)
Adesmia ruiz-lealii	ARG(SCR)
Adesmia salamancensis	ARG(CHU)
Adesmia salicornioides	ARG(SCR, TDF) / CHL(MAG)
Adesmia sandwithii	ARG(NEU)
Adesmia sanjuanensis	ARG(SJU)
Adesmia schickendanzii	ARG(CAT, JUJ, SAL, TUC)
Adesmia schneideri	ARG(CHU, MEN, NEU, SCR) / CHL(ATA, LBO, RME)
Adesmia securigerifolia	ARG(ERI) / BRA(RGS) / URY(CAS, CLA, DUR, FLA, LAV, PAY, SAO, TAC, TYT)
Adesmia serrana	ARG(CHU, RNE)
Adesmia sessilifolia	BRA(RGS)
Adesmia silvestrii	ARG(SCR)
Adesmia smithiae	ARG(BAI, CHU, MEN, RNE, SCR)
Adesmia spinosissima	ARG(JUJ, SAL) / CHL(TAR, ANT, ATA)
Adesmia spuma	ARG(CAT, LRI, SJU) / CHL(ATA, COQ)
Adesmia stenocaulon	ARG(MEN, SJU)
Adesmia subterranea	ARG(LRI, MEN, SJU) / CHL(ATA, COQ, VAL)
Adesmia suffocata	ARG(SCR)
Adesmia sulina	BRA(PAR, RGS, SCA)
Adesmia tehuelcha	ARG(CHU, SCR)
Adesmia tenella var. macrocarpa	CHL(ATA)
Adesmia tenella var. tenella	CHL(ANT, ATA, COQ, VAL, LBO, RME)
Adesmia tenella var. misera	CHL(ATA, COQ, VAL, LBO, RME)
Adesmia tomentosa	CHL(VAL, MAU)
Adesmia torcaea	CHL(COQ, VAL)
Adesmia trifoliata	CHL(VAL, RME)
Adesmia trifoliolata var. trifoliolata	ARG(MEN, NEU, RNE) / CHL(VAL, RME)
Adesmia trifoliolata var. epunctata	ARG(MEN, NEU, RNE)
Adesmia trijuga	ARG(CAT, CHU, JUJ, LPA, LRI, MEN, NEU, SAL, SCR, SJU, SLU, TUC)
Adesmia tristis	BRA(PAR, RGS, SCA)
Adesmia tunuianica	ARG(MEN)
Adesmia uspallatensis	ARG(CAT, LRI, MEN, SJU) / CHL(VAL, RME)
Adesmia vallsii	BRA(PAR, SCA)
Adesmia verrucosa	CHL(TAR)
Adesmia villosa	ARG(CHU, NEU, RNE, SCR) / CHL(MAG)
Adesmia viscida	CHL(COQ, VAL, LBO, MAU, BIO, ARA, RME)
Adesmia viscidissima	CHL(ANT)
Adesmia viscosa	CHL(LBO, ARA)
Adesmia volckmannii	ARG(CHU, MEN, NEU, RNE, SCR) / CHL(MAU, BIO, ARA, LLA, AIS, MAG)
Adesmia zoellneri	CHL(COQ, VAL)
Adiantopsis × australopedata	ARG(MIS)
Adiantopsis cheilanthoides	BRA(RGS)
Adiantopsis chlorophylla	ARG(BAI, CAT, CHA, COR, COS, ERI, FOR, JUJ, MIS, SAL, SFE, TUC) / BRA(PAR, RGS, SCA) / PRY(APA, AMA, CAU, CAA, CAN, CEN, COA, GUA, ITA, PAI, PHA, SPE) / URY(ART, CLA, COL, FLA, MAL, PAY, RNO, RIV, ROC, SAO, SOR, TAC)
Adiantopsis dichotoma	ARG(COS, MIS) / BRA(PAR, RGS) / PRY(APA, CEN, ITA, PAI) / URY(MAL, RIV)
Adiantopsis occulta	BRA(PAR, RGS, SCA)
Adiantopsis orbignyana	ARG(COS, MIS, SAL) / PRY(APY, PAI)
Adiantopsis perfasciculata	BRA(RGS, SCA)
Adiantopsis radiata	ARG(CHA, COS, FOR, MIS) / BRA(PAR, RGS, SCA) / PRY(APA, AMA, CAU, CAA, CAN, COA, GUA, ITA, PAI, SPE)
Adiantopsis recurvata	ARG(MIS) / PRY(PAI)
Adiantopsis tweediana	ARG(CHA, COR, COS, ERI, FOR, LRI, MIS, SLU, SFE, SDE) / BRA(Fuera del área del proyecto) / PRY(APY, CAU, CEN, COA, ÑEE, PAI) / URY(RNO)
Adiantum abscissum	BRA(PAR, SCA)
Adiantum camptorachis	ARG(CAT, COR, JUJ, LRI, SAL, TUC)
Adiantum capillus-veneris	BRA(RGS) / CHL(TAR, ATA, COQ, VAL, LBO, RME)
Adiantum chilense var. scabrum	ARG(NEU) / CHL(VAL, LBO, MAU, BIO, ARA, LLA, RME)
Adiantum chilense var. chilense	ARG(BAI, CAT, CHU, COR, LPA, LRI, MEN, NEU, RNE, SCR, SJU, SLU, TDF) / CHL(TAR, ATA, COQ, VAL, LBO, MAU, BIO, ARA, LLA, AIS, MAG, RME, JFE)
Adiantum curvatum	BRA(PAR, SCA)
Adiantum deflectens	ARG(MIS, SAL) / BRA(PAR) / PRY(AMA, COA, GUA, PAI, PHA)
Adiantum delicatulum	BRA(Fuera del área del proyecto) / PRY(APY, AMA, CEN, PAI)
Adiantum digitatum	ARG(JUJ, SAL, TUC) / BRA(PAR, RGS, SCA) / URY(ART, LAV, MAL, RNO, RIV, SAO, TAC)
Adiantum diogoanum	BRA(PAR)
Adiantum excisum	CHL(COQ, VAL, LBO, MAU, BIO, ARA, RME)
Adiantum gertrudis	CHL(COQ, VAL, RME)
Adiantum humile	BRA(PAR)
Adiantum incertum	BRA(PAR, SCA) / PRY(Desconocida)
Adiantum intermedium	BRA(SCA)
Adiantum latifolium	ARG(FOR, MIS) / BRA(PAR, SCA) / PRY(APY, APA, CAN, CEN, GUA)
Adiantum lorentzii	ARG(CAT, CHA, COR, COS, ERI, FOR, JUJ, MIS, SAL, SLU, TUC) / BRA(PAR, RGS, SCA) / PRY(CAA, CEN, COA, GUA, PAI, SPE)
Adiantum macrophyllum	ARG(MIS) / BRA(Fuera del área del proyecto)
Adiantum mathewsianum	BRA(PAR) / PRY(APY, CON)
Adiantum obliquum	BRA(PAR)
Adiantum orbignyanum	ARG(CAT, COR, JUJ, SAL, TUC)
Adiantum papillosum	BRA(PAR)
Adiantum pearcei	CHL(COQ, VAL, RME)
Adiantum pectinatum	ARG(JUJ, SAL) / BRA(PAR, SCA) / PRY(AMA)
Adiantum pentadactylon	BRA(PAR, RGS, SCA)
Adiantum peruvianum	ARG(SAL)
Adiantum petiolatum	BRA(SCA) / PRY(CAN)
Adiantum platyphyllum	BRA(Fuera del área del proyecto) / PRY(AMA)
Adiantum poiretii f. bottini	ARG(BAI, COR, LPA, MEN, SLU, TUC)
Adiantum poiretii	ARG(BAI, CAT, COR, JUJ, LPA, MEN, MIS, SAL, SJU, SLU, TUC) / BRA(RGS, SCA) / PRY(PAI) / URY(CAS, CLA, FLA, LAV, MAL, PAY, TAC, TYT)
Adiantum pseudotinctum	ARG(CHA, COS, JUJ, MIS, SAL) / BRA(PAR, RGS, SCA) / PRY(AMA, CAN, COA, GUA, MIE, PAI, SPE)
Adiantum pulverulentum	BRA(RGS) / PRY(AMA)
Adiantum raddianum	ARG(BAI, CAT, CHA, COR, COS, ERI, JUJ, LRI, MIS, SAL, SFE, SLU, TUC) / BRA(PAR, RGS, SCA) / PRY(APA, AMA, CAA, CAN, GUA, PAI) / URY(ART, CAS, CLA, DUR, FLA, MAL, PAY, SAO, TAC)
Adiantum serrato-dentatum	ARG(COS) / BRA(PAR) / PRY(AMA, CAN, CON, COA, PHA, SPE)
Adiantum sulphureum var. majus	CHL(COQ, VAL, LBO, MAU, BIO, ARA, RME)
Adiantum sulphureum	ARG(CHU, MEN, NEU, RNE, SCR) / CHL(COQ, VAL, LBO, MAU, BIO, ARA, LLA, AIS, RME)
Adiantum terminatum	BRA(PAR, SCA)
Adiantum tetraphyllum	ARG(MIS) / BRA(PAR) / PRY(APA, AMA, CAN, COA, GUA, PAI, SPE)
Adiantum thalictroides var. hirsutum	ARG(CAT, COR, JUJ, LRI, SAL, SJU, TUC) / CHL(ANT, COQ, VAL, LBO, MAU, BIO)
Adiantum windischii	BRA(Fuera del área del proyecto) / PRY(CAN)
Aechmea apocalyptica	BRA(SCA)
Aechmea bicolor	BRA(SCA)
Aechmea blumenavii var. alba	BRA(SCA)
Aechmea blumenavii var. blumenavii	BRA(SCA)
Aechmea bromeliifolia	ARG(COS, MIS) / BRA(PAR, RGS, SCA) / PRY(CAA, CEN, COA, GUA, ÑEE)
Aechmea calyculata var. calyculata	ARG(MIS) / BRA(RGS, SCA)
Aechmea calyculata var. variegata	BRA(RGS)
Aechmea candida	BRA(SCA)
Aechmea caudata	BRA(PAR, RGS, SCA)
Aechmea coelestis	BRA(PAR, SCA)
Aechmea cylindrata	BRA(PAR, RGS, SCA)
Aechmea dealbata	BRA(Fuera del área del proyecto) / PRY(AMA)
Aechmea distichantha var. glaziovii	BRA(PAR, RGS)
Aechmea distichantha f. albiflora	BRA(PAR, RGS)
Aechmea distichantha var. schlumbergeri	ARG(CHA, COS, FOR, JUJ, MIS, SAL, SFE, TUC) / BRA(Fuera del área del proyecto) / PRY(APY, CAN, CEN, CON, COA, GUA, ÑEE, PAI, PHA)
Aechmea distichantha f. distichantha	ARG(CHA, COS, FOR, JUJ, MIS, SAL, SFE, TUC) / BRA(PAR, RGS, SCA) / PRY(APY, APA, AMA, CAN, CEN, COA, GUA, PAI, PHA)
Aechmea gamosepala var. nivea	BRA(SCA)
Aechmea gamosepala var. gamosepala	BRA(PAR, RGS, SCA)
Aechmea gracilis	BRA(PAR)
Aechmea joannis var. alvipetala	BRA(RGS)
Aechmea joannis var. joannis	BRA(RGS)
Aechmea kertesziae var. kertesziae	BRA(SCA)
Aechmea kertesziae var. viridi-aurata	BRA(SCA)
Aechmea kleinii	BRA(SCA)
Aechmea leppardii	BRA(SCA)
Aechmea lindenii var. lindenii	BRA(RGS, SCA)
Aechmea lindenii var. makoyana	BRA(SCA)
Aechmea nudicaulis var. cuspidata	BRA(PAR, RGS, SCA)
Aechmea nudicaulis var. tabuleirensis	BRA(SCA)
Aechmea nudicaulis var. flavomarginata	BRA(SCA)
Aechmea organensis	BRA(PAR, RGS, SCA)
Aechmea ornata var. nationalis	BRA(SCA)
Aechmea ornata var. ornata	BRA(PAR, SCA)
Aechmea ornata var. hoehneana	BRA(PAR, SCA)
Aechmea pectinata	BRA(PAR, SCA)
Aechmea pimenti-velosoi var. pimenti-velosoi	BRA(SCA)
Aechmea pimenti-velosoi var. glabra	BRA(SCA)
Aechmea recurvata var. recurvata	ARG(COS, MIS) / BRA(PAR, RGS, SCA) / PRY(APA, CAN, GUA) / URY(CLA, RNO, TAC)
Aechmea recurvata var. ortgiesii	BRA(PAR, SCA)
Aechmea recurvata var. albobracteata	BRA(RGS)
Aechmea recurvata var. benrathii	BRA(SCA)
Aechmea rubroaristata	BRA(SCA)
Aechmea winkleri	BRA(RGS)
Aegiphila brachiata	ARG(COS, MIS) / BRA(PAR, RGS, SCA) / PRY(APY, APA, CAU, CAA, CAN, CEN, COA, GUA, ITA, MIE, PAI, SPE) / URY(CLA, RIV, TAC)
Aegiphila fluminensis	BRA(PAR)
Aegiphila integrifolia	BRA(PAR, RGS, SCA) / PRY(APA, CAN)
Aegiphila mediterranea	ARG(MIS) / BRA(PAR) / PRY(APA)
Aegiphila obducta	BRA(PAR, SCA)
Aegiphila riedeliana	BRA(RGS)
Aegiphila saltensis	ARG(SAL)
Aegiphila verticillata	BRA(PAR, SCA) / PRY(APY, APA, AMA, CAN, CEN, CON, COA, PAI, SPE)
Aegiphila vitelliniflora	ARG(CHA, COS, MIS) / BRA(PAR) / PRY(APY, AMA, CAU, CAN, CON, MIE, PHA, SPE)
Aeschynomene americana	ARG(CHA, COS, ERI, FOR, JUJ, SFE) / BRA(PAR) / PRY(CON, COA, GUA, PHA)
Aeschynomene brasiliana	BRA(PAR) / PRY(APY)
Aeschynomene denticulata	ARG(BAI, CHA, COR, COS, ERI, FOR, MIS, SAL, SFE, TUC) / BRA(PAR, RGS) / PRY(APY, BOQ, CHO, COA, GUA, ÑEE) / URY(ART, RNO, SAO)
Aeschynomene elegans	BRA(RGS, SCA)
Aeschynomene evenia	ARG(JUJ, SAL, TUC) / BRA(Fuera del área del proyecto)
Aeschynomene falcata var. hassleri	PRY(AMA, CON)
Aeschynomene falcata var. falcata	ARG(CHA, COS, FOR, MIS) / BRA(PAR, RGS, SCA) / PRY(CAU, CAN, CEN, CON, COA, GUA, PAI)
Aeschynomene fluminensis	BRA(PAR) / PRY(APY)
Aeschynomene fructipendula	BRA(RGS, SCA)
Aeschynomene histrix var. histrix	BRA(RGS) / PRY(CON, PAI, PHA)
Aeschynomene histrix var. apana	PRY(AMA)
Aeschynomene histrix var. densiflora	BRA(Fuera del área del proyecto) / PRY(AMA)
Aeschynomene histrix var. multijuga	ARG(MIS) / PRY(AMA, CAA, CAN, CON)
Aeschynomene histrix var. incana	ARG(COR, COS, ERI, MIS) / BRA(RGS) / PRY(APY, CON, COA) / URY(ART, COL, MON, RNO, SAO, SJO, SOR, TAC)
Aeschynomene indica	BRA(RGS)
Aeschynomene lorentziana	ARG(COS, ERI, MIS) / URY(ART, SAO)
Aeschynomene magna	PRY(CON)
Aeschynomene mollicula	BRA(Fuera del área del proyecto) / PRY(CON, PHA)
Aeschynomene montevidensis	ARG(BAI, CHA, COS, DFE, ERI, FOR, MIS, SFE) / BRA(PAR, RGS) / PRY(APA, AMA, CAN, CEN, CON, COA, GUA, ÑEE, PHA, SPE) / URY(ART, COL, PAY, RNO, SAO, SJO, SOR)
Aeschynomene paniculata	BRA(Fuera del área del proyecto) / PRY(APY, AMA, CON)
Aeschynomene paraguayensis	PRY(PAI)
Aeschynomene parviflora	ARG(FOR) / BRA(Fuera del área del proyecto) / PRY(APY, AMA, CEN, CON, PAI)
Aeschynomene pratensis var. caribaea	BRA(Fuera del área del proyecto) / PRY(SPE)
Aeschynomene rudis	ARG(BAI, CHA, COS, DFE, ERI, FOR, MIS, SFE) / BRA(RGS) / PRY(APY, AMA, CEN, PHA, SPE) / URY(SOR)
Aeschynomene selloi	BRA(PAR, RGS, SCA) / PRY(PAI)
Aeschynomene sensitiva	ARG(BAI, CHA, COS, ERI, MIS, SFE) / BRA(PAR, RGS, SCA) / PRY(APY, AMA, CEN, COA, GUA, ÑEE, PAI, PHA)
Aeschynomene viscidula	ARG(FOR) / BRA(Fuera del área del proyecto) / PRY(APY, PHA)
Aethionema saxatile	ARG(NEU, RNE)
Aextoxicon punctatum	ARG(CHU, RNE) / CHL(COQ, VAL, LBO, MAU, BIO, ARA, LLA)
Agalinis communis	ARG(BAI, COR, COS, ERI, FOR, MIS, RNE, SFE, SJU) / BRA(PAR, RGS, SCA) / PRY(APY, CAU, CAA, CEN, COA, GUA, ITA, PAI) / URY(ART, CAS, COL, DUR, LAV, MAL, MON, PAY, RNO, RIV, ROC, SAO, SJO, SOR, TAC, TYT)
Agalinis digitalis	URY(MAL)
Agalinis fiebrigii	ARG(CAT, JUJ, LRI, MIS, SAL, TUC)
Agalinis genistifolia	ARG(BAI, CAT, CHA, COR, COS, ERI, FOR, JUJ, MIS, SAL, SLU, SFE, SDE, TUC) / BRA(PAR, SCA) / PRY(AMA, CAA, CEN, CON, COA) / URY(COL, PAY, RNO, RIV, TAC)
Agalinis linarioides ssp. rojasii	PRY(AMA, CON)
Agalinis linarioides ssp. linarioides	BRA(PAR, RGS, SCA) / CHL(ATA, COQ) / URY(MAL, MON, RNO, SOR)
Agalinis meyeniana	CHL(ATA)
Agalinis ramulifera	BRA(PAR)
Agapanthus umbellatus	ARG(BAI)
Agarista boliviensis	ARG(JUJ, SAL)
Agarista chlorantha	BRA(PAR, RGS, SCA) / URY(RIV)
Agarista eucalyptoides	BRA(RGS, SCA) / URY(RIV)
Agarista minensis	BRA(RGS, SCA)
Agarista niederleinii var. acutifolia	BRA(PAR, RGS, SCA)
Agarista niederleinii var. niederleinii	BRA(PAR, RGS, SCA)
Agarista nummularia	BRA(RGS, SCA)
Agarista paraguayensis	ARG(MIS) / PRY(AMA, COA, PAI)
Agarista pulchella	BRA(PAR, SCA)
Agave americana	ARG(COR, LPA)
Agenium leptocladum	ARG(COS, MIS) / BRA(PAR, SCA) / PRY(COA, PAI)
Agenium majus	BRA(Fuera del área del proyecto) / PRY(APA)
Agenium villosum	ARG(COR, COS, ERI, MIS, SFE) / BRA(PAR, RGS, SCA) / PRY(AMA, CON, COA, GUA) / URY(CLA, COL, DUR, LAV, MAL, MON, PAY, RNO, RIV, SAO, SJO, SOR, TYT)
Ageratina azangaroensis	ARG(JUJ, SAL)
Ageratina lorentzii	ARG(CAT, JUJ, LRI, SAL, TUC)
Ageratina tenuis	ARG(JUJ, SAL)
Ageratum conyzoides	ARG(BAI, CAT, CHA, COR, COS, ERI, JUJ, MIS, SAL, SFE, TUC) / BRA(PAR, RGS, SCA) / PRY(AMA, CAA, CAN, CEN, COA, GUA, ITA) / URY(ART)
Agonandra brasiliensis	BRA(Fuera del área del proyecto) / PRY(AMA, CON, SPE)
Agonandra excelsa	ARG(CHA, COS, FOR, JUJ, MIS, SAL, TUC) / BRA(PAR, RGS, SCA) / PRY(APY, AMA, CEN, CON, COA)
Agoseris chilensis	CHL(COQ, VAL, LBO, RME)
Agoseris coronopifolia	ARG(CHU, MEN, NEU, RNE, SCR, TDF) / CHL(COQ, VAL, BIO, ARA, LLA, AIS, MAG, RME)
Agrimonia hirsuta	BRA(PAR, RGS, SCA)
Agrimonia parviflora	ARG(JUJ, MIS, SAL, TUC) / BRA(PAR, SCA)
Agrimonia villosa	ARG(MIS) / BRA(PAR, RGS, SCA)
Agropyron cristatum	CHL(MAG)
Agrostemma githago	ARG(BAI, ERI, SJU, TDF) / CHL(BIO, ARA) / URY(CAS, MON)
Agrostis ambatoensis	ARG(CAT)
Agrostis arvensis	CHL(BIO)
Agrostis brachyathera	ARG(TDF) / CHL(MAU, BIO, AIS, MAG)
Agrostis breviculmis	ARG(CAT, COR, SAL) / CHL(COQ, BIO, ARA, RME)
Agrostis capillaris	ARG(BAI, MEN, NEU, RNE, SCR, TDF) / BRA(RGS) / CHL(COQ, VAL, MAU, BIO, ARA, LLA, AIS, MAG)
Agrostis castellana	ARG(BAI, CHU, NEU, RNE, SCR, TDF) / CHL(BIO, ARA, LLA, AIS, MAG, RME)
Agrostis gigantea	ARG(BAI, CAT, CHU, COR, ERI, LPA, MEN, NEU, RNE, SJU, SCR, TDF, TUC) / BRA(RGS) / CHL(COQ, VAL, LBO, BIO, ARA, LLA, AIS, MAG, RME) / URY(FLA, MON, SOR)
Agrostis glabra var. glabra	ARG(CHU, MEN, NEU, RNE, SJU, SLU, SCR, TDF) / CHL(COQ, LBO, MAU, BIO, ARA, MAG, RME)
Agrostis glabra var. melanthes	ARG(CHU, NEU, RNE) / CHL(BIO, ARA, LLA, AIS)
Agrostis idahoensis	ARG(CHU) / CHL(MAU, BIO, LLA, MAG)
Agrostis imberbis	ARG(CHU, COR, MEN, NEU, RNE, SLU, SCR) / CHL(COQ, LBO, MAU, BIO, LLA, MAG, RME)
Agrostis inconspicua	ARG(CAT, CHU, JUJ, LRI, NEU, RNE, SCR, TDF, TUC) / CHL(VAL, LBO, MAU, BIO, ARA, LLA, AIS, MAG, RME)
Agrostis insularis	CHL(LLA)
Agrostis lenis	ARG(TUC) / BRA(RGS, SCA) / URY(RIV)
Agrostis leptotricha	ARG(CHU, NEU, RNE, SCR) / CHL(VAL, MAU, BIO, ARA, LLA, AIS, MAG, RME)
Agrostis longiberbis	BRA(PAR, RGS)
Agrostis masafuerana	CHL(JFE)
Agrostis mertensii	ARG(CHU, NEU, SAL, SCR) / CHL(LBO, MAU, BIO, LLA, AIS, MAG)
Agrostis meyenii	ARG(CAT, CHU, JUJ, LRI, MEN, NEU, RNE, SAL, SJU, SCR, TDF, TUC) / CHL(COQ, VAL, LBO, MAU, BIO, ARA, LLA, MAG)
Agrostis montevidensis f. montevidensis	ARG(BAI, CAT, CHA, COR, COS, ERI, JUJ, LPA, LRI, MIS, SAL, SLU, SFE, TUC) / BRA(PAR, RGS, SCA) / PRY(COA, GUA) / URY(ART, CAS, CLA, FLO, FLA, LAV, MAL, MON, PAY, RNO, RIV, ROC, SAO, SOR, TAC, TYT)
Agrostis montevidensis f. submutica	ARG(CAT, JUJ, MIS, SAL, TUC) / BRA(PAR, RGS, SCA) / CHL(ARA) / PRY(COA, GUA)
Agrostis nebulosa	ARG(BAI)
Agrostis perennans	ARG(CAT, CHU, COR, JUJ, MEN, NEU, RNE, SAL, SJU, SCR, TDF, TUC) / CHL(BIO, ARA, LLA, MAG)
Agrostis philippiana	ARG(CHU, NEU, RNE, SCR) / CHL(BIO, LLA, AIS, MAG)
Agrostis platensis	ARG(BAI, DFE) / BRA(RGS)
Agrostis reuteri	ARG(BAI)
Agrostis scabra	ARG(CHU, NEU, RNE) / CHL(ARA)
Agrostis serranoi	ARG(CHU, NEU, RNE, SCR, TDF) / CHL(VAL, ARA, LLA, AIS, MAG)
Agrostis stolonifera var. palustris	ARG(BAI, DFE, NEU, RNE, SCR, TDF) / CHL(ANT, VAL, MAU, BIO, ARA, LLA, AIS, MAG) / URY(CAS, MON)
Agrostis stolonifera var. stolonifera	ARG(BAI, CHU, LPA, MEN, NEU, RNE, TDF) / CHL(TAR, COQ, VAL, MAU, BIO, ARA, LLA, AIS, MAG, JFE, IPA)
Agrostis tolucensis	ARG(CAT, COR, JUJ, SAL, TUC) / CHL(TAR)
Agrostis uliginosa	ARG(CHU, NEU, RNE, SCR, TDF) / CHL(BIO, ARA, LLA, AIS, MAG)
Agrostis umbellata	CHL(VAL, LBO, MAU, BIO, ARA, RME)
Agrostis vidalii	ARG(CHU, NEU, RNE) / CHL(LLA, AIS)
Agrostis vinealis	ARG(CHU) / CHL(COQ)
Ailanthus altissima	ARG(BAI, DFE, ERI, LPA, SAL, TUC) / CHL(RME) / URY(MON)
Aimara rollinsii	CHL(TAR, ANT)
Aiouea acarodomatifera	BRA(SCA)
Aiouea saligna	BRA(PAR, RGS, SCA)
Aiouea trinervis	BRA(RGS) / PRY(APY, AMA, CAN, CON, SPE)
Aira caryophyllea	ARG(BAI, CHU, COR, NEU, RNE, SCR, TDF, TUC) / CHL(ANT, COQ, VAL, LBO, MAU, BIO, ARA, LLA, AIS, MAG, RME, JFE) / URY(FLA, LAV, MAL, MON, ROC, SJO)
Aira cupaniana	URY(LAV, MAL, MON)
Aira elegantissima	ARG(BAI, TUC) / BRA(RGS) / CHL(VAL, ARA) / URY(CLA, DUR, FLA, LAV, MAL, PAY, RIV, SJO)
Aira praecox	ARG(SCR, TDF) / CHL(LLA, MAG, JFE) / URY(LAV, MON, SJO)
Airampoa ayrampo	ARG(CAT, JUJ, SAL) / CHL(TAR, ANT)
Alansmia reclinata	BRA(PAR, RGS, SCA)
Alatiglossum chrysopteranthum	BRA(PAR)
Alatiglossum ciliatum	BRA(PAR, RGS, SCA)
Alatiglossum emilii	PRY(Desconocida)
Alatiglossum herzogii	ARG(CAT, JUJ, SAL, TUC)
Alatiglossum macropetalum	BRA(SCA) / PRY(APY)
Alatiglossum micropogon	BRA(RGS, SCA)
Albizia burkartiana	BRA(PAR, SCA)
Albizia edwallii	ARG(MIS) / BRA(PAR, RGS, SCA)
Albizia inundata	ARG(BAI, CHA, COS, ERI, FOR, JUJ, MIS, SAL, SFE) / BRA(RGS) / PRY(APY, CAA, CEN, CON, COA, PHA) / URY(ART, PAY, RNO, SAO, SOR)
Albizia julibrissin	ARG(COR, SFE)
Albizia lophantha	CHL(VAL, JFE)
Albizia niopoides	ARG(COS, MIS) / BRA(PAR, RGS, SCA) / PRY(APA, AMA, CAN, CEN, COA, PAI)
Alcea rosea	ARG(SJU)
Alchornea castaneifolia	ARG(FOR) / BRA(Fuera del área del proyecto) / PRY(APY, CON, COA)
Alchornea glandulosa ssp. iricurana	ARG(MIS) / BRA(PAR, SCA) / PRY(APA, CAU, CAN, COA, ITA, PAI)
Alchornea sidifolia	ARG(MIS) / BRA(PAR, RGS, SCA)
Alchornea triplinervia	ARG(COS, MIS) / BRA(PAR, RGS, SCA) / PRY(CAA, CAN, CEN, COA, PAI)
Aldama adenotricha	CHL(COQ)
Aldama amphichlora	PRY(CAN)
Aldama anchusifolia var. anchusifolia	ARG(BAI, COS, ERI, MIS) / BRA(RGS, SCA) / URY(ROC)
Aldama anchusifolia var. imarginata	ARG(BAI, COS, ERI) / BRA(PAR, RGS, SCA) / URY(MON, PAY, SJO, TAC)
Aldama aspilioides	BRA(PAR)
Aldama atacamensis	CHL(TAR, ANT)
Aldama breviflosculosa	URY(CLA, FLA, LAV, MAL, RIV, TAC, TYT)
Aldama densifolia	PRY(CAU)
Aldama fabrisii	ARG(COS)
Aldama filifolia	PRY(AMA)
Aldama gilliesii	ARG(MEN, SJU)
Aldama helianthoides	ARG(JUJ, SAL) / CHL(TAR)
Aldama knobiana	BRA(RGS)
Aldama linearifolia	PRY(AMA, CAU, CAN, CEN, CON, PAI, SPE)
Aldama macrorhiza	BRA(PAR) / PRY(CAU, CAN)
Aldama megapotamica	BRA(RGS, SCA)
Aldama meridionalis	BRA(RGS)
Aldama misionensis	ARG(MIS)
Aldama mollis	ARG(JUJ, SAL, TUC)
Aldama nudicaulis	BRA(RGS) / URY(CLA, LAV, MAL, TAC, TYT)
Aldama paranensis	BRA(PAR)
Aldama pilicaulis	PRY(AMA)
Aldama pilosa	ARG(COS, MIS) / BRA(PAR, RGS, SCA) / PRY(GUA)
Aldama revoluta	ARG(MEN, NEU) / CHL(ATA, COQ, LBO, MAU, BIO, RME)
Aldama robusta	BRA(PAR)
Aldama santacatarinensis	BRA(RGS, SCA)
Aldama subdentata	BRA(SCA)
Aldama tuberosa var. guaranitica	ARG(CHA, COS, FOR, MIS, SDE) / BRA(PAR, RGS, SCA) / PRY(CAN, COA, SPE)
Aldama tuberosa var. tuberosa	ARG(CHA, COS, ERI, FOR, SFE, SDE) / BRA(RGS) / PRY(CAN, CON, ITA, PHA) / URY(ART, PAY, RNO, RIV)
Aldama tucumanensis	ARG(CAT, COR, JUJ, LRI, SAL, SDE, TUC)
Aleurites moluccanus	ARG(COS, MIS)
Alibertia latifolia	PRY(CON)
Alicia anisopetala	ARG(COS, MIS) / BRA(PAR) / PRY(CAU, CAA, CAN, CEN, CON, COA, GUA, ITA, PAI, SPE)
Alisma lanceolatum	CHL(VAL, LBO, MAU, BIO, ARA, LLA, RME)
Alisma plantago-aquatica	ARG(RNE) / CHL(VAL, MAU, BIO, ARA, LLA, RME)
Allagoptera campestris	ARG(COS, MIS) / BRA(PAR) / PRY(AMA, CAN, COA, SPE)
Allagoptera leucocalyx	ARG(MIS) / BRA(PAR) / PRY(APY, AMA, CAN, CON, COA, PAI)
Allamanda cathartica	BRA(PAR)
Allamanda schottii	BRA(PAR, SCA)
Allenrolfea patagonica	ARG(BAI, CAT, CHA, COR, LPA, LRI, MEN, SAL, SDE, SFE, SJU, SLU)
Allenrolfea vaginata	ARG(CAT, CHA, COR, LPA, LRI, MEN, NEU, SAL, SJU, SLU, SFE, SDE, TUC)
Alliaria petiolata	ARG(NEU, RNE)
Allionia choisyi	ARG(CAT, COR, JUJ, LRI, MEN, SAL, SJU, SLU, TUC)
Allionia incarnata	ARG(CAT, COR, JUJ, LPA, LRI, MEN, NEU, SAL, SDE, SJU, SLU, TUC) / CHL(TAR, ANT, ATA) / URY(PAY)
Allium ampeloprasum	ARG(BAI, CAT, ERI, LRI)
Allium cepa	ARG(BAI, COS, JUJ, SAL)
Allium commutatum	ARG(BAI, CAT)
Allium porrum	ARG(BAI)
Allium schoenoprasum	ARG(TDF)
Allium triquetrum	ARG(BAI, LPA)
Allium vineale var. compactum	ARG(BAI) / CHL(ARA)
Allophylus edulis	ARG(BAI, CAT, CHA, COS, ERI, FOR, JUJ, MIS, SAL, SDE, SFE, TUC) / BRA(PAR, RGS, SCA) / PRY(APY, APA, AMA, CAU, CAA, CAN, CEN, CON, COA, GUA, MIE, PAI, PHA, SPE) / URY(DUR, LAV, MAL, PAY, RIV, ROC, SAO, TAC, TYT)
Allophylus guaraniticus	ARG(COS, FOR, MIS) / BRA(PAR, RGS, SCA) / PRY(APA, AMA, CAA, CAN, CEN, GUA, ITA) / URY(ART, RIV, ROC)
Allophylus pauciflorus	ARG(FOR, JUJ, SAL, TUC) / BRA(PAR) / PRY(CON)
Allophylus petiolulatus	BRA(PAR, SCA)
Allophylus puberulus	BRA(PAR)
Allophylus semidentatus	BRA(PAR)
Alnus acuminata	ARG(CAT, JUJ, SAL, TUC)
Alnus glutinosa	ARG(NEU, RNE) / CHL(COQ, BIO, LLA, RME)
Alocasia macrorrhizos	PRY(ITA)
Alonsoa honoraria	CHL(COQ)
Alonsoa meridionalis	CHL(COQ, VAL, LBO, MAU, BIO, RME)
Alopecurus aequalis	ARG(CHU, NEU, SCR, TDF)
Alopecurus bonariensis	ARG(BAI, CHU, DFE, ERI, LPA, SFE) / URY(CAS)
Alopecurus geniculatus var. geniculatus	ARG(BAI, CHU, RNE, SCR, TDF) / CHL(MAG)
Alopecurus geniculatus var. patagonicus	ARG(CHU, SCR, TDF) / CHL(MAG)
Alopecurus heleochloides	CHL(COQ, MAG, RME)
Alopecurus hitchcockii	ARG(JUJ)
Alopecurus lechleri	CHL(LLA)
Alopecurus magellanicus var. bracteatus	ARG(CHU, MEN, NEU, RNE, SCR, TDF) / CHL(BIO, LLA, AIS, MAG)
Alopecurus magellanicus var. magellanicus	ARG(CHU, MEN, NEU, RNE, SCR, TDF) / CHL(MAU, BIO, ARA, LLA, AIS, MAG)
Alopecurus myosuroides	ARG(BAI, DFE, RNE) / CHL(MAG)
Alopecurus pratensis	ARG(NEU, RNE, TDF) / CHL(LLA, AIS, MAG)
Aloysia brasiliensis	BRA(PAR, RGS, SCA)
Aloysia castellanosii	ARG(CAT, LRI, SAL, SJU, TUC)
Aloysia catamarcensis	ARG(CAT, LRI, SAL, SDE)
Aloysia chamaedryfolia	ARG(MIS) / BRA(RGS) / URY(ART, RIV, TAC, TYT)
Aloysia citrodora	ARG(CAT, JUJ, LRI, SAL, SJU, TUC) / PRY(CEN, COA)
Aloysia cordata	BRA(PAR)
Aloysia crenata	ARG(COS) / BRA(PAR) / PRY(APA, CAA)
Aloysia decipiens	ARG(BAI, CAT, CHA, COR, COS, ERI, FOR, LPA, LRI, SAL, SLU, SFE, SDE, TUC)
Aloysia deserticola	ARG(CAT, JUJ, SAL, SJU) / CHL(TAR, ANT)
Aloysia dusenii	BRA(PAR, RGS, SCA)
Aloysia fiebrigii	ARG(JUJ, SAL)
Aloysia gratissima var. gratissima	ARG(BAI, CAT, CHA, COR, COS, ERI, FOR, JUJ, LPA, LRI, MEN, MIS, SAL, SJU, SLU, SFE, SDE, TUC) / BRA(RGS) / CHL(VAL) / PRY(APY, AMA, CAA, CEN, COA, GUA, ITA, ÑEE, PAI, PHA, SPE) / URY(DUR, MAL, PAY, RIV, SAO, TAC, TYT)
Aloysia gratissima var. sellowii	ARG(COS, MIS, SAL) / BRA(PAR, RGS, SCA) / PRY(APA, GUA, ITA, PAI) / URY(ART, RIV, TAC)
Aloysia hatschbachii	BRA(PAR)
Aloysia oblanceolata	BRA(PAR, RGS) / PRY(APY, CEN, COA, ITA)
Aloysia ovatifolia	ARG(CAT, COR, LRI, MEN, SAL, SJU, SLU, SDE, TUC)
Aloysia polygalifolia	BRA(PAR, RGS, SCA)
Aloysia polystachya	ARG(CAT, COR, COS, ERI, FOR, LRI, SAL, SJU, SDE) / PRY(CEN, PHA)
Aloysia riojana	ARG(LRI, SJU)
Aloysia salsoloides	ARG(CAT, JUJ, LRI, SAL)
Aloysia salviifolia	ARG(MEN) / CHL(ATA, COQ)
Aloysia schulziana	ARG(CAT, CHA, COR, COS, FOR, JUJ, LRI, MIS, SAL, SJU, SFE, SDE, TUC) / PRY(APY, PHA)
Aloysia scorodonioides var. scorodonioides	ARG(JUJ, SAL, TUC) / PRY(APY, BOQ)
Aloysia scorodonioides var. mathewsii	ARG(CHA, JUJ, LRI, SAL)
Aloysia tarapacana	CHL(TAR)
Aloysia trifida	ARG(LRI, SJU) / CHL(TAR, ANT, ATA, COQ)
Aloysia virgata var. virgata	ARG(CAT, CHA, COS, FOR, JUJ, MIS, SAL, TUC) / BRA(PAR, RGS, SCA) / PRY(APA, APY, AMA, BOQ, CAU, CAN, CEN, COA, GUA, ITA, MIE, ÑEE, PAI, PHA, SPE)
Aloysia virgata var. platyphylla	ARG(CHA, COS, ERI, FOR, JUJ, MIS, SAL, SDE, TUC) / PRY(APA, APY, AMA, CAU, CEN, CON, COA, GUA, ITA, MIE, ÑEE, PAI, PHA, SPE)
Alseis floribunda	BRA(PAR, SCA)
Alshehbazia hauthalii	ARG(SCR) / CHL(MAG)
Alsophila capensis ssp. polypodioides	BRA(PAR, RGS, SCA)
Alsophila cuspidata	BRA(Fuera del área del proyecto) / PRY(CAA, CAN, COA)
Alsophila elata	ARG(SAL)
Alsophila odonelliana	ARG(JUJ, SAL)
Alsophila setosa	ARG(MIS) / BRA(PAR, RGS, SCA) / PRY(APA, AMA, CAU, CAA, COA, PAI, SPE)
Alsophila sternbergii	BRA(PAR, SCA) / PRY(CAA, CAN, COA, PAI)
Alstroemeria achirae	CHL(MAU)
Alstroemeria albescens	BRA(RGS)
Alstroemeria amabilis	BRA(PAR, SCA)
Alstroemeria andina var. andina	CHL(ATA, COQ)
Alstroemeria andina var. venustula	ARG(SJU) / CHL(ATA, COQ)
Alstroemeria angustifolia var. angustifolia	CHL(ATA, COQ, VAL, LBO, RME)
Alstroemeria angustifolia var. velutina	CHL(COQ, VAL, RME)
Alstroemeria apertiflora	ARG(MIS) / BRA(PAR, RGS, SCA) / PRY(AMA, CAU, CAN, PAI)
Alstroemeria aurea	ARG(CHU, NEU, RNE) / CHL(MAU, BIO, ARA, LLA, AIS)
Alstroemeria bakeri	ARG(CAT)
Alstroemeria citrina	CHL(COQ, VAL)
Alstroemeria crispata	CHL(ATA, COQ)
Alstroemeria cummingiana	CHL(VAL)
Alstroemeria cunha	BRA(PAR)
Alstroemeria diluta ssp. chrysantha	CHL(ATA, COQ, VAL)
Alstroemeria diluta ssp. diluta	CHL(LBO, MAU)
Alstroemeria exerens	CHL(LBO, MAU, RME)
Alstroemeria garaventae	CHL(VAL, RME)
Alstroemeria graminea	CHL(ANT, ATA)
Alstroemeria hookeri ssp. recumbens	CHL(COQ, VAL)
Alstroemeria hookeri ssp. sansebastiana	CHL(BIO)
Alstroemeria hookeri ssp. hookeri	CHL(VAL, MAU, BIO)
Alstroemeria hookeri ssp. maculata	CHL(COQ)
Alstroemeria inodora	BRA(PAR, RGS, SCA)
Alstroemeria isabellana	ARG(COS, MIS) / BRA(PAR, RGS, SCA) / PRY(PAI) / URY(TYT)
Alstroemeria kingii	CHL(ATA)
Alstroemeria leporina	CHL(ATA, COQ)
Alstroemeria ligtu ssp. ligtu	CHL(MAU, BIO, ARA, RME)
Alstroemeria ligtu ssp. splendens	CHL(LBO, MAU, RME)
Alstroemeria ligtu ssp. simsii	CHL(VAL, LBO, MAU, BIO, RME)
Alstroemeria lutea	CHL(TAR)
Alstroemeria magnifica ssp. magenta	CHL(COQ, VAL)
Alstroemeria magnifica var. tofoensis	CHL(COQ)
Alstroemeria magnifica var. sierrae	CHL(COQ)
Alstroemeria magnifica ssp. magnifica	CHL(COQ)
Alstroemeria malmeana	BRA(PAR, SCA)
Alstroemeria mollensis	CHL(COQ)
Alstroemeria monantha	CHL(VAL)
Alstroemeria pallida	CHL(VAL, RME)
Alstroemeria parvula	CHL(VAL, RME)
Alstroemeria patagonica	ARG(CHU, NEU, RNE, SCR, TDF) / CHL(AIS, MAG)
Alstroemeria pelegrina	CHL(COQ, VAL)
Alstroemeria philippii var. albicans	CHL(ATA)
Alstroemeria philippii var. philippii	CHL(ATA, COQ)
Alstroemeria polyphylla	CHL(ATA)
Alstroemeria presliana ssp. australis	CHL(BIO, ARA)
Alstroemeria presliana ssp. presliana	ARG(NEU) / CHL(MAU, BIO)
Alstroemeria pseudospathulata	ARG(MEN, NEU, RNE) / CHL(MAU)
Alstroemeria psittacina	ARG(BAI, CAT, COR, COS, DFE, ERI, LPA, MIS, SAL, SFE, TUC) / BRA(PAR, RGS) / PRY(APA, CAU, CAN, GUA) / URY(CAS, MON)
Alstroemeria pulchra var. maxima	CHL(COQ, VAL, RME)
Alstroemeria pulchra ssp. pulchra	CHL(COQ, VAL, LBO, MAU, RME)
Alstroemeria pulchra ssp. lavandulacea	CHL(BIO, ARA)
Alstroemeria pygmaea	ARG(CAT, JUJ, SAL, TUC)
Alstroemeria revoluta	CHL(VAL, LBO, MAU, BIO, ARA, RME)
Alstroemeria ribeirensis	BRA(PAR)
Alstroemeria schizanthoides var. schizanthoides	CHL(ATA, COQ)
Alstroemeria schizanthoides var. alba	CHL(COQ)
Alstroemeria sellowiana	BRA(PAR, RGS, SCA)
Alstroemeria spathulata	CHL(COQ, VAL, LBO, RME)
Alstroemeria umbellata	CHL(LBO, RME)
Alstroemeria versicolor	CHL(LBO, MAU, BIO, RME)
Alstroemeria violacea	CHL(TAR, ATA)
Alstroemeria werdermannii var. flavicans	CHL(ATA, COQ)
Alstroemeria werdermannii var. werdermannii	CHL(ATA, COQ)
Alstroemeria zoellneri	CHL(VAL, RME)
Alternanthera albida	ARG(CAT, CHA, COR, JUJ, SAL, SDE, SLU, TUC) / PRY(APY)
Alternanthera altacruzensis	ARG(JUJ)
Alternanthera aquatica	ARG(CHA) / PRY(APY, CEN, CON, COA, PHA)
Alternanthera brasiliana var. villosa	ARG(COS, MIS) / BRA(SCA) / PRY(APA, CAN, SPE)
Alternanthera brasiliana var. brasiliana	BRA(SCA) / PRY(APY, CEN)
Alternanthera cana	ARG(SJU)
Alternanthera caracasana	ARG(BAI, COR, JUJ, SAL, SFE)
Alternanthera cinerella	ARG(CAT, JUJ, SAL, TUC)
Alternanthera collina	ARG(SDE)
Alternanthera ficoidea	ARG(MIS) / BRA(PAR) / PRY(APY, AMA, CEN, PHA)
Alternanthera flavescens	BRA(SCA)
Alternanthera halimifolia	CHL(TAR)
Alternanthera hirtula var. hirsuta	PRY(APA, CAN)
Alternanthera hirtula var. hirtula	ARG(COS) / BRA(PAR, RGS) / PRY(APA, AMA, CAU, CAN, CEN, COA, ITA, MIE, PAI, PHA) / URY(Desconocida)
Alternanthera hirtula var. nitens	PRY(AMA, CAN)
Alternanthera inaccessa	PRY(APY)
Alternanthera kurtzii ssp. sclerosperma	PRY(APY, CEN)
Alternanthera kurtzii ssp. kurtzii	ARG(BAI, CAT, CHA, COS, ERI, FOR, JUJ, MIS, SAL, SFE, TUC) / BRA(Fuera del área del proyecto) / PRY(APY, AMA, BOQ, CEN, CON, COA, PAI, PHA) / URY(ART, COL, PAY, RNO)
Alternanthera lanceolata	ARG(JUJ, SAL)
Alternanthera malmeana var. straminea	ARG(MIS) / PRY(APA, CAU, CAA, CAN, GUA, ITA, SPE)
Alternanthera malmeana var. malmeana	ARG(MIS) / BRA(RGS) / PRY(CAU, CAA)
Alternanthera maritima	BRA(SCA)
Alternanthera meyeriana	ARG(JUJ, SAL, TUC)
Alternanthera micrantha	ARG(MIS) / BRA(PAR, RGS, SCA) / PRY(APA, GUA)
Alternanthera microphylla var. microphylla	ARG(JUJ)
Alternanthera microphylla var. maior	ARG(JUJ)
Alternanthera nodifera	ARG(CAT, COR, LRI, MEN, SAL, SDE, SJU, SLU, TUC) / PRY(APY, PHA)
Alternanthera paronychioides ssp. chacoensis	ARG(BAI, CAT, CHA, COS, DFE, ERI, FOR, JUJ, MIS, SAL, SDE, SFE, TUC) / BRA(Fuera del área del proyecto) / PRY(APY, AMA, BOQ, CAU, CEN, CON, COA, GUA, MIE, ÑEE, PAI, PHA, SPE)
Alternanthera paronychioides f. aberrans	ARG(BAI, COS, ERI, MIS) / URY(MON)
Alternanthera paronychioides ssp. paronychioides	ARG(BAI, CHA, COS, ERI, SFE) / BRA(RGS, SCA) / PRY(CEN)
Alternanthera paronychioides ssp. pilosa	ARG(BAI, COS, ERI, FOR, MIS, SFE) / BRA(RGS) / PRY(APA, ITA) / URY(DUR, MON, SAO, SJO)
Alternanthera pennelliana	PRY(APY, PHA)
Alternanthera philoxeroides f. angustifolia	ARG(CHA, COS, ERI, FOR, MIS, SFE) / PRY(CEN, COA, MIE, ÑEE, PAI, PHA)
Alternanthera philoxeroides f. philoxeroides	ARG(BAI, CHA, COS, ERI, FOR, JUJ, SAL, SDE, SFE, SJU, TUC) / BRA(RGS, SCA) / CHL(VAL) / PRY(APY) / URY(MON)
Alternanthera piptantha	PRY(APY)
Alternanthera porrigens	CHL(TAR, ANT, ATA, VAL)
Alternanthera praelonga var. australis	BRA(RGS, SCA)
Alternanthera puberula	ARG(COS, MIS) / BRA(Fuera del área del proyecto) / PRY(APA, APY)
Alternanthera pumila	ARG(COR)
Alternanthera pungens	ARG(BAI, CAT, CHA, COR, COS, ERI, FOR, JUJ, LRI, MIS, SAL, SDE, SFE, SJU, SLU, TUC) / BRA(PAR) / PRY(APA, APY, CEN, COA, GUA, PHA) / URY(MON)
Alternanthera reineckii	ARG(BAI, CHA, COS, ERI, FOR, MIS, SAL, SFE) / BRA(PAR, RGS, SCA) / PRY(AMA, CEN, COA, ITA, MIE, ÑEE, PAI, SPE) / URY(ART, PAY, RIV, SAO, TYT)
Alternanthera rufa	ARG(MIS) / BRA(PAR)
Alternanthera scandens	ARG(JUJ, SAL) / PRY(CAU, CAN)
Alternanthera serpens	PRY(APY)
Alternanthera sessilis	BRA(SCA) / PRY(APY)
Alternanthera suessenguthii	ARG(COR, RNE, SLU)
Alvaradoa subovata	ARG(JUJ, SAL, TUC)
Alyssum alyssoides	ARG(BAI, CHU, LPA, MEN, NEU, RNE, SCR) / CHL(BIO, MAG, RME)
Amaioua guianensis	BRA(PAR, SCA)
Amaranthus albus	ARG(BAI, COR, DFE, LPA, RNE, SLU) / URY(ART, DUR, MON, PAY, RNO, SAO)
Amaranthus asplundii var. australis	ARG(JUJ, SAL, TUC)
Amaranthus asplundii var. asplundii	ARG(JUJ, SJU) / CHL(LLA)
Amaranthus blitoides	ARG(LPA, RNE, TUC)
Amaranthus blitum	ARG(BAI, CHA, COS, FOR, SAL, SFE, TUC) / BRA(RGS) / PRY(CEN, COA, MIE, PAI) / URY(SJO)
Amaranthus bouchonii	ARG(NEU)
Amaranthus cardenasianus	ARG(SAL)
Amaranthus celosioides	ARG(BAI, SAL)
Amaranthus crispus	ARG(BAI, LPA, MEN, RNE, SLU) / URY(MON)
Amaranthus deflexus	ARG(BAI, CHU, COR, ERI, LPA, MEN, NEU, RNE, SJU) / CHL(ANT, ATA, COQ, VAL, LBO, MAU, BIO, ARA, LLA, AIS, MAG, IDE, JFE) / URY(MON)
Amaranthus dubius	ARG(DFE)
Amaranthus emarginatus	CHL(ANT)
Amaranthus hunzikeri	ARG(CAT, JUJ)
Amaranthus hybridus ssp. cruentus	ARG(MIS) / BRA(SCA) / CHL(MAU, BIO, RME) / PRY(APA, AMA, CAN, CEN, GUA, PAI)
Amaranthus hybridus ssp. hybridus	ARG(BAI, CAT, CHU, COR, COS, ERI, FOR, JUJ, LRI, MEN, MIS, NEU, SAL, SJU, SFE, SDE, TUC) / BRA(SCA) / CHL(TAR, ANT, COQ, VAL, LBO, MAU, BIO, ARA, LLA, RME, JFE) / PRY(APA, APY, AMA, CON, COA, GUA, ÑEE, PAI, PHA, SPE) / URY(MON)
Amaranthus kloosianus	ARG(JUJ, LRI, SAL)
Amaranthus lividus	ARG(BAI, COS, ERI) / BRA(RGS) / PRY(COA)
Amaranthus lombardoi	URY(CAS, SJO)
Amaranthus looseri	CHL(VAL, RME)
Amaranthus mantegazzianus	ARG(TUC)
Amaranthus muricatus	ARG(BAI, CHA, COR, COS, FOR, JUJ, LRI, MEN, SAL, SFE, SJU, SLU, TUC) / PRY(APY, BOQ, CEN, PHA) / URY(MON)
Amaranthus palmeri	ARG(COR, LPA, SLU)
Amaranthus pedersenianus	ARG(JUJ, SAL)
Amaranthus persimilis	ARG(CAT, MEN, SJU)
Amaranthus peruvianus	ARG(CAT, JUJ, SAL, TUC)
Amaranthus powellii	ARG(SAL, SJU)
Amaranthus retroflexus	ARG(CHU, COR, LPA, SFE) / BRA(PAR, RGS) / CHL(TAR, ANT, ATA, COQ, VAL, MAU, BIO, ARA, RME) / PRY(APY) / URY(SOR)
Amaranthus rosengurttii	ARG(ERI) / BRA(RGS) / URY(ART, FLO, FLA, LAV, RIV)
Amaranthus spinosus	ARG(CHA, COS, JUJ, LPA, MIS, SAL) / BRA(PAR, RGS, SCA) / PRY(APA, CAA, CEN, CON)
Amaranthus standleyanus	ARG(BAI, CHA, COR, COS, ERI, FOR, JUJ, LPA, LRI, MEN, RNE, SAL, SDE, SFE, SJU, SLU, TUC) / PRY(APY, BOQ, PHA) / URY(MON)
Amaranthus viridis	ARG(BAI, CHA, COS, ERI, FOR, JUJ, LRI, MIS, SAL, SDE, SFE, SJU) / BRA(RGS, SCA) / PRY(APA, APY, BOQ, CEN, COA, GUA, MIE, PAI, PHA, SPE) / URY(ART, CAS, CLA, MON, PAY, RNO, RIV, SAO, SJO, TAC)
Amaranthus vulgatissimus	ARG(BAI, CAT, CHU, COR, JUJ, MEN, SFE, SJU) / URY(PAY)
Amaryllis belladona	BRA(PAR) / CHL(VAL) / PRY(APY)
Amasonia hirta	BRA(Fuera del área del proyecto) / PRY(AMA)
Amblostoma tridactylum	BRA(PAR, RGS, SCA)
Amblyopappus pusillus var. pauciflorus	CHL(ATA)
Amblyopappus pusillus var. pusillus	CHL(ANT, ATA, COQ, JFE)
Ambrosia arborescens	CHL(COQ)
Ambrosia artemisioides	CHL(TAR, ANT)
Ambrosia chamissonis	CHL(COQ, VAL, LBO, MAU, BIO, ARA, LLA)
Ambrosia elatior	ARG(BAI, CAT, CHA, COR, COS, DFE, ERI, FOR, JUJ, LRI, MEN, MIS, SAL, SJU, SLU, SFE, SDE, TUC) / BRA(PAR, RGS, SCA) / CHL(MAU, BIO) / PRY(CAA, COA, PHA) / URY(ART, CAS, FLA, MON, PAY, RNO, RIV)
Ambrosia peruviana	CHL(TAR)
Ambrosia polystachya	BRA(PAR, RGS)
Ambrosia scabra	ARG(BAI, DFE, SFE) / BRA(RGS, SCA)
Ambrosia tenuifolia	ARG(BAI, CHA, CHU, COR, COS, DFE, ERI, FOR, JUJ, LPA, LRI, MEN, MIS, NEU, RNE, SAL, SJU, SLU, SFE, SDE, TUC) / BRA(RGS, SCA) / PRY(CEN, PHA) / URY(CAS, COL, FLA, MAL, MON, PAY, RIV, ROC, SAO, SJO)
Amburana cearensis	ARG(JUJ, SAL) / BRA(Fuera del área del proyecto) / PRY(APY, AMA, CON)
Ameghinoa patagonica	ARG(CHU, LPA, MEN, NEU, RNE, SCR)
Amelichloa ambigua	ARG(BAI, CHU, COR, ERI, LPA, MIS, NEU, RNE, SLU, SCR)
Amelichloa brachychaeta	ARG(BAI, CAT, COR, DFE, ERI, LPA, MEN, RNE, SAL, SDE, SFE, SLU, TUC)
Amelichloa brevipes	ARG(CHU, MEN, NEU, RNE, SCR) / CHL(BIO, AIS, MAG, RME)
Amelichloa caudata	ARG(BAI, CHU, ERI, JUJ, LPA, MEN, NEU, RNE, SFE) / CHL(VAL, BIO, ARA, RME) / URY(FLA, MON, SJO)
Amicia andicola	ARG(CAT, JUJ, SAL, TUC)
Amicia fimbriata	ARG(JUJ, SAL)
Amicia medicaginea	ARG(CAT, JUJ, SAL, TUC)
Ammannia auriculata	ARG(CHA, COS, ERI, FOR, SAL, SFE) / BRA(Fuera del área del proyecto) / PRY(APY, BOQ, CON, PHA) / URY(ART, SAO)
Ammannia coccinea	ARG(ERI)
Ammannia latifolia	ARG(COS, JUJ, SAL) / BRA(Fuera del área del proyecto) / CHL(MAU)
Ammannia robusta	ARG(BAI) / BRA(RGS, SCA)
Ammi majus	ARG(BAI, CHA, CHU, COS, ERI, FOR, LPA, NEU, RNE, SAL, SJU, SFE, SDE) / BRA(SCA) / CHL(LLA) / URY(MON)
Ammi visnaga	ARG(BAI, COR, COS, ERI, LPA, MEN, SAL, SJU, SFE, SDE) / BRA(PAR, SCA) / CHL(COQ, VAL, LBO, MAU, ARA, RME, JFE) / URY(MON)
Ammophila arenaria	ARG(BAI, SCR, TDF) / CHL(COQ, VAL, LLA, MAG)
Ammoselinum rosengurtii	ARG(COS, ERI) / URY(ART, CLA, FLA, PAY, RNO, SAO, SOR)
Amomyrtella güili	ARG(SAL, TUC)
Amomyrtus luma	ARG(CHU, NEU, RNE) / CHL(MAU, BIO, ARA, LLA, AIS)
Amomyrtus meli	CHL(BIO, ARA, LLA)
Amorimia exotropica	ARG(MIS) / BRA(PAR, RGS)
Amorpha fruticosa	ARG(BAI, DFE, ERI, MEN, SFE, TUC) / URY(CLA, FLA, MON)
Amphibromus quadridentulus	ARG(ERI, MIS) / BRA(PAR, RGS, SCA) / URY(CAS, MAL, MON, ROC, SJO, TAC)
Amphibromus scabrivalvis var. scabrivalvis	ARG(BAI, COR, ERI, LPA, NEU, SFE) / CHL(VAL, MAU, BIO, ARA, LLA) / URY(CLA, FLO, MAL, MON, PAY, SJO, SOR)
Amphibromus scabrivalvis var. indigestus	ARG(NEU)
Amphilophium bracteatum	BRA(PAR)
Amphilophium carolinae	ARG(BAI, CAT, CHA, COR, COS, ERI, FOR, JUJ, LRI, MIS, SAL, SJU, SLU, SFE, SDE, TUC) / BRA(Fuera del área del proyecto) / PRY(APY, BOQ, CHO, ÑEE, NAS, PHA) / URY(PAY, RNO)
Amphilophium crucigerum	ARG(COS, JUJ, MIS, SAL, TUC) / BRA(PAR, RGS, SCA) / PRY(APA, AMA, CAU, CAA, CAN, CEN, CON, COA, GUA, ITA, MIE, PAI, SPE)
Amphilophium dolichoides	BRA(PAR, SCA)
Amphilophium dusenianum	BRA(PAR, RGS, SCA)
Amphilophium elongatum	BRA(PAR, SCA)
Amphilophium falcatum	BRA(PAR)
Amphilophium paniculatum	ARG(CHA, COS, FOR, JUJ, MIS, SAL, TUC) / BRA(PAR, RGS, SCA) / PRY(APA, AMA, CAU, CAA, CAN, CEN, CON, COA, GUA, MIE, PAI, PHA, SPE)
Amphilophium pannosum	ARG(JUJ, SAL)
Amphilophium sandwithii	ARG(JUJ, SAL)
Amphipetalum paraguayense	PRY(APY)
Amphiscirpus nevadensis	ARG(CAT, CHU, JUJ, NEU, RNE, SAL, SCR, TDF) / CHL(MAG)
Amsinckia calycina	ARG(BAI, CHU, LPA, MEN, NEU, RNE, SCR, TDF) / CHL(TAR, ANT, COQ, VAL, LBO, MAU, BIO, ARA, LLA, AIS, MAG, RME)
Amsinckia tessellata	ARG(CHU, MEN, NEU) / CHL(RME)
Anacampseros kurtzii	ARG(CAT, JUJ, LRI, SAL)
Anacampseros vulcanensis	ARG(JUJ, SAL)
Anacardium humile	BRA(PAR) / PRY(AMA, CAU, CAN, CON, SPE)
Anacheilium faustum	BRA(PAR)
Anacheilium fragrans	BRA(PAR)
Anadenanthera colubrina var. colubrina	ARG(COS, FOR, JUJ, SAL, TUC) / BRA(PAR)
Anadenanthera colubrina var. cebil	ARG(CAT, CHA, COR, COS, ERI, FOR, JUJ, MIS, SAL, SDE, TUC) / BRA(PAR, RGS) / PRY(APY, AMA, CAU, CAN, CEN, CON, COA, PAI, PHA, SPE)
Anadenanthera peregrina	BRA(PAR) / PRY(APY, AMA, CAN, ÑEE, PAI)
Anagallis alternifolia var. alternifolia	ARG(MEN, NEU, RNE, SCR, TDF) / CHL(ANT, ATA, COQ, VAL, LBO, MAU, BIO, ARA, LLA, AIS, MAG, RME)
Anagallis alternifolia var. repens	ARG(CAT, CHU, LRI, MEN, NEU, RNE, SCR, SJU, TDF, TUC) / CHL(ATA, VAL, MAU, ARA, LLA, MAG, RME)
Anagallis arvensis	ARG(BAI, CHU, COR, COS, DFE, ERI, JUJ, LPA, LRI, MEN, MIS, RNE, SAL, SJU, SLU, SCR, SFE, TUC) / BRA(PAR, RGS, SCA) / CHL(TAR, ATA, COQ, VAL, LBO, MAU, BIO, ARA, LLA, RME, JFE) / URY(ART, COL, MAL, MON, RIV, ROC, SAO, SJO)
Anagallis filiformis	ARG(MIS) / BRA(PAR, RGS, SCA) / URY(MAL, MON)
Anagallis pumila	ARG(COR, COS, MIS) / BRA(Fuera del área del proyecto) / PRY(CAN, CEN, PAI, SPE)
Ananas ananassoides	BRA(Fuera del área del proyecto) / PRY(AMA, CEN, CON, SPE)
Ananas bracteatus var. bracteatus	ARG(COS, MIS) / BRA(PAR, RGS, SCA) / PRY(APA, CAU, PAI)
Ananas bracteatus var. tricolor	BRA(RGS) / PRY(APA, PAI)
Ananas fritzmuelleri	BRA(PAR, RGS, SCA)
Anaphalis chilensis	CHL(VAL, LBO, MAU, BIO, ARA, RME)
Anarthrophyllum andicolum	CHL(VAL, LBO, RME)
Anarthrophyllum burkartii	ARG(NEU)
Anarthrophyllum capitatum	ARG(NEU)
Anarthrophyllum catamarcense	ARG(CAT)
Anarthrophyllum cumingii	CHL(COQ, VAL, LBO, MAU, RME)
Anarthrophyllum desideratum var. mustersii	ARG(CHU, SCR)
Anarthrophyllum desideratum var. morenonis	ARG(CHU, SCR) / CHL(MAG)
Anarthrophyllum desideratum var. desideratum	ARG(CHU, SCR) / CHL(MAG)
Anarthrophyllum elegans	ARG(MEN, NEU) / CHL(VAL)
Anarthrophyllum gayanum	ARG(MEN, NEU, SJU) / CHL(COQ, RME)
Anarthrophyllum macrophyllum	ARG(MEN, NEU)
Anarthrophyllum ornithopodum	ARG(CHU, LPA, NEU)
Anarthrophyllum patagonicum	ARG(CHU, NEU, RNE)
Anarthrophyllum pedicellatum	ARG(CHU, LPA, MEN)
Anarthrophyllum rigidum	ARG(CHU, MEN, NEU, RNE, SCR) / CHL(MAU, MAG)
Anarthrophyllum strigulipetalum	ARG(CHU, NEU, RNE)
Anarthrophyllum subandinum	ARG(CHU, NEU, RNE)
Anathallis bertoniensis	PRY(APA)
Anathallis bleyensis	BRA(PAR, SCA)
Anathallis bocainensis	BRA(SCA)
Anathallis caroli	BRA(RGS)
Anathallis crebrifolia	BRA(PAR)
Anathallis ferdinandiana	BRA(PAR)
Anathallis gert-hatschbachii	BRA(PAR, RGS)
Anathallis globifera	BRA(SCA)
Anathallis imbricata	BRA(SCA)
Anathallis ipyrangana	BRA(PAR)
Anathallis johnsonii	ARG(MIS)
Anathallis kleinii	BRA(PAR, SCA)
Anathallis klingelfusii	BRA(SCA)
Anathallis laciniata	BRA(RGS)
Anathallis linearifolia	ARG(MIS) / BRA(PAR, RGS, SCA)
Anathallis liparanges	BRA(PAR)
Anathallis malmeana	BRA(RGS)
Anathallis microphyta	BRA(RGS, SCA)
Anathallis muscoidea	BRA(SCA)
Anathallis obovata	ARG(JUJ, MIS, SAL) / BRA(PAR, RGS, SCA) / PRY(APA)
Anathallis pabstii	BRA(PAR, SCA)
Anathallis petersiana	BRA(PAR)
Anathallis piratiningana	BRA(PAR)
Anathallis rigidula	BRA(PAR, RGS, SCA)
Anathallis rubrolimbata	BRA(RGS)
Anathallis sclerophylla	BRA(PAR, SCA)
Anathallis seidelii	BRA(SCA)
Anathallis ypirangae	BRA(PAR, RGS)
Anatherostipa bomanii	ARG(JUJ) / CHL(TAR, ANT)
Anatherostipa brevis	ARG(JUJ, SAL)
Anatherostipa hans-meyeri	CHL(TAR)
Anatherostipa henrardiana	ARG(JUJ)
Anatherostipa mucronata	ARG(JUJ, SAL, TUC) / CHL(TAR, ANT, ATA)
Anatherostipa obtusa	ARG(JUJ)
Anatherostipa orurensis	
Anatherostipa rigidiseta	CHL(TAR, ANT, ATA)
Anatherostipa venusta	CHL(TAR, ANT)
Anchietea pyrifolia	ARG(BAI, COS, ERI, JUJ, MIS, SAL) / BRA(PAR, RGS, SCA) / PRY(AMA, CAN, GUA, ITA) / URY(ART, RIV, SAO, TAC)
Anchusa officinalis	ARG(BAI, LPA)
Ancistrotropsis serrana	BRA(PAR)
Andeimalva chilensis	CHL(ATA, COQ, VAL, LBO, MAU, RME)
Andira fraxinifolia	BRA(PAR, SCA)
Andira humilis	BRA(PAR) / PRY(AMA, CAU, CAN, CON, SPE)
Andira inermis	BRA(PAR) / PRY(MIE)
Andropogon arenarius	BRA(PAR, RGS, SCA) / URY(CAS, MAL, MON, ROC)
Andropogon barretoi	BRA(RGS)
Andropogon bicornis	ARG(CHA, COS, FOR, MIS) / BRA(PAR, RGS, SCA) / PRY(APA, AMA, CAN, COA, ITA, MIE, ÑEE, PAI, PHA)
Andropogon coloratus	ARG(CHA)
Andropogon exaratus	ARG(COS, MIS) / PRY(CEN, COA, GUA)
Andropogon gayanum	BRA(RGS)
Andropogon glaucophyllus	BRA(RGS, SCA) / URY(CAS, MON, ROC)
Andropogon glaziovii	BRA(Fuera del área del proyecto) / PRY(AMA, CON, COA, MIE, SPE)
Andropogon hypogynus	ARG(CHA, COS, MIS) / BRA(PAR) / PRY(ITA)
Andropogon lateralis	ARG(BAI, CHA, COS, ERI, FOR, MIS, SFE) / BRA(PAR, RGS, SCA) / PRY(APA, AMA, CAU, ITA, ÑEE, PAI) / URY(ART, CAS, CLA, DUR, LAV, MON, RNO, RIV, ROC, SAO, SOR, TAC, TYT)
Andropogon leucostachyus	ARG(BAI, COS, ERI, MIS) / BRA(PAR, RGS, SCA) / PRY(AMA, CAU, CON, COA, ITA, MIE, PAI, PHA, SPE)
Andropogon lindmanii	BRA(RGS, SCA) / URY(CAS, ROC)
Andropogon macrothrix	ARG(COS, MIS) / BRA(PAR, RGS, SCA) / PRY(GUA) / URY(CLA, RIV, TAC)
Andropogon selloanus	ARG(CHA, COR, COS, ERI, FOR, JUJ, MIS, SFE) / BRA(PAR, RGS, SCA) / PRY(AMA, CAU, CON, PAI, PHA) / URY(CAS, CLA, COL, FLA, MAL, MON, RNO, RIV, ROC, SAO, SJO, TAC)
Andropogon subtilior	PRY(PAI)
Andropogon ternatus	ARG(BAI, COR, COS, ERI, MIS, SLU) / BRA(RGS, SCA) / PRY(AMA) / URY(ART, CLA, COL, FLO, FLA, LAV, MAL, MON, PAY, RNO, RIV, ROC, SAO, SJO, SOR, TAC, TYT)
Andropogon virgatus	ARG(COS, ERI, MIS) / BRA(PAR, RGS, SCA) / PRY(CAA, CAN) / URY(RIV)
Androsace salasii	ARG(CHU, LPA, MEN, NEU, RNE, SCR, TDF) / CHL(MAG)
Androtrichum trigynum	ARG(BAI, ERI) / BRA(PAR, RGS, SCA) / URY(CAS, CLA, COL, MAL, MON, ROC, SJO)
Anemia alfredi-rohrii	BRA(SCA)
Anemia australis	ARG(CAT, COR, JUJ, LRI, SAL, SJU, SLU, SDE, TUC)
Anemia ferruginea	BRA(PAR) / PRY(AMA, CAA)
Anemia herzogii	ARG(JUJ, SAL) / PRY(APY)
Anemia imbricata	BRA(RGS, SCA)
Anemia myriophylla	ARG(JUJ, SAL) / PRY(CEN, COA, PAI)
Anemia phyllitidis var. phyllitidis	ARG(CAT, CHA, COS, JUJ, MIS, SAL, SFE, TUC) / BRA(PAR, RGS, SCA) / PRY(AMA, CAA, CAN, PAI) / URY(ART, CLA)
Anemia phyllitidis var. tweedieana	ARG(BAI, CHA, COS, MIS, SAL) / BRA(RGS) / PRY(CAN) / URY(TYT)
Anemia raddiana	BRA(PAR, RGS, SCA)
Anemia simplicior	ARG(CHA, COS, FOR, MIS, SFE) / BRA(RGS, SCA) / PRY(CAU, CAN, COA)
Anemia tomentosa var. tomentosa	ARG(BAI, CAT, CHA, COR, COS, ERI, JUJ, LRI, MIS, RNE, SAL, SJU, SLU, SDE, TUC) / BRA(RGS, SCA) / PRY(CAN, COA, PAI) / URY(ART, CLA, LAV, MAL, MON, RNO, ROC, SJO, TAC)
Anemia tomentosa var. anthriscifolia	ARG(BAI, CAT, CHA, COR, COS, FOR, JUJ, LRI, MIS, SAL, SJU, SLU, SFE, SDE, TUC) / BRA(PAR, RGS, SCA) / PRY(APY, AMA, BOQ, CAA, CAN, CEN, ÑEE)
Anemia trichorrhiza var. paraguariensis	PRY(CEN, COA, GUA)
Anemia villosa	BRA(PAR, RGS, SCA)
Anemia warmingii	BRA(PAR, RGS, SCA)
Anemia wettsteinii	ARG(MIS) / BRA(Fuera del área del proyecto)
Anemone antucensis	ARG(NEU, RNE) / CHL(MAU, BIO, ARA, LLA)
Anemone decapetala var. decapetala	ARG(BAI, CHU, COR, ERI, MIS, NEU, RNE, SLU) / BRA(PAR, RGS) / CHL(COQ, VAL, LBO, MAU, BIO, ARA, LLA, AIS, MAG, JFE) / URY(MON, SOR)
Anemone decapetala var. foliolosa	ARG(BAI, CAT, CHA, CHU, COR, COS, ERI, JUJ, LPA, LRI, MIS, RNE, SAL, SFE, TUC) / BRA(SCA) / CHL(VAL, LBO, MAU, BIO, ARA, LLA, AIS, MAG) / URY(MON, SOR)
Anemone hepaticifolia	CHL(LLA)
Anemone moorei	CHL(MAU)
Anemone multifida	ARG(CHU, MEN, NEU, RNE, SCR, TDF) / CHL(MAU, BIO, ARA, LLA, AIS, MAG)
Anemone rigida	CHL(LBO, MAU, RME)
Anemone sellowii	BRA(SCA)
Anemopaegma arvense	BRA(PAR) / PRY(AMA, CAU, CAN, SPE)
Anemopaegma chamberlaynii	BRA(PAR, SCA) / PRY(APA, AMA, CAN, CEN, CON, PHA, SPE)
Anemopaegma flavum	ARG(CHA, COS, FOR, SFE) / BRA(Fuera del área del proyecto) / PRY(CEN, COA, GUA, ÑEE)
Anemopaegma glaucum	BRA(Fuera del área del proyecto) / PRY(AMA)
Anemopaegma longipetiolatum	BRA(Fuera del área del proyecto) / PRY(AMA, SPE)
Anemopaegma prostratum	BRA(PAR, RGS, SCA) / PRY(CON)
Anethum graveolens	ARG(COS, MIS) / BRA(RGS, SCA) / CHL(JFE)
Anetium citrifolium	BRA(SCA)
Angelonia gardneri	ARG(CHA, COS, FOR, SFE) / BRA(Fuera del área del proyecto) / PRY(APY, AMA, CEN, COA, ÑEE, PAI, PHA, SPE)
Angelonia hassleriana	ARG(FOR, MIS) / PRY(CAN, CEN, COA, PAI)
Angelonia integerrima	ARG(CHA, COS, ERI, FOR, MIS, SFE) / BRA(PAR, RGS, SCA) / PRY(CAU, CAA, CAN, CEN, CON, COA, GUA, ITA, ÑEE, PAI, SPE) / URY(ART, CLA, DUR, RNO, RIV, SOR, TAC)
Angelonia salicariifolia	ARG(CHA, COR, COS, ERI, FOR, MIS, SFE) / BRA(Fuera del área del proyecto) / PRY(APY, AMA, CEN, COA, PAI, PHA, SPE)
Angelphytum indutum	PRY(CAU, CEN, COA, GUA)
Aniba firmula	BRA(PAR, RGS, SCA)
Aniseia argentina	ARG(BAI, CHA, COS, ERI, FOR, MIS, SFE) / BRA(RGS) / PRY(CON, ÑEE, PHA) / URY(ART, CLA, COL, DUR, PAY, RNO, RIV, SAO, SOR, TYT)
Aniseia martinicensis var. ambigua	ARG(MIS) / BRA(Fuera del área del proyecto) / PRY(APY, CON)
Anisocapparis speciosa	ARG(CAT, CHA, COS, FOR, JUJ, SAL, SDE, SFE, TUC) / PRY(APY, PHA)
Anisomeria coriacea var. coriacea	CHL(COQ, VAL, LBO, MAU, RME)
Anisomeria littoralis	CHL(ANT, ATA, COQ, VAL, MAU, RME)
Annona cacans	BRA(PAR, RGS, SCA) / PRY(APA, AMA, CAN)
Annona calophylla	PRY(APA, AMA, CAU, CAN, CON, SPE)
Annona campestris	PRY(APA, AMA, CAU, PAI)
Annona coriacea var. coriacea	BRA(PAR) / PRY(AMA, CAN, SPE)
Annona coriacea var. cuneata	PRY(CAN)
Annona cornifolia	BRA(PAR)
Annona crassiflora	BRA(Fuera del área del proyecto) / PRY(CAN)
Annona crotonifolia	BRA(Fuera del área del proyecto) / PRY(AMA, CAN)
Annona dioica	BRA(PAR) / PRY(AMA, CAN, CEN, CON, COA, PAI, SPE)
Annona emarginata	ARG(CHA, COS, ERI, FOR, SFE) / BRA(PAR, RGS) / PRY(APA, APY, AMA, CAU, CAA, CAN, CEN, CON, COA, GUA, ITA, MIE, ÑEE, PAI, PHA, SPE) / URY(ART)
Annona glabra	BRA(PAR, RGS, SCA)
Annona glaucophylla	PRY(AMA, CON)
Annona montana	BRA(PAR)
Annona neosalicifolia	ARG(COS, FOR, MIS) / BRA(PAR, RGS, SCA) / PRY(APA, CAA, CAN, CEN, COA, GUA, ITA, PAI, SPE)
Annona nutans	BRA(Fuera del área del proyecto) / PRY(APA, APY, AMA, CAA, CAN, CEN, CHO, CON, COA, GUA, MIE, NAS, PAI, PHA, SPE)
Annona paraguayensis	PRY(CON)
Annona rugulosa	ARG(MIS, SAL) / BRA(PAR, RGS, SCA)
Anoda cristata	ARG(BAI, CAT, COR, ERI, JUJ, LPA, MEN, SAL, SDE, SFE, SLU, TUC) / BRA(RGS) / CHL(TAR, ANT, ATA, COQ, VAL, LBO, MAU, BIO, ARA, RME, JFE) / URY(MON)
Anoda hastata	ARG(JUJ, LRI, MEN, SAL, TUC) / CHL(TAR)
Anogramma chaerophylla	ARG(BAI, CHA, COR, COS, ERI, JUJ, MIS, SAL, SFE) / BRA(PAR, RGS, SCA) / PRY(CEN, PAI) / URY(CAS, CLA, LAV, MAL, PAY, SJO, SOR)
Anogramma lorentzii	ARG(CHA, COR, ERI, JUJ) / BRA(RGS) / PRY(CEN) / URY(MON)
Anogramma osteniana	BRA(RGS) / URY(CAS, SJO, TAC)
Anredera cordifolia	ARG(BAI, CAT, CHA, COR, COS, DFE, ERI, FOR, JUJ, MIS, SAL, SDE, SFE, SLU, TUC) / BRA(PAR, RGS, SCA) / PRY(APY, CEN, GUA, PAI, PHA, SPE) / URY(COL, MON)
Anredera krapovickasii	ARG(JUJ, SAL)
Anredera tucumanesis	ARG(TUC) / BRA(PAR, SCA)
Antennaria chilensis var. magellanica	ARG(CHU, MEN, NEU, SCR, TDF) / CHL(MAG)
Antennaria chilensis var. chilensis	ARG(CHU, MEN, NEU, SJU, SCR) / CHL(COQ, VAL, LBO, MAU, BIO, AIS, MAG, RME)
Antennaria sleumeri	ARG(SAL)
Anthaenantia lanata	ARG(BAI, CHA, COS, ERI, FOR, MIS, SFE) / BRA(PAR, RGS, SCA) / PRY(APA, AMA, CAU, CAN, CEN, CON, COA, GUA, ÑEE, PAI, PHA, SPE) / URY(ART, CLA, COL, DUR, FLA, LAV, MAL, MON, PAY, RNO, RIV, ROC, SAO, SOR, TYT)
Anthaenantiopsis fiebrigii	ARG(JUJ, SAL) / BRA(Fuera del área del proyecto) / PRY(AMA)
Anthaenantiopsis perforata	BRA(PAR) / PRY(APA, AMA, CAU, CAN, CON)
Anthaenantiopsis rojasiana	ARG(COS, MIS) / PRY(AMA, GUA)
Anthaenantiopsis trachystachya	BRA(Fuera del área del proyecto) / PRY(AMA, CAU)
Anthemis arvensis	CHL(BIO, ARA, LLA) / URY(MON)
Anthemis cotula	ARG(BAI, CAT, CHA, CHU, COR, COS, DFE, ERI, FOR, JUJ, LPA, LRI, MEN, MIS, NEU, RNE, SAL, SJU, SLU, SCR, SFE, TDF, TUC) / BRA(PAR, RGS) / CHL(TAR, ANT, ATA, COQ, VAL, LBO, MAU, BIO, ARA, LLA, RME, JFE) / PRY(CEN, ITA) / URY(CAS, CLA, COL, DUR, MON, PAY, RNO, SJO, SOR)
Anthericum argentinense	ARG(CAT, SAL, TUC)
Anthericum eccremorrhizum	ARG(SAL)
Anthericum glaucum	ARG(JUJ)
Anthericum hickenianum	ARG(JUJ, SAL, TUC)
Anthericum humboldtii	ARG(JUJ, SAL, TUC)
Anthericum volcanense	ARG(JUJ)
Anthodon decussatum	BRA(Fuera del área del proyecto) / PRY(CAN)
Anthoxanthum altissimum	CHL(BIO, ARA, LLA, AIS)
Anthoxanthum gunckelii	ARG(RNE) / CHL(BIO, ARA, LLA)
Anthoxanthum juncifolium	ARG(CHU, NEU, RNE) / CHL(BIO, ARA, LLA)
Anthoxanthum odoratum	ARG(BAI, NEU, RNE, TDF) / BRA(PAR, RGS, SCA) / CHL(MAU, BIO, ARA, LLA, MAG, JFE) / URY(CAS, MON)
Anthoxanthum pusillum	ARG(SCR, TDF) / CHL(MAG)
Anthoxanthum redolens	ARG(CHU, NEU, RNE, SCR, TDF) / CHL(COQ, BIO, LLA, AIS, MAG)
Anthoxanthum spicatum	CHL(ARA, MAG)
Anthoxanthum utriculatum	ARG(NEU) / CHL(ARA)
Anthriscus caucalis	ARG(MEN, NEU, RNE) / CHL(VAL, LBO, BIO, RME)
Anthriscus sylvestris	CHL(MAG)
Anthurium acutum	BRA(PAR, SCA)
Anthurium comtum	BRA(PAR)
Anthurium gaudichaudianum	BRA(PAR, SCA)
Anthurium glaucescens	BRA(PAR, SCA)
Anthurium hatschbachii 	BRA(PAR, SCA)
Anthurium loefgrenii	BRA(PAR, SCA)
Anthurium marense	BRA(PAR)
Anthurium paraguayense	ARG(CHA, COS, FOR, SAL, TUC) / BRA(Fuera del área del proyecto) / PRY(APY, AMA, CAA, CEN, CON, COA, ÑEE, PAI, PHA, SPE)
Anthurium pentaphyllum	BRA(PAR, SCA)
Anthurium pilonense	BRA(SCA)
Anthurium plowmanii	BRA(Fuera del área del proyecto) / PRY(AMA, SPE)
Anthurium scandens	BRA(PAR, RGS, SCA)
Anthurium sellowianum	BRA(PAR, SCA)
Anthurium sinuatum	BRA(PAR) / PRY(CAN)
Anthurium urvilleanum	BRA(PAR, SCA)
Antidaphne punctulata	CHL(BIO, ARA, LLA)
Antigonon leptopus	ARG(SAL) / PRY(CEN, COA)
Antiphytum cruciatum	BRA(RGS) / URY(CLA, MAL, RIV, TYT)
Antirrhinum majus	ARG(BAI, ERI) / URY(MON)
Apalanthe granatensis	ARG(COS, MIS) / BRA(Fuera del área del proyecto)
Aparisthmium cordatum	BRA(PAR, SCA)
Apera interrupta	ARG(CHU, MEN, NEU, RNE) / CHL(ARA)
Aphanes arvensis	ARG(MIS, NEU, RNE) / BRA(SCA) / CHL(ANT, COQ, LBO, ARA, LLA, RME)
Aphanes berteroana f. vegeta	CHL(LBO)
Aphanes looseri	CHL(RME)
Aphanes neglecta	CHL(BIO, ARA, LLA, RME)
Aphanes parodii	ARG(BAI, CHU, COR, COS, DFE, LPA, SCR, SFE) / BRA(SCA) / URY(RNO, ROC, SOR, TAC)
Aphelandra chamissoniana	BRA(PAR, SCA)
Aphelandra hieronymi	ARG(JUJ, SAL)
Aphelandra liboniana	BRA(PAR, SCA)
Aphelandra lilacina	ARG(SAL)
Aphelandra longiflora	ARG(MIS) / BRA(PAR, RGS, SCA)
Aphelandra ornata	BRA(PAR, SCA)
Aphelandra schottiana	BRA(PAR)
Aphyllocladus denticulatus var. calvus	CHL(TAR)
Aphyllocladus denticulatus var. denticulatus	CHL(ATA)
Aphyllocladus ephedroides	ARG(CAT, LRI, SJU)
Aphyllocladus sanmartinianus	ARG(MEN, SJU)
Aphyllocladus spartioides	ARG(JUJ, SAL)
Apinagia fucoides	BRA(SCA)
Apinagia guairaensis	PRY(CAN)
Apinagia yguazuensis	ARG(MIS) / BRA(PAR, RGS, SCA) / PRY(APA, CAN)
Apium australe	
Apium chilense	CHL(ANT, VAL, LBO, MAU, JFE)
Apium commersonii	ARG(BAI, CHU, MEN, SCR) / URY(MON, SJO)
Apium graveolens	ARG(LPA, SJU, SLU) / BRA(SCA) / CHL(ANT, LLA, JFE) / PRY(CEN)
Apium humile	CHL(RME)
Apium nodiflorum	ARG(BAI, NEU) / CHL(ATA, COQ, VAL, MAU, BIO)
Apium panul	ARG(MEN, NEU, SJU, TUC) / CHL(ANT, ATA, COQ, VAL, LBO, MAU, BIO, ARA, LLA, RME)
Apium pimpinellifolium	CHL(LBO)
Apium prostratum	ARG(BAI, CHU, MEN, SCR, TDF) / BRA(PAR, RGS, SCA) / CHL(ANT, ATA, COQ, BIO, LLA, AIS, MAG, RME, JFE, IPA) / URY(ROC)
Apium sellowianum	ARG(BAI, CAT, CHA, COS, ERI, FOR, LPA, LRI, MEN, SFE, SJU) / BRA(PAR, RGS, SCA) / PRY(PAI) / URY(CAS, CLA, COL, LAV, MAL, MON, PAY, ROC, SAO, SJO, SOR, TAC)
Apoclada simplex	BRA(PAR, SCA)
Apodanthera anatuyana	ARG(FOR, SDE)
Apodanthera catharinensis	BRA(PAR, SCA)
Apodanthera hirtella	ARG(JUJ, SAL)
Apodanthera laciniosa	ARG(MIS) / BRA(PAR, RGS, SCA)
Apodanthera sagittifolia var. sagittifolia	ARG(COR, LRI, MEN, SLU)
Apodanthera sagittifolia var. villosa	ARG(BAI, COR, COS, DFE, ERI, LPA, MIS, SFE, SJU, SLU) / BRA(RGS) / URY(CAS, FLA, LAV, MAL, MON, SOR)
Apodanthera sagittifolia var. dissecta	ARG(BAI, COR) / URY(SOR)
Apodanthera ulei	BRA(SCA)
Apodasmia chilensis	CHL(BIO, ARA, LLA, AIS, MAG)
Aponogeton distachyos	CHL(LLA)
Apopyros corymbosus	ARG(COS, MIS) / BRA(PAR, RGS) / PRY(AMA, CAU, COA)
Aptenia cordifolia	ARG(BAI, MEN, SFE)
Apteria aphylla	ARG(COS, MIS) / BRA(PAR, RGS, SCA) / PRY(APA, AMA)
Apuleia leiocarpa	ARG(COS, MIS) / BRA(PAR, RGS, SCA) / PRY(APA, CAN, COA, ITA, PAI)
Apurimacia dolichocarpa	ARG(COR)
Aquilegia vulgaris	ARG(NEU, RNE) / CHL(BIO, ARA, LLA)
Arabidopsis thaliana	ARG(SCR) / CHL(BIO, ARA, LLA, AIS) / URY(MON)
Arabis alpina	ARG(NEU, RNE)
Arachis batizocoi	PRY(APY)
Arachis burkartii	ARG(COS, ERI, MIS) / BRA(RGS) / URY(ART, PAY, RIV, SAO, TAC)
Arachis cardenasii	PRY(APY)
Arachis correntina	ARG(COS) / PRY(CEN, PAI, PHA)
Arachis diogoi	BRA(Fuera del área del proyecto) / PRY(APA, PAI, PHA)
Arachis duranensis	ARG(JUJ, SAL) / PRY(APY)
Arachis glabrata var. glabrata	ARG(COS, MIS) / BRA(Fuera del área del proyecto) / PRY(APY, APA, AMA, CAU, CEN, CON, COA, GUA, ITA, MIE, PAI, SPE) / URY(ART)
Arachis glabrata var. hagenbeckii	ARG(COS) / PRY(APY, AMA, CAU, CAN, CEN, COA, GUA, MIE, PAI, SPE)
Arachis guaranitica	BRA(Fuera del área del proyecto) / PRY(AMA, CAN)
Arachis hassleri	PRY(CON, PHA)
Arachis hoehnei	BRA(Fuera del área del proyecto) / PRY(AMA)
Arachis lignosa	PRY(CON, PHA)
Arachis major	BRA(Fuera del área del proyecto) / PRY(AMA, CON)
Arachis monticola	ARG(JUJ, SAL)
Arachis nitida	BRA(Fuera del área del proyecto) / PRY(AMA, CON)
Arachis paraguariensis	BRA(Fuera del área del proyecto) / PRY(AMA, CAN, CON, COA, PAI)
Arachis Pflugeae	BRA(Fuera del área del proyecto) / PRY(CON)
Arachis pseudovillosa	BRA(Fuera del área del proyecto) / PRY(AMA, CAN)
Arachis schininii	PRY(AMA)
Arachis stenophylla	BRA(Fuera del área del proyecto) / PRY(CON)
Arachis stenosperma	BRA(PAR)
Arachis villosa	ARG(COS, ERI) / BRA(RGS) / URY(ART, CAS, COL, MON, PAY, RNO, SAO, SJO, SOR)
Arachniodes denticulata	BRA(PAR)
Arachnitis uniflora	ARG(CHU, NEU, RNE, SCR, TDF) / CHL(MAU, BIO, ARA, LLA, AIS, MAG, RME)
Araeoandra tenuicaulis	CHL(COQ)
Aralia soratensis	ARG(CHA, COS, FOR, JUJ, MIS, SAL, TUC)
Aralia warmingiana	ARG(CHA, COS, FOR, MIS, SAL, SFE) / BRA(PAR, SCA) / PRY(APA, AMA, CAN, COA, SPE)
Araucaria angustifolia var. caiova	BRA(PAR, RGS, SCA)
Araucaria angustifolia f. catharinensis	BRA(SCA)
Araucaria angustifolia var. angustifolia	ARG(MIS) / BRA(PAR, RGS, SCA)
Araucaria angustifolia var. vinacea	BRA(SCA)
Araucaria angustifolia var. striata	BRA(SCA)
Araucaria angustifolia var. indehiscens	BRA(SCA)
Araucaria angustifolia var. alba	BRA(SCA)
Araucaria araucana	ARG(NEU, RNE) / CHL(BIO, ARA, LLA)
Araujia angustifolia	ARG(BAI, CHA, COS, ERI, FOR, SDE, SFE) / URY(ART, PAY, SAO, SOR)
Araujia brachystephana	ARG(BAI, CAT, COR, COS, ERI, FOR, JUJ, SAL, SLU, SFE, SDE, TUC) / PRY(APY, BOQ, NAS, PHA) / URY(PAY)
Araujia hassleriana	PRY(APY, CON)
Araujia herzogii	ARG(SAL)
Araujia megapotamica	ARG(COS, ERI) / BRA(PAR, RGS) / PRY(PAI) / URY(MON, PAY, ROC, SAO)
Araujia odorata	ARG(BAI, CAT, CHA, COR, COS, ERI, FOR, JUJ, LPA, LRI, MEN, SAL, SJU, SFE, SDE, TUC) / BRA(Fuera del área del proyecto) / PRY(APY, BOQ, CEN, CHO, COA, ITA, ÑEE, NAS, PAI, PHA) / URY(COL, SJO)
Araujia plumosa	ARG(CHA, COS, FOR, JUJ, SAL, TUC) / BRA(Fuera del área del proyecto) / PRY(APY, AMA, CAU, CEN, COA, GUA, PAI)
Araujia scalae	ARG(BAI, COR, LPA, RNE)
Araujia sericifera	ARG(BAI, COS, ERI, MIS, SFE) / BRA(PAR, RGS, SCA) / PRY(APA, GUA, ITA) / URY(CAS, CLA, FLO, MON, RIV, SAO)
Araujia stuckertiana ssp. stuckertiana	ARG(COR, SFE)
Araujia stuckertiana ssp. grandiflora	ARG(CAT, COR, FOR, LRI, SAL, SDE, TUC)
Araujia variegata	ARG(CAT, CHA, COS, FOR, JUJ, SAL, TUC) / BRA(Fuera del área del proyecto) / PRY(APY, BOQ, CON, PHA)
Arctium minus	ARG(BAI, CAT, CHU, COR, COS, DFE, ERI, LPA, LRI, MEN, SJU, SFE) / BRA(PAR, RGS, SCA) / CHL(LBO, MAU, LLA, RME) / URY(CAS, FLA, MON, SOR)
Arctotheca calendula	ARG(BAI) / CHL(BIO)
Arctotis stoechadifolia	ARG(COR, COS, ERI) / BRA(RGS) / URY(COL)
Ardisia catharinensis	BRA(PAR, SCA)
Ardisia guianensis	BRA(PAR, SCA)
Arenaria achalensis	ARG(CAT, COR, SAL, TUC)
Arenaria bisulca	ARG(CAT, JUJ, SAL, TUC)
Arenaria catamarcensis	ARG(CAT, JUJ, LRI, SAL, SJU)
Arenaria digyna	CHL(TAR, ANT, ATA, COQ, VAL, LBO, MAU, BIO, ARA, LLA, AIS, MAG, RME)
Arenaria fastigiata	CHL(MAU)
Arenaria jussiaei	BRA(RGS)
Arenaria lanuginosa var. lanuginosa	ARG(CAT, COR, JUJ, LRI, SAL, SJU, SLU, SDE, TUC) / BRA(RGS)
Arenaria lanuginosa var. megalantha	ARG(JUJ, SAL, SJU, TUC)
Arenaria lanuginosa var. ensifolia	ARG(JUJ, SAL, TUC)
Arenaria oligosperma	CHL(COQ)
Arenaria pleurantha	CHL(LLA, AIS)
Arenaria pycnophylloides	ARG(CAT, LRI, SAL)
Arenaria rivularis	ARG(JUJ, MEN, SAL, SJU, TUC) / CHL(ANT)
Arenaria serpens	ARG(CAT, CHU, COR, JUJ, LRI, MEN, NEU, RNE, SAL, SCR, SJU, TDF, TUC) / CHL(ANT, COQ, LLA)
Arenaria serpyllifolia	ARG(BAI, LPA, NEU, RNE, SCR, SLU) / CHL(COQ, MAU, MAG, RME) / URY(PAY, TAC)
Argemone crassifolia	CHL(ATA)
Argemone hunnemannii	ARG(COR, LPA, MEN, SLU) / CHL(ANT, ATA, COQ, VAL, LBO, MAU, RME)
Argemone rosea	CHL(ATA, COQ)
Argemone subfusiformis	ARG(BAI, CAT, CHA, CHU, COR, COS, DFE, ERI, FOR, JUJ, LPA, LRI, MEN, MIS, SAL, SJU, SLU, SFE, SDE, TUC) / CHL(TAR, ANT, ATA, COQ, VAL, RME) / PRY(APY, CEN, PAI) / URY(COL, MON, RNO)
Argylia adscendens var. adscendens	CHL(COQ, VAL, LBO, RME)
Argylia adscendens var. viridis	CHL(COQ, RME)
Argylia bifrons	CHL(ATA)
Argylia bustillosii	ARG(MEN, NEU) / CHL(LBO, BIO)
Argylia checoensis	CHL(ANT, ATA)
Argylia conaiensis	CHL(ATA)
Argylia farnesiana	CHL(COQ)
Argylia geranioides	CHL(ATA, COQ)
Argylia glutinosa	CHL(ANT, ATA)
Argylia potentillifolia	CHL(ATA, COQ)
Argylia radiata	CHL(ANT, ATA, COQ, VAL, RME)
Argylia robusta	ARG(MEN, NEU, RNE)
Argylia tomentosa	CHL(ANT, ATA)
Argylia uspallatensis	ARG(CAT, JUJ, LRI, MEN, SAL, SJU) / CHL(ANT, VAL)
Argyranthemum frutescens	ARG(BAI) / CHL(COQ, RME)
Argyrochosma chilensis	CHL(JFE)
Argyrochosma nivea var. nivea	ARG(BAI, CAT, COR, JUJ, LPA, LRI, MEN, SAL, SDE, SJU, SLU, TUC) / CHL(TAR, ANT)
Argyrochosma nivea var. flava	ARG(CAT, COR, COS, JUJ, LRI, SAL, SJU, SLU, SDE, TUC)
Argyrochosma nivea var. tenera	ARG(BAI, CAT, COR, JUJ, LPA, LRI, MEN, SAL, SJU, SLU, TUC)
Aristida achalensis	ARG(CAT, COR, JUJ, LRI, SAL, SLU, TUC)
Aristida adscensionis	ARG(BAI, CAT, CHA, COR, COS, DFE, ERI, FOR, JUJ, LPA, LRI, MEN, SAL, SJU, SLU, SFE, SDE, TUC) / CHL(TAR, ANT, ATA, COQ, VAL, RME) / PRY(APY, BOQ)
Aristida antoniana	ARG(JUJ, SAL, TUC)
Aristida asplundii var. pauciflora	ARG(SAL)
Aristida asplundii var. asplundii	ARG(JUJ, SAL, TUC)
Aristida brasiliensis	BRA(PAR, SCA)
Aristida circinalis	ARG(BAI, CAT, CHA, COR, COS, ERI, FOR, LPA, MEN, MIS, SAL, SLU, SFE, SDE, TUC) / BRA(PAR, RGS, SCA) / PRY(APY, AMA, BOQ, CAU, CEN, GUA, MIE, ÑEE, PAI, SPE) / URY(ART, CAS, COL, MAL, MON, PAY, RNO, RIV, SAO, SJO, SOR, TAC)
Aristida condylifolia	ARG(COS, ERI) / BRA(RGS) / PRY(PAI)
Aristida constricta	BRA(RGS)
Aristida echinulata	BRA(RGS) / URY(ART, FLA, PAY, RNO, RIV, SAO, SJO, TAC)
Aristida ekmaniana	BRA(PAR)
Aristida filifolia	BRA(RGS, SCA) / URY(CLA, COL, FLO, FLA, LAV, MAL, MON, PAY, RNO, RIV, SJO, SJO, TYT)
Aristida flaccida	BRA(PAR, RGS, SCA) / URY(TYT)
Aristida friesii	ARG(SAL)
Aristida glaziovii	BRA(RGS)
Aristida hackelii	URY(LAV, RNO, SJO, SOR)
Aristida hassleri	BRA(Fuera del área del proyecto) / PRY(AMA, COA)
Aristida helleriana	BRA(RGS)
Aristida jubata	ARG(BAI, CHA, COS, ERI, MIS, SFE) / BRA(PAR, RGS, SCA) / PRY(AMA, CAU, COA, MIE, PAI) / URY(ART, CLA, MAL, RIV, TAC)
Aristida laevis	ARG(BAI, CHA, COR, ERI, JUJ, MIS, SAL, SLU, SFE) / BRA(PAR, RGS, SCA) / URY(CLA, COL, CLA, LAV, MAL, RIV, ROC, TAC, TYT)
Aristida laxa var. longiramea	ARG(JUJ, SAL)
Aristida macrantha	PRY(AMA)
Aristida macrophylla	ARG(COS, MIS) / BRA(PAR, RGS, SCA) / PRY(AMA, CAN, CON, SPE)
Aristida megapotamica var. longipes	ARG(COS, MIS) / BRA(PAR) / PRY(CON)
Aristida megapotamica var. brevipes	ARG(COS) / BRA(PAR) / PRY(AMA, PAI)
Aristida megapotamica var. megapotamica	ARG(COS, MIS) / BRA(PAR, RGS, SCA) / PRY(PAI) / URY(RIV, TAC)
Aristida mendocina	ARG(BAI, CAT, CHA, COR, FOR, JUJ, LPA, LRI, MEN, RNE, SAL, SDE, SJU, SLU, TUC) / PRY(APY)
Aristida minutiflora var. glabriflora	ARG(COR, SLU)
Aristida minutiflora var. minutiflora	ARG(CAT, COR, LPA, MEN, SLU, SDE)
Aristida multiramea	ARG(COR, SLU)
Aristida murina	ARG(BAI, COS, DFE, ERI) / BRA(RGS) / URY(ART, CAS, CLA, FLO, FLA, LAV, MAL, MON, PAY, RNO, RIV, ROC, SAO, SJO, SJO, TYT)
Aristida nicorae	ARG(JUJ, SAL, TUC)
Aristida oligospira	ARG(COS, FOR) / BRA(Fuera del área del proyecto) / PRY(AMA)
Aristida pallens	ARG(BAI, CHU, COR, COS, ERI, LPA, MEN, MIS, RNE, SLU, SFE) / BRA(PAR, SCA) / CHL(MAU, BIO, ARA) / URY(ART, CLA, FLO, FLA, MAL, MON, RNO, SJO)
Aristida parodii	ARG(JUJ, SAL, TUC)
Aristida pedroensis	ARG(JUJ)
Aristida pubescens	ARG(JUJ, SAL)
Aristida recurvata	BRA(PAR)
Aristida riograndensis	ARG(CHA, COS) / BRA(RGS)
Aristida riparia	BRA(PAR)
Aristida sayapensis	ARG(SLU)
Aristida spegazzinii	ARG(BAI, CAT, CHA, CHU, COR, COS, ERI, JUJ, LPA, LRI, MEN, MIS, NEU, RNE, SAL, SLU, SFE, TUC) / BRA(PAR, RGS, SCA) / CHL(BIO, ARA) / URY(ART, CLA, COL, FLO, FLA, LAV, MAL, MON, PAY, RNO, RIV, ROC, SAO, SJO, SJO, TAC, TYT)
Aristida subulata	ARG(BAI, CAT, COR, LPA, MEN, RNE, SLU, TUC)
Aristida teretifolia	BRA(RGS, SCA) / URY(ART, FLO, FLA, LAV, MAL, MON, PAY, RIV, ROC, SAO, SJO, SJO)
Aristida trachyantha	ARG(BAI, LPA, MEN, RNE)
Aristida uruguayensis var. laevis	ARG(COR, COS, ERI) / BRA(RGS) / URY(RNO, SAO, SOR, TAC)
Aristida uruguayensis var. uruguayensis	ARG(BAI, CHA, COR, COS, ERI, SDE) / BRA(RGS) / URY(ART, CLA, COL, CLA, FLO, FLA, LAV, PAY, RNO, RIV, SAO, SJO, SJO, TAC)
Aristida valida	ARG(MIS)
Aristida venustula var. venustula	ARG(BAI, CHA, COR, COS, ERI, FOR, MIS, SFE, SDE, TUC) / BRA(RGS) / PRY(CAU, GUA, ITA, PAI) / URY(ART, CAS, CLA, COL, DUR, FLO, FLA, LAV, MAL, MON, PAY, RNO, RIV, ROC, SAO, SJO, SOR, TAC, TYT)
Aristida venustula var. scabrifolia	ARG(CHA)
Aristida venustula var. venustuloides	ARG(COS, ERI) / BRA(RGS)
Aristida vexativa	ARG(SFE)
Aristida victoriana	ARG(SAL)
Aristolochia angustifolia	ARG(CHA, COS, ERI, MIS) / BRA(RGS) / PRY(AMA, CEN, CON, COA, PAI, PHA, SPE) / URY(RNO, SJO, SJO)
Aristolochia argentina	ARG(CAT, CHA, COR, COS, JUJ, LRI, SAL, SLU, SDE, TUC) / PRY(AMA)
Aristolochia barbata ssp. benedicti	BRA(Fuera del área del proyecto) / PRY(AMA, CON)
Aristolochia bridgesii	CHL(ATA, COQ, RME)
Aristolochia burelae	ARG(SAL) / PRY(APY)
Aristolochia castellanosii	ARG(COS, MIS) / PRY(CEN, COA, GUA, PAI)
Aristolochia ceresensis	ARG(CAT, CHA, FOR, MIS, SFE, SDE) / PRY(BOQ, PHA)
Aristolochia chamissonis	BRA(PAR)
Aristolochia chilensis	CHL(ATA, COQ, VAL, RME)
Aristolochia curviflora	ARG(COS) / BRA(RGS)
Aristolochia elegans	ARG(CHA, COS, ERI, JUJ, MIS, SAL, SFE) / BRA(PAR, RGS, SCA) / PRY(AMA, CEN, CON, COA, PAI, SPE)
Aristolochia esperanzae var. esperanzae	ARG(CHA, FOR, JUJ, SAL, TUC) / PRY(APY, AMA, BOQ, CON, PAI, PHA)
Aristolochia fimbriata	ARG(BAI, CHA, COR, COS, ERI, FOR, MIS) / BRA(RGS, SCA) / PRY(CEN, COA, ITA, ÑEE, PAI) / URY(ART, PAY, SAO, SOR, TAC)
Aristolochia gibertii var. gibertii	ARG(COS, FOR) / BRA(Fuera del área del proyecto) / PRY(APY, AMA, BOQ, CAN, CEN, CON, COA, GUA, MIE, PAI, PHA, SPE)
Aristolochia holostylis	BRA(Fuera del área del proyecto) / PRY(AMA)
Aristolochia labiata	BRA(PAR, SCA)
Aristolochia lindneri	PRY(APY)
Aristolochia lingua	ARG(CAT, CHA, COR, ERI, JUJ, SAL, SDE, TUC) / PRY(APY, PHA)
Aristolochia malmeana	BRA(Fuera del área del proyecto) / PRY(AMA)
Aristolochia melanoglossa	ARG(CAT, JUJ, SAL, TUC)
Aristolochia melastoma	ARG(MIS) / BRA(PAR, SCA)
Aristolochia odoratissima	ARG(MIS) / BRA(PAR) / PRY(APA, APY, AMA, CAN, CEN, CON, COA, SPE)
Aristolochia paulistana	BRA(PAR, SCA)
Aristolochia prostrata	ARG(SAL)
Aristolochia ridicula	PRY(AMA)
Aristolochia robertii	BRA(RGS, SCA)
Aristolochia rojasiana	ARG(CHA, FOR) / BRA(Fuera del área del proyecto) / PRY(APY, CON, COA, PHA)
Aristolochia sessilifolia	ARG(COS, MIS) / BRA(PAR, RGS, SCA) / PRY(APA, CAU) / URY(ART, TAC)
Aristolochia stomachoidis	ARG(MIS) / BRA(Fuera del área del proyecto)
Aristolochia stuckertii	ARG(BAI, COR, COS, ERI, MIS) / URY(ART, RNO, SAO, SOR)
Aristolochia triangularis	ARG(BAI, COS, ERI, FOR, MIS) / BRA(PAR, RGS, SCA) / PRY(AMA, CAA, CAN, CEN, CON, COA, PAI, SPE) / URY(PAY, SOR)
Aristolochia trilobata	ARG(BAI, CHA, COS, ERI, MIS) / BRA(PAR, SCA) / PRY(APA, CAN, PHA) / URY(MON, ROC)
Aristolochia warmingii	BRA(Fuera del área del proyecto) / PRY(AMA)
Aristolochia wendeliana	BRA(PAR)
Aristotelia chilensis	ARG(CAT, CHU, LPA, LRI, MEN, NEU, RNE, SJU, SLU) / CHL(COQ, VAL, LBO, MAU, BIO, ARA, LLA, AIS, RME, JFE)
Arjona longifolia	ARG(CAT, CHU, LRI, MEN, NEU, RNE, SJU)
Arjona megapotamica	BRA(RGS, SCA)
Arjona patagonica	ARG(BAI, CHU, LPA, MEN, NEU, RNE, SCR, SJU, TDF) / CHL(COQ, VAL, LBO, ARA, MAG)
Arjona pusilla	ARG(CHU, MEN, NEU, SCR, SJU, TDF) / CHL(AIS, MAG)
Arjona tuberosa var. tuberosa	ARG(CHU, LPA, MEN, NEU, RNE, SCR, TDF) / CHL(MAU, ARA, AIS, MAG)
Arjona tuberosa var. tandilensis	ARG(BAI, CHU, COR, LPA, MEN, NEU, RNE) / URY(MON)
Armeria maritima	ARG(CHU, COR, MEN, NEU, RNE, SCR, TDF) / CHL(COQ, VAL, LBO, MAU, BIO, ARA, LLA, AIS, MAG, RME)
Arnica angustifolia	ARG(NEU) / CHL(LLA)
Arquita mimosifolia	ARG(CAT, COR, JUJ, LPA, LRI, SAL, SJU, SLU, TUC)
Arquita trichocarpa	ARG(CAT, JUJ, SAL, TUC)
Arrhenatherum elatius var. elatius	ARG(BAI, CHU, MEN, NEU, RNE, SCR, SFE, TDF) / BRA(RGS) / CHL(BIO, ARA, LLA, RME) / URY(RNO)
Arrhenatherum elatius var. bulbosum	ARG(NEU, TDF) / CHL(VAL, BIO, ARA, LLA, MAG)
Artemisia abrotanum	ARG(NEU, RNE, SFE, TDF)
Artemisia absinthium	ARG(BAI, CAT, CHU, DFE, MEN, MIS, NEU, RNE, SAL, SJU, SCR, TDF) / BRA(RGS, SCA) / CHL(VAL, MAU, BIO, ARA, LLA, MAG, JFE)
Artemisia annua	ARG(BAI, COR, DFE, ERI, LPA, NEU, SAL, SFE, SJU, TUC)
Artemisia copa var. copa	ARG(CAT, JUJ, SAL, SJU) / CHL(TAR, ANT, ATA, VAL)
Artemisia copa var. trifida	CHL(ANT)
Artemisia douglasiana	ARG(COR, LRI, MEN, SJU, SLU)
Artemisia echegarayi	ARG(CAT, LRI, MEN, SJU)
Artemisia magellanica	ARG(CHU, MEN, NEU, RNE, SCR, TDF) / CHL(MAG)
Artemisia mendozana var. paramilloënsis	ARG(MEN)
Artemisia mendozana var. mendozana	ARG(CAT, LRI, MEN, SJU)
Artemisia verlotorum	ARG(BAI, CHA, CHU, COR, DFE, ERI, JUJ, LPA, MEN, MIS, NEU, RNE, SAL, SJU, SLU, SCR, SFE, TUC) / BRA(PAR, RGS, SCA) / URY(CLA, FLA, MON, RNO)
Arthropogon villosus	BRA(PAR)
Arthropogon xerachne	BRA(PAR)
Arthropteris altescandens	CHL(JFE)
Arthrosia auriculata	BRA(PAR, RGS, SCA)
Arthrosia caldensis	BRA(PAR)
Arthrosia floribunda	BRA(PAR, SCA)
Arthrosia hygrophila	ARG(MIS) / BRA(PAR, RGS, SCA) / URY(CLA)
Arthrosia malachantha	BRA(PAR)
Arthrosia muscosa	ARG(MIS) / BRA(PAR)
Arthrosia myrticola	BRA(PAR, RGS)
Arum italicum	ARG(BAI, LPA) / URY(CAS, MON)
Arundinella berteroniana	ARG(ERI, FOR, SAL) / BRA(PAR)
Arundinella hispida	ARG(CHA, COS, ERI, FOR, JUJ, MIS, SAL, SFE, TUC) / BRA(PAR, RGS, SCA) / PRY(CAA, CEN, COA, GUA, MIE, PAI, SPE) / URY(ART, PAY, RNO, RIV)
Arundo donax	ARG(BAI, CAT, CHA, COR, DFE, ERI, FOR, LPA, LRI, MEN, MIS, SAL, SJU, SLU, SFE) / BRA(RGS) / CHL(TAR, ANT, ATA, COQ, ARA, RME, IPA)
Aschersoniodoxa cachensis	ARG(CAT, JUJ, SAL, TUC)
Asclepias aequicornu	ARG(MIS) / BRA(PAR, SCA) / PRY(CAN, CEN)
Asclepias barjoniaefolia	ARG(JUJ, SAL, TUC)
Asclepias boliviensis	ARG(CAT, CHA, FOR, JUJ, SAL, SDE, TUC)
Asclepias bracteolata	BRA(SCA)
Asclepias candida	ARG(MIS) / BRA(PAR) / PRY(AMA, CAU, COA, PAI, SPE) / URY(RIV)
Asclepias curassavica	ARG(BAI, CAT, CHA, COS, ERI, FOR, JUJ, MIS, SAL, SFE, SJU, TUC) / BRA(PAR, RGS, SCA) / CHL(TAR) / PRY(CEN, COA, GUA, PAI)
Asclepias fruticosa	ARG(BAI, ERI, SJU) / URY(CAS, MON, SOR, TYT)
Asclepias langsdorfii	BRA(PAR, SCA) / PRY(CAN)
Asclepias mellodora	ARG(BAI, CHA, COR, COS, ERI, FOR, JUJ, LPA, MIS, RNE, SAL, SDE, SFE, SLU, TUC) / BRA(PAR, RGS, SCA) / PRY(AMA, CAN, COA, GUA, ITA, ÑEE, PAI, SPE) / URY(ART, CLA, COL, FLA, LAV, MON, PAY, RNO, ROC, SAO, SJO, SOR, TAC)
Asclepias pilgeriana	ARG(CAT, JUJ, LRI, SAL, TUC)
Asclepias selloana	BRA(PAR)
Asemeia extraaxillaris	ARG(CHA, COS, FOR, JUJ, MIS, SAL, SFE, SDE, TUC) / BRA(PAR, RGS, SCA) / PRY(APA, APY, AMA, BOQ, CAU, CAA, CAN, CEN, CHO, CON, GUA, MIE, PAI, PHA, SPE)
Asemeia hebeclada	BRA(PAR, SCA) / PRY(COA)
Asemeia hirsuta	BRA(PAR)
Asemeia rhodoptera	BRA(PAR)
Asemeia tobatiensis	PRY(COA)
Asemeia violacea	BRA(PAR)
Asparagus asparagoides	ARG(BAI, LPA) / URY(CAS, MAL)
Asparagus densiflorus	ARG(BAI, LPA, SFE, TUC) / URY(MON)
Asparagus officinalis var. altilis	ARG(BAI, COR, DFE, ERI, LPA, LRI, MEN, RNE, SAL, SDE, SJU, SLU, TUC) / URY(CAS)
Asparagus scoparius	ARG(LPA)
Asparagus setaceus	ARG(BAI, COS, DFE, LPA, SFE)
Aspasia lunata	BRA(PAR, RGS, SCA)
Asperugo procumbens	ARG(SCR)
Asphodelus fistulosus	ARG(COR, LPA) / CHL(ATA)
Aspicarpa pulchella	ARG(COS, MIS) / BRA(PAR, RGS) / PRY(CAU, CAN, CEN, CON, SPE) / URY(ART, CLA, RIV)
Aspicarpa salicifolia	ARG(COS, MIS) / BRA(Fuera del área del proyecto) / PRY(PAI)
Aspicarpa schininii	ARG(JUJ) / BRA(Fuera del área del proyecto) / PRY(CEN, PAI)
Aspicarpa sericea	ARG(CHA, COR, FOR, JUJ, SAL, SDE, TUC) / PRY(APY)
Aspicarpa uruguariensis	URY(TAC)
Aspidogyne argentea	BRA(PAR, RGS, SCA) / PRY(CAU, CAN, CON, COA, PAI)
Aspidogyne bicolor	BRA(PAR, RGS, SCA) / PRY(APY, CAN)
Aspidogyne bidentifera	ARG(COS, MIS) / BRA(PAR, RGS, SCA) / PRY(CEN)
Aspidogyne bruxellii	ARG(COS, MIS) / BRA(PAR, RGS, SCA)
Aspidogyne fimbrillaris	BRA(PAR, RGS, SCA)
Aspidogyne foliosa	BRA(PAR) / PRY(CAN)
Aspidogyne kuczynskii	ARG(CHA, COS, MIS) / BRA(PAR, RGS, SCA) / PRY(APA, AMA, COA, GUA, SPE)
Aspidogyne lindleyana	ARG(MIS) / BRA(RGS, SCA)
Aspidogyne longicornu	BRA(RGS, SCA)
Aspidogyne malmei	ARG(MIS) / BRA(RGS)
Aspidosperma australe	ARG(COS, MIS) / BRA(PAR, RGS, SCA) / PRY(APA, AMA, CAU, CAN, CON, GUA, ITA, PAI, PHA, SPE)
Aspidosperma camporum	BRA(PAR, SCA)
Aspidosperma cuspa	BRA(Fuera del área del proyecto) / PRY(COA)
Aspidosperma cylindrocarpon	BRA(PAR) / PRY(AMA, CON)
Aspidosperma macrocarpon	BRA(Fuera del área del proyecto) / PRY(AMA, CAN, CON)
Aspidosperma polyneuron	ARG(MIS) / BRA(PAR) / PRY(APA, AMA, CAU, CAN)
Aspidosperma pyricollum	BRA(PAR, SCA) / PRY(CON)
Aspidosperma pyrifolium	BRA(Fuera del área del proyecto) / PRY(APY, AMA, CON, PHA)
Aspidosperma quebracho-blanco	ARG(CAT, CHA, COR, COS, ERI, FOR, JUJ, LRI, SAL, SDE, SFE, SJU, SLU, TUC) / PRY(APY, CEN, CON, ÑEE, PAI, PHA) / URY(ART, PAY, RNO, RIV, SAO, SJO)
Aspidosperma ramiflorum	BRA(RGS, SCA)
Aspidosperma riedelii	BRA(RGS) / PRY(CAU, CEN, CON)
Aspidosperma subincanum	BRA(Fuera del área del proyecto) / PRY(AMA)
Aspidosperma tomentosum	BRA(PAR, SCA) / PRY(AMA, CAN, CON)
Aspidosperma triternatum	ARG(CHA, COS, FOR, JUJ, SAL, SFE) / PRY(APY, CON, PHA)
Aspilia attenuata	BRA(PAR)
Aspilia aurantiaca var. aurantiaca	ARG(JUJ, SAL, TUC)
Aspilia aurantiaca var. vulcanica	ARG(JUJ)
Aspilia camporum	PRY(AMA, CAN, CON, PAI)
Aspilia clausseniana	ARG(COS) / BRA(PAR) / PRY(AMA, CEN, COA, GUA, PAI)
Aspilia floribunda	BRA(PAR)
Aspilia foliacea	BRA(PAR, RGS) / PRY(CAU)
Aspilia hassleriana	PRY(APA)
Aspilia latissima	BRA(PAR) / PRY(PAI)
Aspilia leucanthema	PRY(AMA, CON, SPE)
Aspilia linearis	ARG(MIS)
Aspilia montevidensis	ARG(CHA, COS, ERI, FOR, MIS, SFE) / BRA(PAR, RGS, SCA) / PRY(AMA, CAU, CAA, CAN, CEN, CON, COA, GUA, ITA, MIE, PAI, PHA, SPE) / URY(ART, CAS, CLA, CLA, LAV, MON, PAY, RIV, ROC, TAC, TYT)
Aspilia pascalioides	ARG(BAI, CHA, COS, ERI, FOR, MIS, SFE) / BRA(PAR, RGS) / PRY(APA, COA, GUA, MIE, ÑEE, PAI, PHA) / URY(ART, CLA, RNO, RIV, SAO, SJO, TYT)
Aspilia phyllostachya	PRY(CON)
Aspilia reflexa	BRA(PAR, SCA) / PRY(CEN)
Aspilia riedelli	PRY(CAU)
Aspilia silphioides	ARG(BAI, CHA, COS, ERI, FOR, MIS, SDE, SFE) / BRA(PAR) / PRY(AMA, CEN, COA, ÑEE, PHA) / URY(MON, RNO, SJO)
Asplenium abscissum	ARG(MIS, SAL) / BRA(PAR, RGS, SCA) / PRY(CAN, SPE) / URY(CLA, RIV, ROC, TAC, TYT)
Asplenium achalense	ARG(COR, SAL, SLU, TUC)
Asplenium alatum	ARG(MIS) / BRA(PAR, RGS, SCA)
Asplenium argentinum	ARG(CAT, COR, JUJ, MIS, SAL, SLU, TUC)
Asplenium auriculatum	ARG(MIS) / BRA(PAR, RGS, SCA) / PRY(APA, AMA, CAN)
Asplenium auritum	ARG(CAT, JUJ, MIS, SAL, TUC) / BRA(PAR, RGS, SCA) / PRY(APA, CAN, SPE)
Asplenium balansae	ARG(MIS) / BRA(PAR, RGS) / PRY(APA, CAN, COA, PAI)
Asplenium bradei	BRA(RGS)
Asplenium brasiliense	ARG(MIS) / BRA(PAR, RGS, SCA) / PRY(CAU, CAA, CEN, GUA, PAI)
Asplenium campos-portoi	BRA(PAR)
Asplenium castaneum	ARG(MEN) / BRA(Fuera del área del proyecto) / CHL(MAG)
Asplenium claussenii	ARG(JUJ, MIS, TUC) / BRA(PAR, RGS, SCA) / PRY(AMA, CAA, CAN, COA, GUA, PAI) / URY(TAC)
Asplenium cristatum	BRA(RGS, SCA)
Asplenium cuspidatum	ARG(JUJ, MIS, SAL, TUC)
Asplenium dareoides	ARG(BAI, CHU, NEU, RNE, SCR, TDF) / CHL(COQ, VAL, LBO, MAU, BIO, ARA, LLA, AIS, MAG, JFE)
Asplenium depauperatum	ARG(CAT, CHA, COR, JUJ, MIS, SAL, SLU, TUC) / BRA(Fuera del área del proyecto) / PRY(CEN, COA, GUA, PAI)
Asplenium drepanophyllum	PRY(PAI, SPE)
Asplenium feei	BRA(PAR, SCA)
Asplenium flabellulatum	BRA(PAR) / PRY(PAI)
Asplenium formosum	ARG(COR, COS, JUJ, MIS, SAL, SLU, TUC) / BRA(Fuera del área del proyecto) / PRY(CAN)
Asplenium gastonis	ARG(COS, MIS) / BRA(PAR, RGS, SCA) / PRY(APY, APA, CEN, GUA, PAI, SPE) / URY(RIV, TAC, TYT)
Asplenium gilliesii	ARG(BAI, CAT, COR, JUJ, LRI, MEN, SAL, SLU, TUC) / CHL(TAR)
Asplenium harpeodes	ARG(JUJ, SAL) / BRA(PAR, RGS, SCA)
Asplenium inaequilaterale	ARG(JUJ, MIS, SAL) / BRA(PAR, RGS, SCA) / PRY(CAA, GUA, PAI) / URY(TAC)
Asplenium incurvatum	BRA(PAR, RGS, SCA)
Asplenium kunzeanum	ARG(MIS) / BRA(PAR, RGS, SCA)
Asplenium lacinulatum	BRA(PAR)
Asplenium lilloanum	ARG(COR, JUJ, SAL, TUC)
Asplenium lorentzii	ARG(BAI, CAT, COR, JUJ, SAL, TUC)
Asplenium macrosorum	CHL(JFE)
Asplenium martianum	BRA(PAR, RGS, SCA)
Asplenium monanthes	ARG(BAI, CAT, COR, JUJ, LRI, SAL, SLU, TUC) / BRA(RGS, SCA) / CHL(ARA, LLA, AIS, MAG) / URY(MAL)
Asplenium mucronatum	ARG(MIS) / BRA(PAR, RGS, SCA) / PRY(APA, CAU, CAN, SPE)
Asplenium muellerianum	BRA(PAR, SCA)
Asplenium obtusatum var. sphenoides	CHL(VAL, LBO, MAU, BIO, ARA, LLA, AIS, MAG, JFE)
Asplenium oligophyllum	ARG(COS) / BRA(PAR, RGS, SCA) / PRY(CEN)
Asplenium otites	BRA(PAR) / PRY(PAI)
Asplenium palmeri	ARG(COR, LRI, SAL, TUC)
Asplenium papaverifolium	ARG(CHU, MEN, NEU, RNE, SCR, TDF) / CHL(COQ, VAL, LBO, MAU, BIO, ARA, LLA, AIS, RME)
Asplenium peruvianum	ARG(JUJ, SAL) / CHL(ANT)
Asplenium praemorsum	ARG(CAT, COR, JUJ, SAL, TUC) / BRA(SCA)
Asplenium pseudonitidum	BRA(PAR, RGS, SCA)
Asplenium pteropus	BRA(PAR, SCA)
Asplenium pulchellum	ARG(MIS) / BRA(RGS, SCA)
Asplenium pumilum	ARG(JUJ, SAL, TUC)
Asplenium raddianum	BRA(PAR, RGS, SCA)
Asplenium radicans var. cirrhatum	BRA(PAR, SCA)
Asplenium radicans var. radicans	ARG(MIS) / BRA(PAR, RGS, SCA)
Asplenium resiliens	ARG(BAI, CAT, COR, JUJ, LRI, MEN, SAL, SJU, SLU, SDE, TUC) / BRA(RGS, SCA) / URY(COL, RNO, SAO)
Asplenium scandicinum	ARG(MIS) / BRA(PAR, RGS, SCA)
Asplenium sellowianum	ARG(BAI, COR, COS, ERI, MIS) / BRA(PAR, RGS, SCA) / PRY(ITA) / URY(ART, CLA, LAV, MAL, RNO, ROC, SOR, TAC, TYT)
Asplenium serra	ARG(JUJ, MIS, SAL) / BRA(PAR, RGS, SCA) / URY(CLA, LAV, TYT)
Asplenium serratum	ARG(MIS) / BRA(PAR, RGS, SCA) / PRY(CAA, CAN)
Asplenium squamosum	ARG(JUJ, SAL, TUC) / BRA(SCA)
Asplenium stellatum	CHL(VAL, JFE)
Asplenium stuebelianum	ARG(FOR) / BRA(PAR) / PRY(APY, CAA)
Asplenium trilobum	ARG(CHU, NEU, RNE) / CHL(BIO, ARA, LLA, AIS)
Asplenium triphyllum	ARG(JUJ, TUC) / CHL(AYP, TAR, ANT, COQ)
Asplenium ulbrichtii	ARG(BAI, COR, COS, ERI, MIS) / BRA(PAR, RGS) / PRY(CEN) / URY(ART, CAS, DUR, FLA, LAV, MAL, PAY, RNO, SAO, SJO, SOR, TAC, TYT)
Asplenium uniseriale	ARG(MIS) / BRA(PAR, RGS, SCA) / PRY(CAU, GUA, PAI)
Asplenium wacketii	BRA(PAR)
Asplundia glaucophylla	BRA(PAR)
Asplundia polymera ssp. reitzii	BRA(SCA)
Astelia pumila	ARG(TDF) / CHL(LLA, AIS, MAG)
Asteranthera ovata	ARG(CHU, NEU, RNE) / CHL(MAU, BIO, ARA, LLA, AIS, MAG)
Asteriscium aemocarpon	CHL(COQ, LBO, RME)
Asteriscium argentinum	ARG(CHU, MEN, NEU, SLU)
Asteriscium chilense	CHL(ANT, ATA, COQ, VAL, LBO, MAU, BIO, ARA, LLA)
Asteriscium closii	CHL(ANT, ATA, COQ)
Asteriscium famatinense	ARG(LRI, MEN, SJU)
Asteriscium fimbriatum	ARG(LPA, NEU, RNE, SCR)
Asteriscium glaucum	ARG(JUJ, LRI, MEN, SAL, SJU, SLU)
Asteriscium novarae	ARG(SAL)
Asteriscium vidali	CHL(ATA)
Asteropsis megapotamica	BRA(RGS) / URY(RIV, TAC)
Asterostigma reticulatum	BRA(PAR, SCA)
Asterostigma tweedianum	BRA(PAR, SCA)
Astraea aureomarginata	PRY(SPE)
Astraea hauthalii	PRY(CAU, CAN, PAI)
Astraea lobata	ARG(CHA, COR, COS, ERI, FOR, JUJ, MIS, SAL, SDE, TUC) / BRA(PAR, RGS, SCA) / PRY(APY, GUA, PAI, PHA) / URY(ART, PAY, RNO, SAO, SOR, TAC)
Astragalus amatus	CHL(ATA, COQ, VAL, LBO, MAU, BIO, ARA, RME)
Astragalus ameghinoi	ARG(CHU, NEU, RNE, SCR)
Astragalus anni-novi	ARG(CHU, NEU, RNE)
Astragalus arequipensis	ARG(CAT, JUJ, LRI, SAL, SJU, TUC) / CHL(TAR, ANT)
Astragalus argentinus	ARG(BAI)
Astragalus arnottianus	ARG(MEN, SJU) / CHL(COQ, VAL, LBO, RME)
Astragalus asplundii	ARG(JUJ, LRI, SJU)
Astragalus austroargentinus	ARG(SCR)
Astragalus bellus	ARG(MEN, SJU) / CHL(COQ)
Astragalus bergii	ARG(BAI, CAT, COR, LPA, MEN, RNE, SLU)
Astragalus berteri	CHL(ATA, COQ, VAL, LBO, MAU, BIO, ARA, RME)
Astragalus berterianus	CHL(COQ, VAL, LBO, MAU, BIO, RME)
Astragalus boelckei	ARG(CAT, LRI, MEN, SJU)
Astragalus bonariensis	ARG(BAI, MEN, NEU, RNE)
Astragalus burkartii	ARG(CAT, JUJ, SAL, TUC)
Astragalus bustillosii	ARG(CAT, JUJ, MEN, SAL, SJU, TUC) / CHL(AYP, TAR, ANT, ATA, COQ)
Astragalus cachinalensis	CHL(ANT, ATA)
Astragalus carinatus	ARG(COR, MEN, SAL, TUC)
Astragalus chamissonis	ARG(MEN, NEU, RNE) / CHL(ATA, COQ, VAL, LBO, MAU, BIO, ARA, RME)
Astragalus chubutensis	ARG(CHU, NEU, SAL, SCR)
Astragalus colhuensis	ARG(CHU)
Astragalus complicatus	ARG(MEN)
Astragalus confinis	CHL(TAR)
Astragalus coquimbensis	CHL(ANT, ATA, COQ)
Astragalus cruckshanksii	ARG(CHU, MEN, NEU, RNE, SCR, SJU) / CHL(ATA, COQ, VAL, LBO, MAU, MAG, RME)
Astragalus crymophilus	ARG(JUJ)
Astragalus cryptanthus	CHL(TAR)
Astragalus crypticus	ARG(JUJ, SAL, SJU, TUC)
Astragalus cryptobotrys	ARG(CAT, JUJ, LRI, SAL, SJU, TUC) / CHL(TAR, ANT)
Astragalus curvicaulis	CHL(COQ, VAL, LBO, RME)
Astragalus cuyanus	ARG(MEN, SJU)
Astragalus darumbium	ARG(MEN, NEU) / CHL(LBO, RME)
Astragalus darwinianus	ARG(SCR)
Astragalus diminutivus var. diminutivus	ARG(JUJ, SAL) / CHL(TAR)
Astragalus diminutivus var. dielsii	ARG(JUJ, SAL)
Astragalus distinens	ARG(BAI, CAT, COR, ERI, JUJ, LPA, MEN, SAL, SDE, SFE, SLU, TUC) / URY(COL, MON, RNO, SJO, SOR)
Astragalus dodtii	CHL(ANT, ATA, COQ)
Astragalus domeykoanus	ARG(CHU, NEU, SCR) / CHL(MAU, BIO, ARA)
Astragalus edmonstonei	CHL(ATA, COQ, VAL, LBO, MAU)
Astragalus fabrisii	ARG(JUJ, SAL)
Astragalus famatinae	ARG(CAT, LRI, SAL, SJU, TUC)
Astragalus flavocreatus	ARG(CAT, LRI, SAL, TUC)
Astragalus garbancillo	ARG(CAT, JUJ, LRI, MEN, SAL, SJU, TUC)
Astragalus germainii	CHL(VAL, LBO, MAU, RME)
Astragalus hickenii	ARG(MEN, RNE)
Astragalus hypsogenus	ARG(JUJ, SAL, TUC)
Astragalus illinii	ARG(CHU, RNE)
Astragalus joergensenii	ARG(CAT, JUJ, SAL, TUC)
Astragalus johnstonii	CHL(VAL, RME)
Astragalus limariensis	CHL(ANT, COQ)
Astragalus looseri	ARG(MEN, SJU) / CHL(COQ, VAL, LBO, RME)
Astragalus magellanicus	ARG(SCR) / CHL(MAG)
Astragalus maulensis	CHL(MAU)
Astragalus mendocinus	ARG(MEN)
Astragalus micranthellus	ARG(CAT, JUJ, SAL, TUC) / CHL(TAR, ANT)
Astragalus minimus	ARG(JUJ) / CHL(TAR)
Astragalus minutissimus	CHL(TAR)
Astragalus monteroi	CHL(ARA)
Astragalus monticola	ARG(MEN, NEU, SJU) / CHL(RME)
Astragalus moyanoi	ARG(CHU, NEU)
Astragalus nelidae	ARG(SJU)
Astragalus neoburkartianus	ARG(CHU, SCR)
Astragalus neocarpus	ARG(CHU)
Astragalus neuquenensis	ARG(CHU, NEU)
Astragalus nicorae	ARG(SJU)
Astragalus nivicola	ARG(CHU, NEU, RNE, SCR) / CHL(MAG)
Astragalus nudus	CHL(ATA, COQ, VAL)
Astragalus orthocarpus	CHL(LBO)
Astragalus palenae var. grandiflora	ARG(CHU, NEU, RNE, SCR)
Astragalus palenae var. palenae	ARG(CHU, NEU, RNE, SCR, TDF) / CHL(MAU, ARA, LLA, AIS, MAG)
Astragalus paposanus	CHL(ANT, COQ)
Astragalus parodii	ARG(COR)
Astragalus patagonicus	ARG(CHU, MEN, NEU, RNE, SCR) / CHL(MAG)
Astragalus pauranthus	ARG(CHU, MEN, RNE, SCR)
Astragalus pehuenches	ARG(CHU, LPA, MEN, NEU, RNE, SJU) / CHL(COQ, VAL, LBO, MAU, RME)
Astragalus peruvianus	ARG(CAT, JUJ, LRI, SAL, TUC)
Astragalus pissisii	CHL(ATA, COQ, VAL, MAU, RME)
Astragalus pulviniformis	ARG(SJU)
Astragalus punae	ARG(JUJ)
Astragalus pusillus	ARG(JUJ, LRI, SAL, TUC) / CHL(AYP, TAR, ANT)
Astragalus reichei	CHL(TAR, ANT)
Astragalus ruiz-lealii	ARG(MEN)
Astragalus sanctae-crucis	ARG(BAI, CHU, RNE, SCR)
Astragalus schinetorum	CHL(COQ)
Astragalus spegazzinii	ARG(NEU, RNE)
Astragalus tacorensis	ARG(JUJ, SAL, TUC) / CHL(TAR)
Astragalus tarijensis	ARG(CAT, JUJ, LRI, SAL, TUC)
Astragalus tehuelches	ARG(CHU, MEN, NEU)
Astragalus triflorus	CHL(TAR, ANT)
Astragalus uniflorus	ARG(SAL, TUC)
Astragalus urbanianus 	ARG(JUJ, SAL)
Astragalus vagus	CHL(ATA, COQ)
Astragalus valerianensis	CHL(ATA)
Astragalus valparadisiensis	CHL(VAL)
Astragalus venturii	ARG(CAT, JUJ, SAL, TUC)
Astragalus verticillatus	CHL(VAL, LBO, MAU, BIO)
Astragalus vesiculosus	ARG(MEN, NEU, SJU) / CHL(COQ, VAL, LBO, MAU, RME)
Astragalus weddellianus	ARG(CAT, JUJ, LRI, SAL, TUC)
Astragalus werdermannii	ARG(JUJ, TUC) / CHL(TAR)
Astrocaryum aculeatissimum	BRA(PAR, SCA)
Astrolepis sinuata	ARG(CAT, JUJ, SAL, TUC) / CHL(TAR)
Astronium balansae	ARG(CHA, COS, FOR, MIS, SFE) / BRA(RGS) / PRY(APA, CEN, COA, ITA, ÑEE, PAI, PHA)
Astronium fraxinifolium var. glabrum	ARG(MIS) / BRA(Fuera del área del proyecto) / PRY(APY, CEN, CON, PAI, PHA)
Astronium fraxinifolium var. fraxinifolium	BRA(Fuera del área del proyecto) / PRY(APY, CEN, CON, COA)
Astronium gracile var. acuminatum	PRY(CEN, COA, PAI)
Astronium gracile var. gracile	BRA(Fuera del área del proyecto) / PRY(CAU, CON, COA, GUA, PAI)
Astronium graveolens	BRA(PAR) / PRY(CAN, CEN, PAI, SPE)
Astronium urundeuva var. candollei	ARG(JUJ, SAL) / PRY(CON, PAI, SPE)
Astronium urundeuva var. urundeuva	ARG(CHA, JUJ, SAL) / BRA(Fuera del área del proyecto) / PRY(APY, AMA, CAA, CEN, CON, COA, PAI, PHA)
Ateleia glazioveana	ARG(MIS) / BRA(RGS, SCA) / PRY(CAN, CON)
Athenaea picta	BRA(PAR, SCA)
Athyana weinmanniifolia	ARG(JUJ, SAL) / PRY(APY, CON)
Athyrium dombeyi	ARG(BAI, COR, SAL, TUC) / BRA(RGS, SCA)
Atriplex ameghinoi	ARG(CHU, RNE, SCR)
Atriplex argentina	ARG(CAT, COR, JUJ, LRI, MEN, RNE, SAL, SDE, SFE, SJU, SLU, TUC)
Atriplex atacamensis	CHL(TAR, ANT, ATA)
Atriplex boecheri	ARG(MEN)
Atriplex braunii	ARG(CHU, SCR)
Atriplex chapinii	CHL(IDE)
Atriplex chilensis	CHL(VAL, BIO, ARA)
Atriplex chizae	CHL(TAR)
Atriplex clivicola	CHL(ANT, ATA)
Atriplex coquimbana	CHL(COQ)
Atriplex cordobensis ssp. cordobensis	ARG(CAT, COR, JUJ, LRI, SAL, SJU, SLU, SFE, SDE, TUC)
Atriplex cordobensis ssp. grandibracteata	ARG(CAT, JUJ, LRI, SAL, TUC)
Atriplex costellata	CHL(COQ, VAL)
Atriplex crenatifolia	ARG(COR, LPA, MEN, NEU, SJU, SLU)
Atriplex deserticola	ARG(CAT, JUJ, LRI, MEN, SAL, SJU) / CHL(ANT, ATA, COQ)
Atriplex eximia	ARG(FOR) / PRY(APY, PHA)
Atriplex frigida	ARG(CHU, SCR)
Atriplex glaucescens	CHL(TAR, ANT)
Atriplex heterosperma	ARG(BAI, LPA, MEN, RNE, SJU)
Atriplex hortensis	ARG(BAI, CHU, COR, LPA, LRI, MEN) / CHL(COQ, RME)
Atriplex imbricata var. imbricata	ARG(CAT, SAL) / CHL(TAR, ANT, ATA)
Atriplex imbricata var. foliolosa	CHL(IDE)
Atriplex lampa	ARG(BAI, CAT, CHU, COR, LPA, LRI, MEN, NEU, RNE, SAL, SCR, SJU, SLU, TUC)
Atriplex leuca	CHL(ATA, COQ)
Atriplex lithophila	ARG(LRI, MEN, SJU)
Atriplex madariagae	CHL(TAR, ANT)
Atriplex mendozensis	ARG(MEN)
Atriplex montevidense	ARG(BAI, CHA, CHU, COR, COS, ERI, FOR, LPA, LRI, MEN, RNE, SAL, SLU, SFE, SDE) / PRY(CEN, PHA) / URY(MON, RNO)
Atriplex mucronata	CHL(ANT, ATA, COQ)
Atriplex myriophylla	ARG(JUJ, LRI, SAL, SJU) / CHL(TAR)
Atriplex nitrophiloides	ARG(JUJ, SAL)
Atriplex nummularia	CHL(ANT, COQ)
Atriplex oreophila	ARG(LRI, MEN, SJU) / CHL(TAR, ATA, COQ)
Atriplex pamparum	ARG(BAI, CHA, COR, FOR, SAL, SFE, SDE, TUC) / PRY(APY, PHA)
Atriplex patagonica	ARG(BAI, CHU, LPA, MEN, RNE, SCR)
Atriplex patula	ARG(BAI, SFE) / CHL(ARA, LLA, MAG) / URY(CAS)
Atriplex peruviana	CHL(TAR)
Atriplex philippii	CHL(RME)
Atriplex prostrata	ARG(BAI, CHU, MEN, SJU, SFE) / CHL(COQ, MAU, BIO, ARA, LLA) / URY(CAS, MON)
Atriplex quixadensis	ARG(SLU)
Atriplex repanda	CHL(ATA, COQ, RME)
Atriplex rosea	ARG(BAI, CHU, COR, LPA, LRI, MEN, NEU, RNE, SJU, SLU, SCR, SDE) / CHL(COQ)
Atriplex sagittifolia	ARG(CHU, MEN, RNE, SCR)
Atriplex semibaccata	ARG(BAI, CAT, CHA, CHU, COR, ERI, FOR, JUJ, LPA, LRI, MEN, NEU, RNE, SAL, SDE, SFE, SJU, TUC) / CHL(ANT, ATA, COQ, VAL, RME)
Atriplex sorianoi	ARG(LRI, MEN, NEU, SJU)
Atriplex spegazzinii	ARG(CAT, LRI, MEN, SAL, SJU, SLU)
Atriplex suberecta	ARG(BAI, CAT, CHA, CHU, COR, ERI, FOR, JUJ, LPA, LRI, MEN, SAL, SJU, SFE, SDE) / CHL(ATA, COQ)
Atriplex taltalensis	CHL(ANT, ATA)
Atriplex tatarica	ARG(BAI, CHU, LPA, RNE, SCR) / CHL(RME)
Atriplex undulata	ARG(BAI, CHU, COR, LPA, MEN, RNE, SLU, SFE)
Atriplex vallenarensis	CHL(ATA, COQ)
Atriplex vulgatissima	ARG(BAI, CHU, SCR, TDF) / CHL(MAG)
Attalea anisitsiana	BRA(Fuera del área del proyecto) / PRY(AMA, CON)
Attalea dubia	BRA(PAR, RGS, SCA)
Attalea geraensis	BRA(Fuera del área del proyecto) / PRY(AMA, COA)
Aulonemia aristulata	BRA(PAR, SCA)
Aulonemia cincta	BRA(PAR)
Aulonemia effusa	BRA(PAR)
Aulonemia fimbriatifolia	BRA(PAR)
Aulonemia radiata	BRA(SCA)
Aureliana fasciculata var. longifolia	BRA(PAR)
Aureliana fasciculata var. fasciculata	ARG(MIS) / BRA(PAR, RGS, SCA) / PRY(APA, CAU, CAA, GUA, PAI, SPE)
Aureliana tomentosa	BRA(PAR, SCA)
Aureliana wettsteiniana	BRA(PAR, RGS, SCA)
Austrobrickellia arnottii	ARG(CAT, CHA, COR, ERI, JUJ, LRI, SAL, SJU, SLU, TUC) / PRY(APY, BOQ)
Austrobrickellia patens var. rhodolaena	ARG(CAT, JUJ, LRI, SAL, SJU)
Austrobrickellia patens var. tomentosa	ARG(CAT, CHA, COR, FOR, JUJ, LRI, SAL, SDE, TUC) / PRY(APY, BOQ)
Austrobrickellia patens	ARG(BAI, CAT, CHU, COS, ERI, FOR, JUJ, LPA, LRI, MEN, NEU, RNE, SAL, SJU, SLU, SDE, TUC) / PRY(APY, BOQ, PHA)
Austrocactus bertinii	ARG(CHU, MEN, NEU, RNE, SCR)
Austrocactus ferrarii	ARG(MEN)
Austrocactus patagonicus	ARG(CAT, CHU, LPA, MEN, NEU, RNE, SCR) / CHL(ARA, AIS)
Austrocactus philippii	ARG(MEN) / CHL(MAU)
Austrocactus spiniflorus	CHL(LBO, RME)
Austrocedrus chilensis	ARG(CHU, NEU, RNE) / CHL(VAL, LBO, MAU, BIO, ARA, LLA, RME)
Austrochthamalia major	BRA(Fuera del área del proyecto) / PRY(CAU)
Austrochthamalia teyucuarensis	ARG(MIS)
Austrocylindropuntia miquelii	CHL(ATA, COQ)
Austrocylindropuntia shaferi var. shaferi	ARG(JUJ)
Austrocylindropuntia shaferi var. humahuacana	ARG(JUJ)
Austrocylindropuntia verschaffeltii	ARG(CAT, JUJ, SAL, TUC)
Austrocylindropuntia vestita	ARG(JUJ, SAL)
Austroeupatorium inulifolium	ARG(BAI, CAT, CHA, CHU, COR, COS, DFE, ERI, FOR, JUJ, MIS, SAL, SFE, SDE, TUC) / BRA(PAR, RGS, SCA) / PRY(APA, AMA, CAU, CAA, CAN, CEN, COA, GUA, ITA, PAI, PHA, SPE) / URY(ART, CAS, COL, FLA, LAV, MAL, MON, PAY, RNO, RIV, ROC, SAO, SJO, SJO)
Austroeupatorium laetevirens	ARG(CHA, COS, MIS) / BRA(PAR, RGS) / PRY(APA, AMA, CAU, CAA, CEN, COA, GUA, MIE, PAI)
Austroeupatorium picturatum	ARG(MIS) / BRA(RGS, SCA)
Austrolycopodium alboffii	ARG(CHU, NEU, RNE, SCR, TDF) / CHL(LLA, AIS, MAG)
Austrolycopodium confertum	ARG(CHU, NEU, RNE, SCR, TDF) / CHL(LLA, AIS, MAG)
Austrolycopodium erectum	ARG(BAI, CHU, COR, JUJ, NEU, RNE, SAL) / BRA(RGS, SCA) / CHL(LLA)
Austrolycopodium magellanicum	ARG(CHU, JUJ, NEU, RNE, SCR, TDF) / CHL(BIO, ARA, LLA, AIS)
Austrolycopodium paniculatum	ARG(CHU, NEU, RNE, SCR) / CHL(BIO, ARA, LLA, AIS)
Austropeucedanum oreopansil	ARG(JUJ, SAL, TUC)
Austrostipa plumigera	ARG(SAL)
Avellanita bustillosii	CHL(VAL, LBO, RME)
Avena barbata	ARG(BAI, COR, DFE, LPA, MEN, NEU, RNE, TUC) / BRA(RGS) / CHL(ANT, COQ, VAL, LBO, MAU, BIO, ARA, LLA, RME, JFE) / URY(CAS, FLA, LAV, MON, SJO, SOR)
Avena byzantina var. byzantina	ARG(BAI, COR, COS, DFE, ERI, LPA, LRI, MEN, NEU, RNE, TDF) / URY(MON)
Avena byzantina var. biaristata	ARG(BAI, CHA, COR, DFE, ERI, LPA, NEU, RNE, SJU, SLU, TDF)
Avena byzantina var. hipomelanathera	ARG(BAI)
Avena fatua	ARG(BAI, CHA, COR, DFE, ERI, JUJ, LPA, MEN, NEU, RNE, SAL, SJU, SLU, SCR, SFE, SDE, TDF, TUC) / BRA(RGS, SCA) / CHL(VAL, LBO, MAU, BIO, ARA, LLA, RME, IPA) / URY(COL, MAL, MON, SOR)
Avena sativa var. macrathera	ARG(NEU, RNE)
Avena sativa var. setulosa	ARG(BAI, CHU, LPA)
Avena sativa var. subuniflora	ARG(BAI, LPA)
Avena sativa var. montana	ARG(BAI, COR, SDE, SLU)
Avena sativa var. sativa	ARG(BAI, CHU, COR, DFE, ERI, LPA, MEN, NEU, RNE, SLU, SCR, SFE, TDF) / BRA(PAR, RGS, SCA) / CHL(MAU, BIO, ARA, LLA, MAG)
Avena sativa var. chinensis	ARG(NEU, RNE, SCR)
Avena sativa var. pilosa	ARG(BAI, DFE, LPA, RNE)
Avena sterilis ssp. sterilis	ARG(BAI, COR, COS, DFE, ERI, SJU, SFE) / BRA(RGS) / CHL(RME) / URY(COL, MON, PAY, SAO, SJO, SOR)
Avena sterilis ssp. ludoviciana	ARG(BAI, COR, DFE, ERI, LPA, SFE, SLU) / URY(CAS, FLA, MAL, MON, PAY, SJO, SOR)
Avena strigosa	ARG(BAI, DFE, ERI, LPA, MIS, NEU, RNE) / BRA(RGS) / CHL(BIO, LLA)
Avenella flexuosa	ARG(CHU, SCR, TDF) / CHL(BIO, LLA, AIS, MAG)
Averrhoidium paraguaiense	PRY(AMA, CON)
Avicennia schaueriana	BRA(PAR, SCA)
Axonopus argentinus	ARG(CHA, COS, ERI, MIS, SFE) / BRA(PAR, RGS, SCA) / PRY(AMA, CEN, COA, GUA, PAI, PHA) / URY(ART, CLA, CLA, FLA, LAV, MON, PAY, RNO, RIV, ROC, SAO, SJO, SJO, TAC, TYT)
Axonopus aureus	BRA(PAR)
Axonopus brasiliensis	BRA(PAR, RGS, SCA) / PRY(AMA, CON, SPE)
Axonopus capillaris	BRA(PAR)
Axonopus chrysoblepharis	BRA(PAR) / PRY(AMA, CON)
Axonopus comans	BRA(PAR) / PRY(AMA, GUA)
Axonopus compressus	ARG(BAI, CHA, COR, COS, DFE, ERI, JUJ, MIS, SAL, SFE, TUC) / BRA(PAR, RGS, SCA) / PRY(CAU, CAA, CEN, COA, GUA, ITA, MIE, ÑEE, PAI) / URY(CAS, LAV, MON, RIV, SAO, TAC, TYT)
Axonopus equitans	BRA(PAR)
Axonopus fissifolius	ARG(BAI, CHA, COR, COS, ERI, FOR, JUJ, MIS, SAL, SFE, TUC) / BRA(PAR, RGS, SCA) / PRY(APA, AMA, CAU, CEN, CON, COA, GUA, ITA, MIE, PAI, PHA, SPE) / URY(ART, CAS, CLA, DUR, FLO, FLA, LAV, MAL, MON, PAY, RNO, RIV, ROC, SAO, SJO, SOR, TAC, TYT)
Axonopus leptostachyus	ARG(CHA, COS, FOR, MIS) / BRA(Fuera del área del proyecto) / PRY(ITA)
Axonopus marginatus	ARG(MIS) / BRA(PAR) / PRY(AMA)
Axonopus obtusifolius	ARG(MIS) / BRA(PAR, RGS, SCA)
Axonopus pellitus	BRA(PAR)
Axonopus polystachyus	BRA(PAR, RGS, SCA)
Axonopus pressus	BRA(PAR) / PRY(AMA, CAU, CAN, CON, ITA, SPE)
Axonopus purpusii	BRA(PAR, RGS) / PRY(AMA, CON, COA) / URY(CLA)
Axonopus rosengurttii	ARG(BAI, DFE) / URY(COL, MON, PAY, SAO, SOR)
Axonopus scoparius	BRA(PAR, SCA)
Axonopus siccus	ARG(COS, JUJ, MIS, SAL, TUC) / BRA(PAR, RGS, SCA) / PRY(AMA, CAU, CEN, CON, COA, GUA, ITA, MIE, ÑEE, PAI, SPE) / URY(ART, CLA, RIV, TAC)
Axonopus succulentus	PRY(PAI)
Axonopus suffultus	ARG(BAI, CHA, COR, COS, ERI, FOR, MIS, SFE) / BRA(PAR, RGS, SCA) / PRY(APA, AMA, CAU, CAA, CAN, COA, GUA, ITA, MIE, PAI, SPE) / URY(ART, CAS, CLA, COL, DUR, FLA, MON, PAY, RNO, ROC, SAO, SJO, TAC)
Axonopus uninodis	BRA(SCA) / PRY(AMA, GUA)
Ayapanopsis dydima	ARG(JUJ, SAL, TUC)
Ayapanopsis esperanzae	ARG(MIS) / PRY(AMA, COA, PAI)
Ayapanopsis tucumanensis	ARG(JUJ, SAL, TUC)
Ayenia acalyphifolia	ARG(SAL, SDE, TUC) / PRY(APY)
Ayenia aprica	ARG(COS, MIS) / BRA(RGS) / PRY(AMA, CAU, COA, GUA, ITA, ÑEE, PAI) / URY(TAC)
Ayenia cordobensis	ARG(CAT, COR, LRI, SDE, SJU, SLU)
Ayenia eliae	ARG(CHA, FOR, JUJ, LRI, MEN, SAL, SDE, SFE, SLU, TUC) / PRY(APY, PHA)
Ayenia krapovickasii	BRA(Fuera del área del proyecto) / PRY(APY, AMA, CEN, CON, COA, PAI, SPE)
Ayenia lingulata	ARG(CAT, COR, LRI, MEN, SAL, SDE, SJU, SLU, TUC)
Ayenia magna	PRY(APY)
Ayenia mansfeldiana	ARG(COS, ERI, MIS) / BRA(RGS) / PRY(CEN, CON, COA, PAI, SPE) / URY(ART, MON, RIV, SAO, TAC)
Ayenia nummularia	ARG(COS, MIS) / BRA(RGS) / PRY(APA, AMA)
Ayenia odonellii	ARG(CAT, CHA, COR, COS, ERI, FOR, LRI, SAL, SDE, SFE, TUC) / BRA(Fuera del área del proyecto) / PRY(APY, AMA, CON, COA, PHA, SPE)
Ayenia praecipua	ARG(COS, MIS) / BRA(Fuera del área del proyecto) / PRY(AMA, CAU, GUA, ITA)
Ayenia spinulosa	PRY(AMA, CON)
Ayenia subtilis	ARG(SAL)
Ayenia tomentosa	BRA(Fuera del área del proyecto) / PRY(APY, AMA, CAU, CAN, CEN, CON, COA, GUA, ITA, MIE, PAI, SPE)
Aylacophora deserticola	ARG(NEU)
Azara alpina	ARG(NEU) / CHL(LBO, MAU, BIO, ARA, LLA)
Azara celastrina	CHL(COQ, VAL, LBO, MAU, BIO, RME)
Azara dentata	CHL(COQ, VAL, LBO, MAU, BIO, ARA, RME)
Azara integrifolia	CHL(VAL, LBO, MAU, BIO, ARA, LLA, RME)
Azara lanceolata	ARG(CHU, NEU, RNE) / CHL(BIO, ARA, LLA, AIS)
Azara microphylla	ARG(CHU, NEU, RNE) / CHL(COQ, MAU, BIO, ARA, LLA)
Azara petiolaris	CHL(COQ, VAL, LBO, MAU, BIO, RME)
Azara salicifolia	ARG(CHA, COS, FOR, SFE)
Azara serrata var. serrata	CHL(COQ, VAL, LBO, MAU, BIO, ARA, LLA, RME)
Azara serrata var. fernandeziana	CHL(JFE)
Azara uruguayensis	BRA(PAR, RGS, SCA) / URY(ART, CLA, DUR, FLA, LAV, MAL, PAY, RIV, ROC, SAO, TAC, TYT)
Azolla cristata	ARG(CHA, COR, COS, ERI, LPA, MEN, SAL, TUC) / BRA(Fuera del área del proyecto) / PRY(APY, BOQ, CAA, CEN)
Azolla filiculoides	ARG(BAI, CAT, CHA, COR, COS, ERI, FOR, JUJ, LPA, LRI, MEN, RNE, SAL, SJU, SCR, SFE) / BRA(RGS, SCA) / CHL(TAR, ANT, ATA, COQ, VAL, LBO, MAU, BIO, ARA, LLA, MAG, RME) / PRY(APA, APY, CEN, COA, ITA, ÑEE, PHA) / URY(MAL, MON, ROC)
Azorella acaulis	ARG(CHU, SCR, TDF) / CHL(AIS, MAG)
Azorella albovaginata	ARG(CHU, MEN, NEU) / CHL(MAU)
Azorella albovaginata var. pauciflorum	CHL(LBO, MAU)
Azorella ameghinoi	ARG(CHU, NEU, RNE, SCR) / CHL(AIS, MAG)
Azorella andina	ARG(CHU, NEU, RNE, SCR) / CHL(BIO, ARA, MAG)
Azorella atacamensis	ARG(SAL) / CHL(ANT, ATA)
Azorella biloba	ARG(COR, JUJ, SAL, TUC) / CHL(ANT)
Azorella boelckei	ARG(NEU, RNE) / CHL(LLA, AIS)
Azorella burkartii	ARG(NEU, RNE, SCR) / CHL(ARA, MAG)
Azorella compacta	ARG(CAT, JUJ, LRI, SAL) / CHL(TAR, ANT)
Azorella concolor	ARG(CHU, SCR) / CHL(MAG)
Azorella crassipes	ARG(NEU, RNE) / CHL(BIO)
Azorella cryptantha	ARG(CAT, LRI, MEN, SAL, SJU) / CHL(ATA, COQ)
Azorella diapensioides	ARG(JUJ)
Azorella diversifolia var. antillanca	CHL(LLA)
Azorella diversifolia var. diversifolia	ARG(NEU, SCR) / CHL(MAU, BIO, ARA, LLA)
Azorella echegarayi	ARG(MEN, SJU)
Azorella echinus	ARG(CHU, MEN, NEU, RNE, SJU)
Azorella filamentosa	ARG(TDF) / CHL(MAG)
Azorella fuegiana	ARG(CHU, NEU, SCR, TDF) / CHL(MAG)
Azorella hallei	ARG(CHU, SCR)
Azorella lycopodioides	ARG(CHU, MEN, NEU, RNE, SCR, TDF) / CHL(LBO, MAU, BIO, ARA, LLA, AIS, MAG)
Azorella madreporica	ARG(CHU, MEN, NEU, RNE, SCR, SJU) / CHL(ATA, COQ, VAL, LBO, MAU, ARA, RME)
Azorella microphylla	ARG(CHU, NEU, RNE, SCR)
Azorella monantha	ARG(CHU, MEN, NEU, RNE, SCR, TDF) / CHL(COQ, MAU, BIO, ARA, AIS, MAG, RME)
Azorella monteroi	CHL(ARA)
Azorella nivalis	ARG(NEU, RNE) / CHL(BIO, ARA, LLA)
Azorella patagonica	ARG(CHU, SCR) / CHL(MAG)
Azorella prolifera	ARG(BAI, CHU, LPA, LRI, MEN, NEU, RNE, SJU, SCR) / CHL(ATA, COQ, VAL, LBO, MAU, BIO, ARA, AIS, MAG, RME)
Azorella ranunculus	ARG(SCR, TDF) / CHL(LLA, AIS, MAG)
Azorella ruizii	ARG(MEN, SJU, SCR) / CHL(ATA, COQ, VAL, LBO, MAU, AIS, RME)
Azorella selago	ARG(SCR, TDF) / CHL(MAG)
Azorella spinosa	CHL(COQ, VAL, LBO, MAU, BIO, ARA, LLA, RME)
Azorella trifoliolata	ARG(CHU, MEN, NEU, RNE, SCR, SJU) / CHL(ATA, COQ, BIO, ARA, LLA, AIS, MAG, RME)
Azorella trifurcata	ARG(CHU, MEN, NEU, RNE, SCR, SJU, TDF) / CHL(ATA, LBO, MAU, BIO, ARA, AIS, MAG)
Azorella ulicina	ARG(CAT, JUJ, LRI, MEN, SAL, SJU, TUC)
