Cabomba caroliniana var. caroliniana	ARG(BAI, COS, ERI, RNE, SFE) / BRA(Fuera del área del proyecto) / PRY(APY, BOQ, CEN, ÑEE, PHA, SPE) / URY(SOR)
Cabomba furcata	BRA(PAR)
Cabralea canjerana	ARG(COS, MIS) / BRA(PAR, RGS, SCA) / PRY(APA, AMA, CAN, COA, GUA)
Cabreraea andina	ARG(LRI, SJU)
Caesalpinia angulata	CHL(ATA, COQ)
Caesalpinia argentina	ARG(JUJ)
Caesalpinia coluteifolia	ARG(SAL, SDE, TUC) / PRY(APY)
Caesalpinia coulterioides	ARG(JUJ, SAL)
Caesalpinia decapetala	BRA(PAR, SCA)
Caesalpinia echinata	BRA(SCA)
Caesalpinia exilifolia	ARG(CAT, SAL, TUC)
Caesalpinia fimbriata	ARG(CAT, TUC)
Caesalpinia gilliesii	ARG(BAI, CAT, CHA, COR, COS, DFE, ERI, LPA, LRI, MEN, NEU, RNE, SAL, SJU, SLU, SFE, SDE, TUC) / CHL(TAR, ATA, COQ, VAL, RME) / URY(COL, MON, PAY, SAO)
Caesalpinia marginata	BRA(Fuera del área del proyecto) / PRY(APY, AMA, CON)
Caesalpinia paraguariensis	ARG(CHA, COR, COS, FOR, JUJ, LRI, SAL, SDE, SFE, SLU, TUC) / PRY(APY, CEN, CON, ÑEE, PHA, SPE)
Caesalpinia pluviosa var. peltophoroides	BRA(PAR, SCA) / PRY(APA)
Caesalpinia pluviosa var. pluviosa	ARG(SAL) / BRA(Fuera del área del proyecto) / PRY(APY, AMA, CAN, CON)
Caesalpinia pulcherrima	BRA(SCA) / PRY(COA)
Caesalpinia spinosa	CHL(TAR, COQ, VAL)
Caesalpinia stuckerti	ARG(CHA, FOR, SAL, SDE, TUC) / PRY(APY)
Caesarea albiflora	ARG(MIS) / BRA(PAR, RGS, SCA) / URY(MON, TAC)
Caiophora aconquijae	ARG(CAT, TUC)
Caiophora arechavaletae	BRA(RGS) / URY(MON)
Caiophora boliviana	ARG(SAL)
Caiophora cernua	ARG(CAT, COR, JUJ, LRI, SAL, SJU, SLU, TUC)
Caiophora chuquitensis	ARG(CAT, JUJ, SAL, TUC) / CHL(ANT)
Caiophora cirsiifolia	CHL(TAR)
Caiophora clavata	ARG(CAT, JUJ, SAL, TUC)
Caiophora coronata	ARG(CAT, JUJ, LRI, MEN, SAL, SJU, TUC) / CHL(ANT, ATA, COQ, VAL, RME)
Caiophora deserticola	CHL(TAR)
Caiophora dumetorum	ARG(JUJ, LRI, MEN, SAL, TUC)
Caiophora hibiscifolia	ARG(JUJ, SAL, TUC)
Caiophora lateritia	ARG(CAT, JUJ, NEU, SAL, SDE, TUC)
Caiophora mollis	ARG(CAT, LRI, SAL)
Caiophora nivalis	ARG(CAT, JUJ, SAL, TUC)
Caiophora pulchella	ARG(MEN, SJU)
Caiophora rosulata ssp. rosulata	CHL(TAR, ANT)
Caiophora rosulata ssp. taraxacoides	ARG(CAT, JUJ, SAL, TUC)
Cajanus cajan	BRA(PAR, RGS, SCA) / PRY(CEN, COA, PAI)
Cakile maritima	ARG(BAI) / URY(MAL, ROC)
Caladium bicolor	BRA(Fuera del área del proyecto) / PRY(GUA)
Calandrinia acaulis	ARG(CAT, JUJ, LRI, SAL, TUC) / CHL(TAR, ATA)
Calandrinia affinis	ARG(MEN, NEU, RNE, SJU) / CHL(COQ, VAL, LBO, MAU, RME)
Calandrinia caespitosa	ARG(CHU, MEN, NEU, RNE, SCR, SJU, TDF, TUC) / CHL(ATA, COQ, VAL, MAU, ARA, MAG, RME)
Calandrinia carolinii	ARG(CAT, JUJ, LRI, SAL, TUC)
Calandrinia ciliata	ARG(BAI, CAT, JUJ, SAL, TDF, TUC) / CHL(VAL, LBO, BIO, LLA, RME)
Calandrinia colchaguensis	ARG(CHU, MEN, NEU, RNE) / CHL(LBO, MAU, BIO, ARA, LLA, RME)
Calandrinia compacta	ARG(CAT, JUJ, LRI, MEN, SAL, SJU, TUC) / CHL(TAR, ANT, ATA, COQ, RME)
Calandrinia compressa	CHL(TAR, COQ, VAL, LBO, MAU, BIO, ARA, LLA, RME)
Calandrinia fuegiana	ARG(SCR, TDF) / CHL(MAG)
Calandrinia graminifolia	ARG(MEN, NEU) / CHL(MAU)
Calandrinia monandra	ARG(CHU, MEN, NEU, RNE) / CHL(VAL, LBO, MAU, BIO, ARA, LLA, MAG, RME)
Calandrinia nitida	CHL(BIO, LLA)
Calandrinia ranunculina	ARG(SCR, TDF) / CHL(MAG)
Calandrinia skottsbergii	ARG(NEU, SCR) / CHL(ARA, AIS)
Calceolaria aiseniana	CHL(AIS)
Calceolaria alba	CHL(MAU, BIO, ARA)
Calceolaria andina var. andina	CHL(VAL, MAU, RME)
Calceolaria angustifolia	CHL(VAL, LBO, MAU)
Calceolaria arachnoidea ssp. nubigena	CHL(COQ, VAL, LBO, RME)
Calceolaria arachnoidea ssp. arachnoidea	CHL(MAU)
Calceolaria ascendens ssp. ascendens	CHL(COQ, VAL, RME)
Calceolaria ascendens ssp. glandulifera	CHL(COQ, VAL, LBO, RME)
Calceolaria ascendens ssp. pristiphylla	CHL(COQ, MAU, BIO)
Calceolaria ascendens ssp. exigua	CHL(VAL, RME)
Calceolaria asperula	CHL(LBO)
Calceolaria auriculata	CHL(MAU)
Calceolaria biflora	ARG(CHU, MEN, NEU, RNE, SJU, SCR, TDF, TUC) / CHL(BIO, ARA, AIS, MAG)
Calceolaria borsinii	ARG(NEU)
Calceolaria brunellifolia	ARG(CAT, LRI, MEN, SJU)
Calceolaria caleuana	CHL(VAL, RME)
Calceolaria campanae	CHL(VAL)
Calceolaria cana	CHL(COQ, VAL, LBO, MAU, BIO, ARA, RME)
Calceolaria cavanillesii	ARG(MEN, NEU) / CHL(MAU, BIO, ARA)
Calceolaria chelidonioides	ARG(JUJ, MIS, SAL)
Calceolaria collina ssp. conferta	CHL(COQ)
Calceolaria collina ssp. subincisa	CHL(ATA, COQ)
Calceolaria collina ssp. collina	CHL(COQ)
Calceolaria corymbosa ssp. montana	CHL(LBO, MAU)
Calceolaria corymbosa ssp. santiagina	CHL(VAL, LBO, RME)
Calceolaria corymbosa ssp. floccosa	ARG(MEN, NEU, RNE) / CHL(MAU)
Calceolaria corymbosa ssp. corymbosa	CHL(COQ, VAL, LBO, MAU, BIO, ARA, LLA, RME)
Calceolaria corymbosa ssp. mimuloides	CHL(COQ, VAL, RME)
Calceolaria corymbosa ssp. tetraphylla	CHL(BIO, ARA)
Calceolaria crenatiflora	ARG(CHU, NEU, RNE) / CHL(ARA, LLA)
Calceolaria densifolia ssp. laxa	CHL(VAL, RME)
Calceolaria densifolia ssp. densifolia	CHL(COQ)
Calceolaria dentata ssp. cumingiana	CHL(LBO, MAU)
Calceolaria dentata ssp. dentata	ARG(MEN, NEU) / CHL(VAL, MAU, BIO, ARA, LLA)
Calceolaria dentata ssp. araucana	ARG(NEU) / CHL(LLA)
Calceolaria elatior	ARG(JUJ, SAL)
Calceolaria fabrisii	ARG(CAT, JUJ, SAL, TUC)
Calceolaria filicaulis ssp. luxurians	ARG(CAT, CHU, LRI, MEN, NEU, SJU) / CHL(COQ, VAL, LBO, RME)
Calceolaria filicaulis ssp. filicaulis	ARG(CHU, MEN, NEU, RNE, SCR) / CHL(MAU, BIO, ARA, LLA)
Calceolaria flavovirens	CHL(ATA, COQ)
Calceolaria fothergillii	ARG(TDF)
Calceolaria georgiana	CHL(COQ)
Calceolaria germainii	ARG(CHU, COR, MEN, NEU, RNE, SLU) / CHL(MAU)
Calceolaria glacialis	ARG(CAT, JUJ, SAL, SJU, TUC)
Calceolaria glandulosa ssp. glandulosa	CHL(ANT, ATA, COQ, VAL, LBO, MAU, RME)
Calceolaria glandulosa ssp. alicahuensis	CHL(COQ, VAL)
Calceolaria hypericina	CHL(COQ, VAL, LBO, RME)
Calceolaria inamoena	CHL(TAR)
Calceolaria integrifolia	ARG(NEU) / CHL(VAL, BIO, ARA, LLA)
Calceolaria jujuyensis	ARG(JUJ, SAL)
Calceolaria lagunae-blancae	ARG(CHU, NEU, RNE, SCR)
Calceolaria lanigera	CHL(LBO)
Calceolaria latifolia	CHL(COQ, VAL)
Calceolaria lepida	CHL(COQ, VAL)
Calceolaria lepidota	ARG(CAT)
Calceolaria lilloi	ARG(JUJ, SAL)
Calceolaria meyeniana ssp. cheiranthoides	CHL(MAU)
Calceolaria meyeniana ssp. nahuelbutae	CHL(ARA)
Calceolaria meyeniana ssp. meyeniana	CHL(VAL, LBO, MAU, RME)
Calceolaria meyeniana ssp. glabrata	CHL(BIO)
Calceolaria mollisima	ARG(MEN, NEU, RNE)
Calceolaria morisii	CHL(COQ, VAL, RME)
Calceolaria nitida	CHL(LBO, RME)
Calceolaria nudicaulis	CHL(VAL, LBO, RME)
Calceolaria pallida	CHL(MAU)
Calceolaria paposana	CHL(ANT)
Calceolaria paralia	CHL(LBO, MAU)
Calceolaria parviflora	ARG(BAI, CAT, COR, LRI, MEN, SDE, SLU, TUC) / URY(LAV, MAL)
Calceolaria parvifolia	ARG(JUJ)
Calceolaria pennellii	ARG(MEN, NEU)
Calceolaria petioalaris	CHL(ATA, COQ, VAL, LBO, MAU, RME)
Calceolaria philippii	CHL(RME)
Calceolaria picta	CHL(COQ)
Calceolaria pinifolia	ARG(CAT, LRI, MEN, SJU) / CHL(ATA, COQ, VAL)
Calceolaria pinnata	BRA(Fuera del área del proyecto) / CHL(ANT)
Calceolaria plectranthifolia	ARG(CAT, JUJ, LRI, SAL, TUC)
Calceolaria poikilanthes	ARG(NEU) / CHL(ARA)
Calceolaria polifolia	CHL(COQ, VAL, RME)
Calceolaria polyclada	ARG(CAT, JUJ, LRI, SAL, TUC)
Calceolaria polyrrhiza	ARG(CHU, LRI, MEN, NEU, RNE, SCR, TDF) / CHL(MAU, BIO, ARA, AIS, MAG)
Calceolaria purpurea	CHL(VAL, RME)
Calceolaria racemosa	ARG(BAI)
Calceolaria rinconada	CHL(ANT)
Calceolaria rivularis	ARG(SAL)
Calceolaria rubiginosa	CHL(COQ, VAL)
Calceolaria ruiz-leali	ARG(MEN, NEU, RNE)
Calceolaria santolinoides	ARG(CAT, COR, JUJ, SAL, SLU, TUC)
Calceolaria schickendantziana	ARG(CAT, JUJ, SAL, TUC)
Calceolaria segethii	CHL(COQ, VAL, RME)
Calceolaria spathulata	CHL(BIO)
Calceolaria stellariifolia	CHL(TAR, ANT, RME)
Calceolaria talcana	CHL(MAU, BIO, ARA)
Calceolaria tenella	ARG(CHU, NEU, RNE, SCR) / CHL(BIO, ARA, LLA, AIS, MAG)
Calceolaria teucrioides	ARG(CAT, COR, JUJ, LRI, SAL, TUC)
Calceolaria thyrsiflora	CHL(VAL, LBO, MAU, RME)
Calceolaria tripartita	ARG(MIS) / BRA(PAR, RGS, SCA) / CHL(VAL)
Calceolaria tucumana	ARG(JUJ, SAL, TUC)
Calceolaria umbellata	ARG(CAT, JUJ, LRI, SAL, SJU, TUC)
Calceolaria undulata	ARG(NEU) / CHL(MAU, BIO)
Calceolaria uniflora	ARG(CHU, SCR, TDF) / CHL(AIS, MAG)
Calceolaria valdiviana ssp. valdiviana	ARG(NEU) / CHL(MAU, BIO, ARA, LLA)
Calceolaria valdiviana ssp. crassifolia	CHL(BIO, ARA, LLA)
Calceolaria verbascifolia	CHL(VAL, LBO)
Calceolaria viscosissima	CHL(VAL)
Calceolaria volckmannii	ARG(CHU, MEN, NEU, RNE, SCR) / CHL(MAU, BIO)
Calceolaria williamsii	CHL(MAU)
Caldcluvia paniculata	ARG(CHU, NEU, RNE) / CHL(MAU, BIO, ARA, LLA, AIS)
Calea acaulis	BRA(PAR) / PRY(Desconocida)
Calea annua	PRY(CEN)
Calea asclepiaefolia	ARG(MIS) / PRY(AMA)
Calea bakeriana	BRA(Fuera del área del proyecto) / PRY(AMA, CAU, CEN)
Calea chodatii	PRY(CAN)
Calea clematidea	ARG(COS, MIS) / BRA(RGS) / PRY(AMA, CAA, CEN, CON, COA, GUA, PAI) / URY(ART, RIV, TAC)
Calea crenata	PRY(CON)
Calea cuneifolia	BRA(PAR) / PRY(CAU, CAN)
Calea cymosa	ARG(CHA, COS, ERI, FOR, MIS, SFE) / BRA(PAR, RGS, SCA) / PRY(CAU, CAA, CON, ITA, MIE)
Calea formosa	PRY(CAN)
Calea hassleriana	ARG(COS, MIS) / PRY(CAU, CAA, CAN, SPE)
Calea ilienii	BRA(PAR, SCA)
Calea kristiniae	BRA(RGS)
Calea longifolia	BRA(PAR)
Calea marginata	BRA(PAR)
Calea mediterranea	ARG(COS, MIS) / BRA(PAR) / PRY(CAN, ITA)
Calea monocephala	BRA(PAR)
Calea myrtifolia	BRA(PAR, RGS, SCA)
Calea paraguayensis	BRA(RGS)
Calea parvifolia	BRA(PAR)
Calea phyllolepis	BRA(PAR, RGS, SCA)
Calea pinnatifida	ARG(COS, MIS) / BRA(PAR, RGS, SCA) / PRY(CAU, CAA, CAN, GUA, PAI)
Calea rupicola	PRY(AMA, CON, COA, PAI)
Calea triantha	BRA(PAR, SCA) / PRY(AMA)
Calea uniflora var. discoidea	ARG(COS, ERI)
Calea uniflora var. uniflora	ARG(COS, ERI, MIS) / BRA(PAR, RGS, SCA) / PRY(CAU, CAA, CAN, CEN, CON, COA, ITA, MIE, PAI, SPE)
Calea verticillata	ARG(COS, MIS) / BRA(PAR) / PRY(AMA, CAN, COA, PAI, SPE)
Calendula arvensis	ARG(BAI, CHU, RNE) / CHL(COQ, VAL, BIO, RME) / URY(MON)
Calendula officinalis	ARG(BAI, CHU, JUJ, LPA, NEU, RNE) / CHL(COQ, VAL, BIO, RME, JFE)
Calendula tripterocarpa	CHL(COQ)
Calibrachoa caesia	ARG(MIS) / BRA(PAR, SCA) / PRY(PAI)
Calibrachoa cordifolia	BRA(RGS)
Calibrachoa dusenii	BRA(PAR)
Calibrachoa eglandulata	BRA(SCA)
Calibrachoa ericifolia	BRA(PAR, SCA)
Calibrachoa excellens	ARG(COS, MIS) / BRA(RGS, SCA) / PRY(CAA, GUA) / URY(TAC)
Calibrachoa felipponei	URY(MON)
Calibrachoa heterophylla	BRA(RGS, SCA)
Calibrachoa humilis	ARG(COS) / BRA(RGS) / URY(SAO)
Calibrachoa irgangiana	ARG(MIS) / BRA(RGS)
Calibrachoa linoides ssp. linoides	ARG(MIS) / BRA(RGS, SCA) / PRY(PAI)
Calibrachoa linoides ssp. furcata	ARG(MIS) / BRA(PAR, RGS, SCA)
Calibrachoa longistyla	ARG(COS)
Calibrachoa micrantha	BRA(PAR, SCA)
Calibrachoa missionica	ARG(COS, MIS) / BRA(RGS) / PRY(ITA)
Calibrachoa ovalifolia	ARG(COS, MIS) / BRA(RGS) / URY(ART, CLA, RIV, TYT)
Calibrachoa paranensis	BRA(PAR)
Calibrachoa parviflora	ARG(BAI, CAT, CHA, CHU, COR, COS, DFE, ERI, FOR, JUJ, LPA, MEN, MIS, NEU, RNE, SAL, SJU, SLU, SFE, SDE, TUC) / BRA(RGS) / CHL(VAL) / PRY(COA) / URY(ART, CAS, CLA, COL, MAL, MON, PAY, SAO)
Calibrachoa pubescens	ARG(COS) / URY(MON)
Calibrachoa pygmaea	ARG(COS, ERI, MIS) / BRA(RGS) / URY(ART, CAS, DUR, FLO, FLA, MON, SAO, SOR, TAC)
Calibrachoa scabridula	URY(CAS)
Calibrachoa sellowiana	BRA(PAR, RGS, SCA)
Calibrachoa sendtneriana	BRA(SCA)
Calibrachoa serrulata	BRA(SCA)
Calibrachoa spathulata	BRA(PAR, SCA)
Calibrachoa thymifolia	ARG(COS, ERI, SFE) / BRA(RGS) / PRY(ITA) / URY(ART, COL, PAY, SAO, SJO)
Callaeum psilophyllum	ARG(BAI, COS, ERI, JUJ, MIS, SAL) / BRA(PAR, RGS, SCA) / PRY(AMA, CAN, COA) / URY(ART, SAO, SOR)
Calliandra brevicaulis var. brevicaulis	BRA(Fuera del área del proyecto) / PRY(APA, AMA, CAU, CAN, COA, MIE)
Calliandra brevicaulis var. glabra	ARG(COS, MIS) / PRY(CAU, COA, ITA, PAI, SPE)
Calliandra brevipes	ARG(MIS) / BRA(PAR, RGS, SCA) / URY(ART, CLA, MON, RIV)
Calliandra chilensis	CHL(ATA, COQ)
Calliandra dysantha var. opulenta	BRA(Fuera del área del proyecto) / PRY(AMA, CAN)
Calliandra dysantha var. macrocephala	BRA(PAR)
Calliandra foliolosa	ARG(MIS) / BRA(PAR, RGS, SCA) / PRY(APA, AMA, CAU, CAA, CAN, COA, GUA, PAI)
Calliandra harrisii	BRA(Fuera del área del proyecto) / PRY(APY)
Calliandra longipes	ARG(MIS) / BRA(Fuera del área del proyecto) / PRY(AMA, CAU, COA, MIE)
Calliandra parviflora	BRA(Fuera del área del proyecto) / PRY(APY, AMA, CON, COA, SPE)
Calliandra parvifolia	ARG(BAI, COS, ERI, MIS) / BRA(PAR, RGS) / PRY(AMA, CAU, PAI) / URY(ART, COL, MAL, MON, PAY, RNO, SAO, SOR)
Calliandra tweedii	ARG(COS, MIS) / BRA(PAR, RGS, SCA) / PRY(PAI) / URY(ART, CLA, DUR, FLA, MAL, MON, PAY, RIV, ROC, SAO, SOR, TAC, TYT)
Callianthemoides semiverticillata	ARG(CHU, NEU, RNE) / CHL(LLA)
Callisia monandra	ARG(MIS, SAL) / BRA(Fuera del área del proyecto)
Callisia repens	ARG(CHA, COS, ERI, FOR, JUJ, MIS, TUC) / BRA(Fuera del área del proyecto) / PRY(CEN, PAI)
Callisthene castellanosii	BRA(SCA)
Callisthene hassleri	PRY(AMA)
Callisthene kuhlmannii	BRA(PAR, SCA)
Callitriche albomarginata	CHL(RME)
Callitriche antarctica	ARG(TDF) / CHL(MAG, RME)
Callitriche deflexa	ARG(BAI, COS, ERI, SFE) / BRA(PAR, RGS) / CHL(COQ, LBO, MAU, BIO, ARA) / PRY(CEN) / URY(MON)
Callitriche heterophylla	ARG(ERI) / CHL(BIO, ARA, LLA)
Callitriche heteropoda	ARG(COR, TUC)
Callitriche lechleri var. lechleri	ARG(BAI, CHU, COS, ERI, NEU, RNE, SAL, SJU, SCR, TDF) / CHL(VAL, LBO, BIO, ARA, LLA, MAG, RME, JFE) / URY(LAV)
Callitriche lechleri var. berteroana	ARG(CHU, RNE, TDF) / CHL(VAL, LBO)
Callitriche rimosa	ARG(BAI, COS, ERI, MIS, TDF) / BRA(PAR, RGS, SCA) / PRY(MIE) / URY(CAS, FLA, MON, ROC)
Callitriche terrestris ssp. turfosa	ARG(BAI, CAT, COR, COS, ERI, JUJ, LRI, SAL, SJU, SLU, SDE, TUC) / CHL(ANT, VAL, BIO, ARA, LLA, AIS, RME)
Callitriche terrestris ssp. subsessilis	ARG(BAI, CHA, COR, COS, ERI, FOR, JUJ, MIS, SAL, SJU, SFE, TUC) / BRA(Fuera del área del proyecto) / PRY(CEN, GUA, PAI)
Callitriche truncata	ARG(NEU, SCR) / CHL(ARA, MAG)
Calolisianthus amplissimus	BRA(PAR)
Calolisianthus pedunculatus	BRA(PAR, SCA)
Calolisianthus pendulus	BRA(PAR)
Calolisianthus speciosus	BRA(PAR)
Calopappus acerosus	CHL(COQ, VAL, LBO, MAU, RME)
Calophyllum brasiliense	ARG(COS, MIS) / BRA(PAR, SCA) / PRY(AMA, ITA)
Calopogonium caeruleum	ARG(MIS, SFE) / BRA(PAR, RGS, SCA) / PRY(CON)
Calopogonium sericeum	ARG(COS, FOR, MIS) / BRA(PAR, RGS) / PRY(APA, AMA, CAU, CAN, COA, GUA, MIE, SPE)
Calotropis procera	BRA(Fuera del área del proyecto) / PRY(APY)
Caltha appendiculata	ARG(CHU, NEU, RNE, SCR, TDF) / CHL(LBO, MAU, BIO, ARA, LLA, AIS, MAG)
Caltha dioneifolia	ARG(SCR, TDF) / CHL(AIS, MAG)
Caltha sagittata	ARG(CHU, JUJ, LRI, MEN, NEU, RNE, SCR, SJU, TDF) / CHL(COQ, LBO, MAU, BIO, ARA, LLA, AIS, MAG, RME)
Calycera calcitrapa	ARG(CAT, LRI, MEN, SAL, SJU, TUC)
Calycera crassifolia var. spinulosa	ARG(LPA, MEN, NEU, RNE)
Calycera crassifolia	ARG(BAI, CHU, LPA, MEN, NEU, RNE, SCR, SFE) / URY(CAS, MAL, MON, ROC, SJO)
Calycera eryngioides	CHL(COQ, LBO, RME)
Calycera herbacea var. sinuata	ARG(CAT, JUJ, LRI, MEN, SAL, SJU, TUC) / CHL(ANT)
Calycera herbacea var. herbacea	ARG(MEN, NEU, SJU, TUC) / CHL(COQ, VAL, MAU, ARA, RME)
Calycera horrida	ARG(NEU)
Calycera leucanthema	CHL(LBO, MAU, BIO, ARA, LLA)
Calycera pulvinata f. pulvinata	ARG(CAT, JUJ, SAL, SJU, TUC)
Calycera sessiliflora var. sessiliflora	CHL(COQ, VAL, RME)
Calycera sympaganthera	CHL(BIO, ARA)
Calycophyllum multiflorum	ARG(CHA, FOR, JUJ, SAL, SDE) / BRA(Fuera del área del proyecto) / PRY(APY, AMA, CAN, CEN, CON, COA, GUA, PAI, PHA)
Calyculogygas serrana	BRA(RGS)
Calyculogygas uruguayensis	BRA(SCA) / URY(CAS, LAV, SJO)
Calydorea alba	URY(ART)
Calydorea amabilis	ARG(COS, ERI) / BRA(RGS) / URY(PAY)
Calydorea approximata	ARG(CHA, COS, MIS, SAL, SFE) / PRY(APA, APY, CAU, CAA, GUA, ITA, MIE, SPE)
Calydorea azurea	ARG(COS, ERI) / URY(TYT)
Calydorea basaltica	BRA(PAR)
Calydorea bifida	CHL(MAU)
Calydorea campestris	BRA(PAR, RGS, SCA) / PRY(CAN, GUA)
Calydorea charruana	BRA(RGS) / URY(CLA, RIV, TAC)
Calydorea crocoides	BRA(PAR, RGS, SCA)
Calydorea gardneri	BRA(Fuera del área del proyecto) / PRY(COA)
Calydorea longipes	BRA(PAR)
Calydorea minima	ARG(COS, MIS) / PRY(CAA)
Calydorea nuda	BRA(RGS) / URY(CLA, MON)
Calydorea pallens	ARG(CAT, COR, COS, JUJ, LRI, SAL, SLU, SDE, TUC)
Calydorea riograndensis	BRA(RGS)
Calydorea undulata	ARG(COR, SLU)
Calydorea xiphioides	CHL(COQ, VAL, LBO, MAU, BIO)
Calyptocarpus biaristatus	ARG(BAI, CHA, COS, DFE, ERI, FOR, MIS, TUC) / BRA(PAR, RGS, SCA) / PRY(APA, CAU, CAA, CEN, GUA, ITA, PAI) / URY(ART, COL, FLO, MON, PAY, RNO, RIV, SAO, SJO, SOR, TYT)
Calyptraemalva catharinensis	BRA(SCA)
Calyptranthes brasiliensis var. mutabilis	BRA(SCA)
Calyptranthes concinna	ARG(COS, MIS) / BRA(PAR, RGS, SCA) / PRY(APA, CAU, CAA, CAN, COA, GUA, PAI) / URY(RIV, SAO, TAC, TYT)
Calyptranthes grandifolia var. grandifolia	BRA(RGS, SCA)
Calyptranthes grandifolia var. rufa	BRA(PAR, RGS, SCA)
Calyptranthes hatschbachii	BRA(PAR)
Calyptranthes kleinii	BRA(PAR, SCA)
Calyptranthes lanceolata var. catharinensis	BRA(SCA)
Calyptranthes loranthifolia	BRA(PAR)
Calyptranthes lucida var. lucida	BRA(PAR, RGS, SCA)
Calyptranthes lucida var. polyantha	BRA(PAR, RGS)
Calyptranthes lucida f. hilariana	BRA(SCA)
Calyptranthes obovata	BRA(SCA)
Calyptranthes pileata var. riograndensis	BRA(RGS)
Calyptranthes pileata var. pileata	BRA(PAR, RGS, SCA)
Calyptranthes reitziana	BRA(RGS, SCA)
Calyptranthes rubella	BRA(RGS, SCA)
Calyptranthes strigipes	BRA(SCA)
Calyptranthes tricona	ARG(MIS) / BRA(RGS, SCA)
Calyptrocarya glomerulata	BRA(PAR, SCA) / PRY(CAN)
Calyptrocarya longifolia	BRA(SCA) / PRY(CAN, GUA)
Calystegia brummittii	BRA(RGS, SCA)
Calystegia sepium var. americana	ARG(BAI, COR, ERI, LPA, MEN, RNE, TDF) / CHL(VAL, BIO, ARA, LLA, RME, IPA) / URY(CLA, COL, FLA, MAL, MON, RNO, SJO, SOR)
Calystegia sepium var. sepium	ARG(BAI, COR, ERI, LPA, MEN) / CHL(BIO, ARA, LLA, AIS, RME, IPA)
Calystegia soldanella	ARG(BAI) / CHL(VAL, LBO, MAU, BIO, ARA, LLA, RME) / URY(CAS, MAL, MON, ROC)
Calystegia tuguriorum	CHL(AIS, JFE)
Camarea affinis	BRA(PAR) / PRY(AMA, CAN)
Camarea axillaris	
Cambajuva ulei	BRA(RGS, SCA)
Cambessedesia espora ssp. ilicifolia	BRA(PAR)
Cambessedesia hilariana	BRA(PAR)
Camelina alyssum	ARG(BAI, SFE) / CHL(RME)
Camelina microcarpa	ARG(BAI, CHU, LPA, MEN, NEU, RNE)
Camelina sativa	ARG(BAI, COR, LPA, SFE) / URY(SOR)
Camellia sinensis	ARG(COS, MIS)
Camissonia dentata ssp. littoralis	CHL(MAU, BIO)
Camissonia dentata ssp. dentata	ARG(BAI, CHU, MEN, NEU, RNE, SCR) / CHL(TAR, ATA, COQ, VAL, LBO, MAU, BIO, ARA, RME)
Campanula rotundifolia	ARG(TDF)
Campomanesia adamantium	BRA(PAR, SCA) / PRY(APA, AMA, CAU, CAN)
Campomanesia aurea var. aurea	ARG(COS, MIS) / BRA(PAR, RGS, SCA) / PRY(GUA) / URY(RIV)
Campomanesia aurea var. hatschbachii	BRA(PAR, RGS, SCA) / URY(RIV)
Campomanesia eugenioides	BRA(PAR, SCA)
Campomanesia guaviroba	ARG(MIS) / BRA(PAR, RGS, SCA) / PRY(APA, PAI)
Campomanesia guazumifolia	ARG(COS, MIS) / BRA(PAR, RGS, SCA) / PRY(APA, AMA, CAA, CAN, GUA, MIE, PAI, SPE)
Campomanesia neriiflora	BRA(PAR)
Campomanesia paranensis	PRY(APA)
Campomanesia pubescens	BRA(PAR) / PRY(AMA, CAU, CAA, CAN, CON, PAI, SPE)
Campomanesia reitziana	BRA(PAR, SCA)
Campomanesia schlechtendaliana	BRA(PAR)
Campomanesia sessiliflora var. bullata	BRA(PAR) / PRY(APA, AMA, CAU, CAA, CAN, SPE)
Campomanesia sessiliflora var. lanuginosa	BRA(Fuera del área del proyecto) / PRY(AMA, CON)
Campomanesia xanthocarpa var. xanthocarpa	ARG(COS, MIS) / BRA(PAR, RGS, SCA) / PRY(APA, AMA, CAA, CAN, CEN, COA, GUA, MIE, ÑEE, PAI)
Campomanesia xanthocarpa var. littoralis	BRA(RGS, SCA)
Campovassouria cruciata	ARG(BAI, CAT, CHA, COS, ERI, JUJ, MIS, SAL, TUC) / BRA(PAR, RGS, SCA) / PRY(AMA, CAU, CAN, CEN, COA, GUA, MIE, PAI, SPE) / URY(ART, LAV, RNO, RIV, SJO, TAC)
Campsidium valdivianum	ARG(CHU, NEU, RNE) / CHL(BIO, LLA, AIS)
Campsis radicans	ARG(BAI, ERI, SAL)
Camptosema paraguariense var. paraguariense	ARG(CHA, SFE) / BRA(Fuera del área del proyecto) / PRY(APY, CON, PHA)
Camptosema paraguariense var. parviflorum	ARG(CHA, COS, FOR, SAL, SFE) / BRA(Fuera del área del proyecto) / PRY(APY, BOQ, CON, PHA)
Camptosema praeandinum	ARG(JUJ, SAL, TUC)
Camptosema rubicundum	ARG(BAI, COS, ERI, MIS) / BRA(RGS) / PRY(APA, CEN) / URY(ART, CAS, CLA, COL, FLO, FLA, MAL, MON, PAY, RNO, RIV, SAO, SJO, SOR, TAC, TYT)
Camptosema scarlatinum	ARG(MIS) / BRA(PAR, RGS, SCA) / PRY(APY, APA, AMA, PAI)
Campuloclinium burchellii	ARG(COS, MIS) / BRA(PAR) / PRY(AMA, CAN)
Campuloclinium hickenii	ARG(JUJ, SAL)
Campuloclinium macrocephalum	ARG(BAI, CHA, COR, COS, ERI, FOR, JUJ, MIS, SAL, SFE, SDE, TUC) / BRA(PAR, RGS, SCA) / PRY(APA, APY, AMA, BOQ, CAU, CAA, CAN, CEN, CON, COA, GUA, ITA, ÑEE, PAI, PHA, SPE) / URY(ART, CAS, CLA, COL, CLA, FLO, FLA, LAV, MAL, MON, PAY, RNO, RIV, ROC, TAC, TYT)
Campuloclinium purpurascens	ARG(COS, JUJ, MIS) / BRA(PAR, SCA) / PRY(APA, AMA, CAU, CEN, COA, GUA, MIE, PAI, PHA)
Campylocentrum aromaticum	ARG(MIS) / BRA(PAR, RGS, SCA) / URY(TYT)
Campylocentrum brachycarpum	BRA(RGS)
Campylocentrum crassirhizum	BRA(PAR, SCA)
Campylocentrum densiflorum	ARG(CHA, COS, FOR, MIS) / BRA(PAR, RGS, SCA) / PRY(APA)
Campylocentrum gracile	BRA(SCA)
Campylocentrum grisebachii	ARG(FOR, JUJ, MIS, SAL) / BRA(PAR, RGS, SCA) / PRY(APY)
Campylocentrum hasslerianum	BRA(PAR) / PRY(GUA)
Campylocentrum hirtellum	BRA(SCA)
Campylocentrum iglesiasii	BRA(PAR)
Campylocentrum kuntzei	PRY(GUA)
Campylocentrum lansbergii	BRA(PAR)
Campylocentrum micranthum	ARG(COS) / BRA(PAR, RGS)
Campylocentrum neglectum	ARG(CHA, COS, FOR, MIS, SFE) / BRA(PAR, RGS, SCA) / PRY(APA, CAA, CAN, CEN, CON, ÑEE, PHA, SPE)
Campylocentrum organensis	BRA(PAR)
Campylocentrum ornithorrhynchum	BRA(RGS, SCA)
Campylocentrum parahybunense	BRA(PAR, RGS, SCA)
Campylocentrum pauloense	ARG(MIS) / BRA(RGS, SCA)
Campylocentrum poeppigii	BRA(SCA)
Campylocentrum robustum	BRA(PAR)
Campylocentrum schlechterianum	BRA(SCA)
Campylocentrum sellowii	BRA(RGS, SCA)
Campylocentrum ulaei	ARG(MIS) / BRA(PAR, RGS, SCA) / PRY(APA)
Campyloneurum acrocarpon	BRA(PAR, SCA)
Campyloneurum aglaolepis	ARG(CAT, JUJ, SAL, TUC) / BRA(PAR, RGS, SCA)
Campyloneurum angustifolium	ARG(JUJ, SAL)
Campyloneurum angustipaleatum	ARG(JUJ, SAL)
Campyloneurum austrobrasilianum	ARG(MIS) / BRA(PAR, RGS, SCA)
Campyloneurum decurrens	BRA(PAR, SCA)
Campyloneurum lorentzii	ARG(CAT, CHA, JUJ, SAL, TUC) / PRY(CAA)
Campyloneurum minus	ARG(MIS) / BRA(PAR, SCA) / PRY(COA, GUA, ITA, PAI)
Campyloneurum nitidum	ARG(CHA, COS, ERI, JUJ, MIS, SAL) / BRA(PAR, RGS, SCA) / PRY(APA, AMA, CAA, CAN, GUA, ITA, PAI) / URY(CLA, TAC)
Campyloneurum repens	ARG(MIS) / BRA(RGS)
Campyloneurum rigidum	BRA(PAR, SCA)
Campyloneurum tucumanense	ARG(JUJ, MIS, SAL, TUC)
Canastra aristella	BRA(PAR, RGS, SCA)
Canavalia bonariensis	ARG(BAI, CHA, COS, ERI, JUJ) / BRA(PAR, RGS, SCA) / PRY(ITA) / URY(ART, CAS, CLA, COL, MON, RNO, SJO, TAC)
Canavalia brasiliensis	ARG(COS, FOR, MIS) / BRA(PAR) / PRY(AMA, CEN, CON)
Canavalia ensiformis	ARG(CHA, COS, MIS, SAL) / BRA(Fuera del área del proyecto) / URY(MON)
Canavalia mattogrossensis	BRA(Fuera del área del proyecto) / PRY(AMA, CAU, COA, GUA, PAI, SPE)
Canavalia picta	BRA(PAR)
Canavalia piperi	ARG(SAL) / BRA(Fuera del área del proyecto)
Canavalia rosea	BRA(PAR, SCA)
Canna ascendens	ARG(BAI)
Canna glauca	ARG(BAI, CHA, COS, ERI, FOR, JUJ, MIS, SFE) / BRA(PAR, RGS, SCA) / PRY(CEN, MIE, ÑEE, PAI, PHA, SPE) / URY(MON)
Canna indica	ARG(BAI, CHA, COR, COS, ERI, FOR, JUJ, MIS, SAL, TUC) / BRA(PAR, RGS, SCA) / PRY(APA, ÑEE, PAI, PHA, SPE) / URY(ART, RNO, ROC, TAC)
Canna paniculata	ARG(BAI, MIS) / BRA(PAR, SCA) / PRY(APY, APA, AMA, CAA, CEN, COA, GUA, PAI, PHA)
Canna pedunculata	BRA(SCA)
Cantinoa althaeifolia	ARG(COS, MIS) / BRA(PAR, RGS, SCA) / PRY(AMA, CAU, CAA, CAN, COA, GUA, ITA, MIE, PAI, SPE)
Cantinoa heterodon	BRA(PAR, SCA)
Cantinoa mutabilis	ARG(BAI, CAT, CHA, COR, COS, ERI, FOR, JUJ, MIS, SAL, SFE, TUC) / BRA(PAR, RGS, SCA) / PRY(APY, CAA, COA, ITA, MIE, PAI, PHA)
Cantinoa plectranthoides	BRA(PAR, SCA)
Cantinoa stricta	ARG(COS, MIS) / BRA(PAR, RGS, SCA) / PRY(CAU) / URY(CLA)
Capanemia adelaidae	BRA(PAR, RGS, SCA)
Capanemia brachycion	ARG(JUJ)
Capanemia gehrtii	BRA(PAR, RGS, SCA)
Capanemia micromera	ARG(COS, JUJ, MIS, SAL) / BRA(PAR, RGS, SCA) / PRY(APY, CAA, GUA, PHA, SPE) / URY(TAC, TYT)
Capanemia paranaensis	BRA(PAR)
Capanemia superflua var. superflua	ARG(MIS) / BRA(PAR, RGS, SCA) / URY(CLA)
Capanemia superflua var. rosea	URY(CLA)
Capanemia thereziae	BRA(PAR, RGS, SCA)
Caperonia altissima	PRY(SPE)
Caperonia buettneriacea	BRA(SCA)
Caperonia capiibarensis	PRY(GUA, SPE)
Caperonia castaneifolia	ARG(CHA, COS, ERI, FOR, MIS, SFE) / PRY(AMA, CEN, CON, COA, ITA, MIE, ÑEE, PAI, PHA, SPE) / URY(SAO)
Caperonia cordata	ARG(BAI, CHA, COS, ERI, FOR, MIS, SFE) / BRA(RGS) / PRY(CAA, ITA, ÑEE, PHA) / URY(CLA)
Caperonia glabrata	ARG(FOR) / PRY(MIE, ÑEE, PHA)
Caperonia linearifolia	ARG(BAI, COS, ERI, SFE) / BRA(RGS, SCA) / URY(CAS, MON, ROC, SJO, TYT)
Caperonia palustris	ARG(BAI, CHA, COS, ERI, FOR, MIS, SAL, SDE, SFE, TUC) / BRA(Fuera del área del proyecto) / PRY(APY, CAU, CEN, ÑEE, PHA)
Caperonia paraguayensis	PRY(SPE)
Capparicordis tweediana	ARG(BAI, CHA, COR, COS, ERI, FOR, JUJ, LRI, MIS, SAL, SDE, SFE, SJU, TUC) / BRA(PAR) / PRY(APY, CEN, ÑEE, PHA)
Capparidastrum coimbranum	ARG(SAL)
Capparidastrum humilis	ARG(COS, MIS) / BRA(PAR) / PRY(APA, AMA, ITA)
Capparis atamisquea	ARG(BAI, CAT, CHA, COR, ERI, JUJ, LPA, LRI, MEN, NEU, RNE, SAL, SDE, SFE, SJU, SLU, TUC) / PRY(PHA)
Capparis flexuosa var. pubescens	ARG(CHA, COS, FOR, SFE) / PRY(CEN, COA, PAI, PHA)
Capparis flexuosa var. flexuosa	ARG(CHA, COS, FOR, MIS) / BRA(RGS, SCA) / PRY(CEN, CON, COA, GUA, ÑEE, PAI)
Capraria biflora	ARG(FOR, JUJ, SAL) / PRY(APY)
Capsella bursa-pastoris	ARG(BAI, CAT, CHU, COR, COS, DFE, ERI, FOR, JUJ, LPA, LRI, MEN, MIS, NEU, RNE, SAL, SCR, SDE, SFE, SJU, SLU, TDF, TUC) / BRA(PAR, RGS) / CHL(TAR, ANT, COQ, VAL, LBO, MAU, BIO, ARA, LLA, AIS, MAG, RME, IPA) / URY(CAS)
Capsicodendron dinisii	BRA(PAR, RGS, SCA)
Capsicum baccatum var. pendulum 	PRY(COA, GUA, PAI)
Capsicum baccatum var. baccatum	ARG(CHA, COS, FOR, JUJ, MIS, SAL, TUC) / BRA(PAR, RGS, SCA) / PRY(APY, AMA, CAA, CEN, CON, COA, GUA, PAI, SPE) / URY(RIV)
Capsicum baccatum var. praetermissum	BRA(PAR, SCA) / PRY(GUA, PAI)
Capsicum chacoense	ARG(CAT, CHA, COR, COS, ERI, FOR, JUJ, LPA, LRI, SAL, SDE, SFE, SJU, SLU, TUC) / PRY(APY, BOQ, CON, ÑEE, PHA)
Capsicum eximium	ARG(JUJ, SAL, TUC)
Capsicum flexuosum	ARG(COS, MIS) / BRA(PAR, RGS, SCA) / PRY(APA, CAU, CAA, CAN, GUA, ITA, PAI, SPE)
Capsicum frutescens 	PRY(PHA)
Capsicum recurvatum	BRA(PAR)
Cardamine africana	ARG(MIS, SAL, TUC) / BRA(PAR, RGS, SCA) / CHL(LLA, AIS, IPA)
Cardamine bonariensis	ARG(BAI, CAT, CHU, COR, COS, DFE, ERI, JUJ, LRI, MEN, MIS, NEU, SAL, SJU, SCR, TUC) / BRA(PAR, RGS, SCA) / CHL(TAR, ANT, COQ, VAL, LBO, MAU, BIO, ARA, LLA, MAG, RME, JFE) / PRY(APA) / URY(CAS, FLA, SOR)
Cardamine chenopodiifolia	ARG(BAI, CHA, COR, COS, ERI, FOR, MIS) / BRA(RGS, SCA) / CHL(JFE) / PRY(GUA) / URY(CAS, MON, SJO, SOR)
Cardamine chilensis	ARG(CHU, NEU, RNE, SAL) / CHL(VAL, LBO, MAU, BIO, ARA, LLA, RME)
Cardamine cordata	ARG(CHU, MEN, NEU, RNE, SCR) / CHL(COQ, VAL, LBO, MAU, BIO, ARA, LLA, RME)
Cardamine flexuosa	ARG(COS, JUJ, MEN, SAL)
Cardamine geraniifolia	ARG(SCR, TDF) / CHL(AIS, MAG)
Cardamine glacialis	ARG(CHU, SCR, TDF) / CHL(LLA, AIS, MAG)
Cardamine hirsuta	ARG(BAI, CHU, ERI, LPA, NEU, RNE, SAL, SJU, SCR, TUC) / BRA(RGS) / CHL(VAL, LBO, MAU, BIO, ARA, LLA, MAG, RME) / URY(MON)
Cardamine hispidula	ARG(LRI) / CHL(BIO)
Cardamine kruesselii	CHL(JFE)
Cardamine marginata	CHL(BIO, ARA)
Cardamine rostrata	ARG(CHU) / CHL(BIO, ARA, LLA)
Cardamine tenuirostris	ARG(CHU, NEU, RNE) / CHL(COQ, VAL, LBO, MAU, BIO, ARA, LLA, RME)
Cardamine tuberosa	ARG(CHU) / CHL(COQ, VAL, LBO, BIO, ARA, AIS, RME)
Cardamine variabilis	ARG(CHU, NEU, RNE) / CHL(BIO, ARA, LLA, AIS)
Cardamine volckmannii	ARG(MEN, NEU, SJU) / CHL(ATA, COQ, VAL, LBO, RME)
Cardamine vulgaris var. vulgaris	ARG(CHU, NEU, RNE, TUC) / CHL(VAL, LBO, MAU, BIO, ARA, LLA, AIS, MAG, RME, JFE)
Cardenanthus venturi	ARG(JUJ, SAL, TUC)
Cardionema andinum	CHL(TAR)
Cardionema burkartii	ARG(BAI, CAT, JUJ, LRI, SAL, SJU, TUC)
Cardionema kurtzii	ARG(COR, MEN) / CHL(COQ)
Cardionema ramosissima	ARG(BAI, CAT, CHU, COR, COS, JUJ, LPA, LRI, MEN, RNE, SAL, SJU, SLU, SCR, SDE, TUC) / BRA(RGS) / CHL(TAR, ANT, ATA, COQ, VAL, LBO, BIO, ARA, RME) / PRY(CEN, PAI) / URY(MON)
Cardionema rosetta	ARG(BAI, COR, COS, ERI, SFE) / BRA(RGS) / PRY(COA) / URY(CLA)
Cardiospermum corindum var. parviflorum	ARG(COS, MIS) / BRA(PAR) / PRY(APY)
Cardiospermum corindum var. corindum	ARG(CAT, CHA, COR, FOR, JUJ, SAL, SDE, SLU, TUC) / BRA(Fuera del área del proyecto) / PRY(APY, PHA)
Cardiospermum grandiflorum	ARG(BAI, COR, COS, ERI, FOR, MIS, TUC) / BRA(PAR, RGS, SCA) / PRY(APA, APY, AMA, CAU, CAA, CAN, CEN, CON, COA, GUA, ITA, ÑEE, PAI, PHA, SPE) / URY(CAS, COL, SOR)
Cardiospermum halicacabum var. halicacabum	ARG(BAI, CAT, CHA, COR, COS, ERI, FOR, JUJ, LRI, MIS, SAL, SDE, SFE, SJU, SLU, TUC) / BRA(PAR, RGS, SCA) / PRY(APY, PHA) / URY(CAS, CLA, SJO, SOR)
Cardiospermum halicacabum var. microcarpum	ARG(BAI, CAT, CHA, COR, COS, ERI, FOR, JUJ, LRI, MIS, SAL, SFE, SLU, TUC) / BRA(PAR, RGS, SCA) / PRY(APY, AMA, BOQ, CAN, CEN, CON, COA, GUA, ITA, ÑEE, PAI, PHA, SPE) / URY(ART, CLA, SAO, SOR)
Cardiospermum pterocarpum	ARG(COS) / BRA(Fuera del área del proyecto) / PRY(AMA, CAU, CAN, CON, SPE)
Carduus acanthoides	ARG(BAI, COR, DFE, ERI, JUJ, LPA, SAL, SFE) / URY(CAS, COL, MON, PAY, RNO, SJO)
Carduus nutans	CHL(VAL, ARA, RME)
Carduus pycnocephalus	ARG(BAI, DFE, ERI) / CHL(COQ, VAL, LBO, MAU, BIO, ARA, LLA, RME) / URY(CAS, FLA, LAV, MON, PAY, SJO, SOR)
Carduus tenuiflorus	ARG(BAI, CAT, COR, DFE, ERI, LPA, MEN, NEU, RNE, SAL, SCR, TDF) / URY(CAS, FLA, MON)
Carduus thoermeri	ARG(BAI, CAT, CHU, COR, DFE, ERI, JUJ, LPA, MEN, NEU, RNE, SAL, SCR, SDE, SFE, SJU, SLU, TDF, TUC) / BRA(SCA) / CHL(RME) / URY(PAY, RNO, SOR)
Carelia berroi	BRA(RGS) / URY(RIV, TAC)
Carelia cistifolia	BRA(RGS) / URY(CLA, TYT)
Carelia ramboi	BRA(RGS)
Carex acaulis	ARG(NEU, RNE, SCR, TDF) / CHL(MAG)
Carex acutata	CHL(ATA, MAU, BIO, LLA, AIS)
Carex aematorhyncha var. corralensis	ARG(CHU, COR, NEU, RNE, SCR, TDF) / CHL(LLA, AIS, MAG)
Carex aematorhyncha var. aematorhyncha	ARG(CHU, NEU, SCR, TDF) / CHL(BIO, ARA, LLA, AIS, MAG)
Carex andersonii	ARG(CHU, NEU, RNE, SCR, TDF) / CHL(ARA, LLA, AIS, MAG)
Carex andina	ARG(NEU, RNE) / CHL(COQ, VAL, MAU, BIO, ARA, MAG, RME)
Carex aphylla	ARG(CHU, NEU, RNE) / CHL(COQ, LBO, MAU, BIO, ARA, LLA, RME)
Carex araucana	CHL(BIO)
Carex argentina	ARG(CHU, MEN, NEU, RNE, SCR) / CHL(MAU)
Carex atropicta	ARG(CHU, COR, MEN, NEU, RNE, SCR, TDF) / CHL(ATA, COQ, VAL, AIS, MAG, RME)
Carex aureolensis	ARG(MIS) / BRA(RGS) / PRY(Desconocida)
Carex austroamericana	ARG(CHU, SCR) / CHL(MAG)
Carex banksii var. gilliesii	CHL(RME)
Carex banksii var. banksii	ARG(CHU, COR, MEN, NEU, RNE, SCR, TDF) / CHL(VAL, LBO, MAU, BIO, ARA, LLA, AIS, MAG, RME)
Carex banksii var. abbreviata	ARG(NEU)
Carex banksii var. fonkii	ARG(CHU) / CHL(MAG)
Carex berteroana	CHL(COQ, VAL, LBO, MAU, BIO, ARA, RME)
Carex berteroniana	CHL(JFE)
Carex boelckeiana	ARG(MEN, NEU)
Carex boliviensis	ARG(COR, JUJ, SAL, TUC)
Carex bonariensis var. bonariensis	ARG(BAI, CAT, CHA, COR, COS, DFE, ERI, FOR, JUJ, LPA, LRI, MEN, RNE, SLU, SFE, SDE, TUC) / BRA(PAR, RGS, SCA) / CHL(VAL, BIO, ARA) / PRY(CAN, PHA) / URY(CAS, CLA, DUR, FLO, FLA, MON, PAY, RNO, SAO, SJO, SOR, TYT)
Carex bonariensis var. glabrescens	ARG(COR, TUC)
Carex brachycalama	ARG(COR)
Carex bracteosa	CHL(VAL, LBO, BIO, ARA, LLA, RME)
Carex brasiliensis	ARG(CHA, COS, MIS) / BRA(PAR, RGS, SCA) / PRY(APA, CAA) / URY(RIV)
Carex brongniartii	ARG(BAI, CAT, COS, DFE, ERI, MIS, TUC) / BRA(RGS) / CHL(MAU, BIO, ARA, LLA) / URY(CAS, CLA, MAL, MON, RNO, ROC, TAC)
Carex caduca	ARG(NEU, RNE, SCR, TDF) / CHL(LLA, AIS, MAG)
Carex camptoglochin	ARG(LRI, SCR, SJU, TDF, TUC) / CHL(LLA, AIS, MAG)
Carex canescens	ARG(CHU, COR, NEU, RNE, SCR, TDF) / CHL(LLA, AIS, MAG)
Carex capitata	ARG(MEN, NEU, SCR, TDF) / CHL(MAG)
Carex catamarcensis	ARG(CAT, TUC) / CHL(COQ)
Carex catharinensis	ARG(BAI) / BRA(RGS, SCA)
Carex chilensis	ARG(BAI, CAT, CHA, CHU, COR, DFE, ERI, MIS, NEU, RNE, SFE, SJU) / BRA(RGS) / CHL(BIO, ARA, LLA, AIS) / PRY(PAI) / URY(CAS, MON, RNO, SJO, SOR)
Carex chillanensis	ARG(CHU, MEN, NEU, RNE, SCR, TDF) / CHL(MAU, BIO, MAG, RME)
Carex crassiflora	ARG(JUJ, SAL, TUC)
Carex darwinii var. darwinii	ARG(CHU, NEU, RNE, SCR, TDF) / CHL(ARA, LLA, AIS, MAG)
Carex darwinii var. urolepis	ARG(CHU, RNE) / CHL(MAG)
Carex darwinii var. serranoi	CHL(LLA, AIS, MAG)
Carex decidua	ARG(CHU, COR, MEN, NEU, RNE, SCR, TDF) / CHL(LBO, MAU, BIO, ARA, LLA, AIS, MAG, RME)
Carex distenta	ARG(BAI, CHU, COR, LRI, MEN, NEU, RNE, SCR, SLU, TDF) / BRA(SCA) / CHL(VAL, MAU, BIO, LLA, AIS) / URY(LAV, MAL)
Carex divulsa	ARG(BAI, DFE)
Carex dusenii	ARG(SCR)
Carex excelsa	ARG(BAI, CHU, MEN, MIS, NEU, RNE) / CHL(COQ, VAL, LBO, MAU, BIO, ARA, LLA, AIS)
Carex fecunda	ARG(CAT, JUJ, SAL, TUC)
Carex feddeana	ARG(BAI, CAT, CHA, COR, COS, DFE, ERI, MIS, SFE) / BRA(PAR, RGS, SCA) / PRY(GUA) / URY(SJO)
Carex fernandezensis	CHL(JFE)
Carex firmicaulis	ARG(CHU, COR, MEN, NEU, RNE, SCR, TDF) / CHL(COQ, LBO)
Carex flacca	ARG(TDF)
Carex fossa	ARG(BAI, CAT, CHU, COR, ERI, LPA, RNE, SAL, SFE) / BRA(RGS) / URY(LAV, SOR)
Carex fuscula ssp. fuscula	ARG(BAI, CAT, CHU, COR, MEN, NEU, RNE, SCR, TDF, TUC) / BRA(RGS, SCA) / CHL(COQ, BIO, ARA, LLA, AIS, MAG, RME)
Carex fuscula f. indecora	ARG(RNE, TDF) / CHL(LLA)
Carex fuscula var. pseudextensa	CHL(LLA)
Carex gayana var. gayana	ARG(CAT, CHU, COR, JUJ, MEN, RNE, SAL, SJU, SCR, TDF) / CHL(ANT, ATA, COQ, VAL, MAU, BIO, ARA, MAG, RME)
Carex gayana var. schedonautos	ARG(CHU, MEN, NEU, RNE, SCR, TDF) / CHL(MAG)
Carex gayana var. densa	ARG(CHU, COR, MEN, NEU, SCR, SJU, TDF) / CHL(ATA, LBO, MAU, MAG)
Carex gayana var. rufa	ARG(CAT, CHU, MEN, NEU, SJU) / CHL(COQ, VAL, RME)
Carex herteri	URY(FLA)
Carex hilairei var. glazioviana	ARG(MIS) / BRA(Fuera del área del proyecto)
Carex hookeri	CHL(BIO, LLA)
Carex humahuacaensis	ARG(CAT, JUJ)
Carex hypoleucos	ARG(CHU, MEN, NEU, RNE, SCR) / CHL(BIO, ARA, MAG, RME)
Carex hypsipedos	ARG(JUJ, SAL)
Carex inconspicua	ARG(LRI) / CHL(MAU, BIO, ARA, LLA)
Carex kingii	ARG(TDF) / CHL(AIS, MAG)
Carex lamprocarpa	CHL(BIO, ARA, LLA)
Carex lateriflora	ARG(CHU, NEU, RNE) / CHL(MAU, BIO, ARA, LLA)
Carex longii ssp. meridionalis	ARG(ERI, MIS) / BRA(PAR, RGS, SCA) / URY(CLA, COL, LAV, MAL, RNO, RIV, ROC, SOR, TAC)
Carex macloviana var. pseudoleporina	ARG(CHU, MEN, NEU, RNE, TDF) / CHL(MAU, BIO, ARA, LLA, MAG)
Carex macloviana var. thermarum	ARG(CHU, MEN, NEU, TUC) / CHL(VAL, MAU, BIO, RME)
Carex macloviana var. macloviana	ARG(CHU, COR, MEN, NEU, RNE, SAL, SJU, SCR, TDF, TUC) / CHL(LLA, AIS, MAG, RME)
Carex macrorrhiza	ARG(CAT, COR, JUJ, LRI, MEN, NEU, SAL, SCR, TUC) / CHL(TAR) / URY(RIV, SOR)
Carex macrosolen	ARG(SCR, TDF) / CHL(MAG)
Carex magellanica	ARG(CHU, NEU, RNE, SCR, TDF) / CHL(LBO, MAU, BIO, ARA, LLA, AIS, MAG)
Carex malmei	ARG(MEN, SJU) / CHL(ATA, COQ, RME)
Carex mandoniana	ARG(TUC)
Carex maritima	ARG(CAT, CHU, JUJ, LRI, MEN, NEU, SAL, SJU, SCR, TDF, TUC) / CHL(TAR, ANT, ATA, COQ, BIO, MAG)
Carex microglochin	ARG(JUJ, LRI, SAL, SCR, SJU, TDF, TUC) / CHL(COQ, AIS, MAG)
Carex minutissima	ARG(NEU, SCR) / CHL(MAG)
Carex molinae	CHL(MAU)
Carex monodynama	ARG(COR)
Carex moorei	ARG(SCR) / CHL(MAG)
Carex multispicata	CHL(BIO)
Carex nebularum	ARG(CHU, COR, JUJ, MEN, NEU, SCR, TUC) / CHL(BIO, RME)
Carex nelmesiana	ARG(CHU, SCR)
Carex niederleiniana	ARG(CAT, LRI, RNE, TUC)
Carex ochrostachya	CHL(MAU)
Carex odontolepis	ARG(CHU) / CHL(LBO, BIO, ARA, RME)
Carex otrubae	URY(MON)
Carex patagonica	ARG(CHU, MEN, NEU, RNE, SCR)
Carex phalaroides ssp. crassiflora	ARG(BAI, MIS) / BRA(RGS) / URY(MON, SJO)
Carex phalaroides var. humilis	BRA(SCA)
Carex phalaroides var. elongata	ARG(CAT, JUJ, TUC) / URY(FLA, MAL, MON, SAO, SOR, TYT)
Carex phalaroides var. macella	ARG(BAI, ERI, LRI) / BRA(RGS, SCA) / URY(SOR)
Carex phalaroides ssp. paraguayensis	ARG(MIS) / BRA(RGS, SCA) / PRY(CAU) / URY(CAS, FLA, MAL)
Carex phalaroides ssp. phalaroides	ARG(BAI, COR, COS, ERI, JUJ, LRI, MIS, SAL, TUC) / BRA(PAR, RGS, SCA) / CHL(VAL, BIO, ARA, LLA, JFE) / PRY(Desconocida) / URY(CAS, CLA, FLO, FLA, MAL, MON, RNO, SAO, SJO, SOR, TAC, TYT)
Carex phalaroides var. capitellata	BRA(RGS, SCA)
Carex phalaroides ssp. moesta	BRA(PAR, RGS, SCA) / URY(MON, SAO)
Carex pisanoi	CHL(MAG)
Carex pleioneura	ARG(SJU) / CHL(TAR, COQ)
Carex poeppigii	CHL(BIO)
Carex polystachya	ARG(JUJ, SAL)
Carex polysticha	ARG(BAI, CAT, CHA, COR, COS, DFE, ERI, JUJ, MEN, MIS, NEU, RNE, SAL, SJU, TUC) / BRA(PAR, RGS, SCA) / PRY(APA, CEN) / URY(CLA, CLA, LAV, MAL, MON, PAY, RNO, RIV, ROC, SAO, SJO)
Carex praegracilis	ARG(BAI) / URY(MON)
Carex pseudomacloviana	ARG(SAL, TUC)
Carex pumila	CHL(LBO, MAU, BIO, LLA, AIS, MAG)
Carex purpureovaginata	BRA(PAR, RGS, SCA)
Carex reichei	ARG(CHU, SCR) / CHL(MAU, MAG)
Carex rupicola	ARG(BAI) / URY(CAS)
Carex sagei	ARG(BAI, CHU, NEU, RNE, SCR, TDF) / CHL(BIO, ARA, LLA, MAG)
Carex saltaensis	ARG(SAL)
Carex sellowiana	ARG(BAI, COS, ERI, MIS, TUC) / BRA(PAR, RGS, SCA) / PRY(CAA, GUA) / URY(ART, CAS, COL, FLA, LAV, MAL, RNO, SJO, SOR, TAC, TYT)
Carex seticulmis	BRA(PAR, RGS, SCA)
Carex sorianoi	ARG(CHU, SCR, TDF) / CHL(MAG)
Carex sororia ssp. sororia	ARG(BAI, CAT, CHA, COR, COS, ERI, FOR, LPA, LRI, MIS, RNE, SFE, TUC) / BRA(PAR, RGS, SCA) / PRY(APA, CAU, CAA, CEN, COA, GUA, PAI) / URY(ART, CAS, CLA, CLA, FLO, FLA, LAV, MAL, MON, RNO, SAO, SJO, SJO, TAC, TYT)
Carex sororia var. pseudobracteosa	ARG(ERI)
Carex stuessyi	CHL(JFE)
Carex subandrogyna	ARG(JUJ, SAL)
Carex subantarctica	ARG(CHU, NEU, RNE, SCR, SJU, TDF) / CHL(MAG)
Carex subdivulsa	ARG(LRI, TUC)
Carex subfuegiana	ARG(CHU, NEU, RNE, SCR, SJU)
Carex toroensis	CHL(MAG)
Carex trachycystis	ARG(BAI, CHA, COR, COS, DFE, ERI, FOR, MEN, RNE, SDE, SFE, TUC) / BRA(SCA) / CHL(BIO) / PRY(ÑEE, PHA) / URY(CAS, CLA, FLO, FLA, MAL, MON, PAY, SJO, TAC)
Carex transandina	CHL(MAG)
Carex trichodes	CHL(LLA)
Carex trifida	ARG(TDF) / CHL(AIS, MAG)
Carex tucumanensis	ARG(TUC)
Carex tweediana	ARG(BAI, CHA, COR, COS, DFE, ERI, FOR, MIS, SFE) / BRA(RGS) / PRY(COA) / URY(CAS, COL, FLA, LAV, MON, RNO, RIV, SJO, TAC)
Carex uruguensis	ARG(BAI, COS, DFE, ERI, MIS, TUC) / BRA(RGS, SCA) / URY(CAS, CLA, MON)
Carex vallis-pulchrae var. vallis-pulchrae	ARG(MEN, NEU, SJU) / CHL(ATA, COQ, LBO, MAG, RME)
Carex vallis-pulchrae var. barrosiana	ARG(SCR, TDF) / CHL(MAG)
Carex vixdentata	ARG(BAI, LPA, RNE, SFE) / BRA(RGS) / PRY(CAA) / URY(CAS, MAL, MON)
Carex werdermannii	CHL(LLA)
Carica chilensis	CHL(ATA, COQ, VAL)
Carica glandulosa	ARG(JUJ, SAL, TUC) / BRA(Fuera del área del proyecto)
Carica papaya	ARG(CHA, COS, FOR, MIS, SAL, TUC) / BRA(RGS, SCA) / PRY(AMA, CAU, CEN, PAI)
Carica quercifolia	ARG(CAT, CHA, COS, FOR, JUJ, MIS, SAL, SDE, SFE, TUC) / BRA(PAR, RGS, SCA) / PRY(AMA, CAN, CEN, CON, GUA, PAI, PHA, SPE) / URY(CLA, RIV)
Cariniana estrellensis	BRA(PAR, SCA) / PRY(AMA, CAN, CON)
Carlowrightia sulcata	ARG(CAT, CHA, COR, COS, ERI, FOR, JUJ, MIS, SAL, SLU, SFE, SDE, TUC) / PRY(APY, APA, PHA)
Carolus chlorocarpus	BRA(Fuera del área del proyecto) / PRY(AMA, CAN, CON, SPE)
Carpha schoenoides	ARG(TDF) / CHL(LLA, AIS, MAG)
Carpobrotus chilensis	ARG(CHU) / CHL(ANT, ATA, COQ, VAL, LBO, MAU, BIO, ARA)
Carpobrotus edulis	ARG(BAI) / CHL(VAL, MAU, BIO) / URY(CAS, MAL, MON, ROC)
Carthamus lanatus	ARG(BAI, COS, DFE, ERI, LPA, RNE, SFE, SDE) / BRA(RGS) / CHL(COQ, VAL, LBO, MAU, BIO, ARA, RME, JFE) / URY(CAS, CLA, FLA, LAV, MON, PAY, RNO, SJO, SOR, TYT)
Carthamus tinctorius	ARG(BAI, CAT, CHA, COR, COS, DFE, JUJ, MIS, SAL, SJU, TUC) / CHL(COQ, BIO, RME)
Carya illinoinensis	ARG(BAI, MIS)
Caryocar brasiliense ssp. brasiliense	BRA(PAR) / PRY(AMA, CAN, CON, SPE)
Caryocar brasiliense ssp. intermedium	BRA(PAR) / PRY(APA, AMA, CAN)
Cascaronia astragalina	ARG(JUJ, SAL, TUC)
Casearia aculeata	ARG(FOR) / BRA(PAR) / PRY(APY, AMA, CON, SPE)
Casearia catharinensis	BRA(SCA)
Casearia decandra	ARG(MIS) / BRA(PAR, RGS, SCA) / PRY(APA, AMA, CAU, CAN, COA, GUA, PAI, SPE) / URY(CLA, RIV)
Casearia gossypiosperma	ARG(FOR, MIS) / BRA(PAR) / PRY(APY, APA, AMA, CAA, CAN, CEN, CON, COA, GUA, PAI) / URY(SAO)
Casearia lasiophylla	ARG(MIS) / BRA(PAR, SCA)
Casearia mariquitensis	BRA(PAR)
Casearia obliqua	ARG(MIS) / BRA(PAR, RGS, SCA)
Casearia paranaensis	BRA(PAR)
Casearia sylvestris var. lingua	ARG(ERI) / BRA(PAR)
Casearia sylvestris var. sylvestris	ARG(CHA, COS, ERI, FOR, JUJ, MIS, SAL) / BRA(PAR, RGS, SCA) / PRY(APA, AMA, CAA, CAN, CEN, CON, COA, GUA, ITA, MIE, ÑEE, PAI, PHA, SPE) / URY(ART, CLA, PAY, RIV, ROC, SAO, TYT)
Casimirella guaranitica	PRY(APA, AMA, CAU, CAN, CON, SPE)
Casselia chamaedryfolia	PRY(AMA, CON)
Cassia ferruginea var. velloziana	BRA(PAR)
Cassia leptophylla	BRA(PAR, RGS, SCA)
Castela coccinea	ARG(CAT, CHA, COR, COS, FOR, JUJ, LRI, SAL, SDE, SFE, TUC) / PRY(APY, BOQ, CHO, CON, GUA, ITA, ÑEE, NAS, PHA)
Castela tweedii	ARG(BAI, CAT, CHA, COS, ERI, MIS, SFE, TUC) / BRA(PAR, RGS) / PRY(AMA, CEN, COA, GUA, ITA, MIE, PAI, PHA) / URY(PAY)
Castelnavia princeps	BRA(RGS)
Castilleja arvensis	BRA(PAR, RGS, SCA)
Castilleja attenuata	CHL(VAL, LBO, MAU, BIO, RME)
Castilleja laciniata	CHL(COQ, VAL, MAU, BIO, RME)
Castilleja lithospermoides	ARG(BAI, COR, COS, ERI, JUJ, MIS, SAL, SLU) / BRA(RGS, SCA) / URY(CAS, CLA, MAL, MON, RNO)
Castilleja pumila	ARG(JUJ, SAL, TUC) / CHL(TAR)
Catabrosa aquatica	ARG(SCR, TDF) / CHL(MAG)
Catabrosa werdermannii	ARG(CAT, JUJ, LRI, MEN, SAL, SJU) / CHL(TAR, ANT, ATA, COQ)
Catapodium rigidum	ARG(BAI, ERI, LPA, SLU, SFE) / BRA(RGS) / CHL(COQ, VAL, BIO, ARA, LLA, MAG, RME) / URY(CAS, COL, FLA, MAL, MON, SOR)
Catasetum atratum	BRA(PAR, RGS, SCA)
Catasetum cernuum var. rodigasianum	BRA(SCA)
Catasetum cernuum var. cernuun	BRA(SCA)
Catasetum fimbriatum ssp. fimbriatum	ARG(COS, FOR, JUJ, MIS, SAL) / BRA(PAR, RGS, SCA) / PRY(APY, CAN, PHA, SPE)
Catasetum fimbriatum var. morrenianum	BRA(Fuera del área del proyecto) / PRY(APY, SPE)
Catasetum fimbriatum ssp. fissum	ARG(CHA) / BRA(PAR) / PRY(GUA)
Catasetum fimbriatum var. micranthum	BRA(PAR)
Catasetum fimbriatum var. ornytorrhynchum	BRA(PAR)
Catasetum micranthum	BRA(PAR)
Catasetum rohrii	BRA(SCA)
Catasetum triodon var. guttulatum	BRA(SCA)
Catasetum triodon var. triodon	BRA(PAR, SCA)
Catasetum trulla	BRA(PAR, SCA)
Catharanthus roseus	ARG(COS, ERI) / BRA(SCA) / PRY(CEN, PAI) / URY(SAO)
Catopsis berteroniana	BRA(PAR, SCA)
Catopsis sessiliflora	BRA(PAR, SCA)
Cattleya cernua	ARG(COS, MIS) / BRA(PAR, RGS, SCA) / PRY(COA)
Cattleya forbesii	BRA(PAR, SCA)
Cattleya guttata	BRA(PAR)
Cattleya intermedia	BRA(PAR, RGS, SCA)
Cattleya loddigesii	BRA(PAR)
Cattleya porphyroglossa	BRA(PAR, SCA)
Cattleya tigrina	BRA(RGS, SCA)
Caucalis platycarpos	ARG(BAI, LPA)
Cayaponia alarici	BRA(RGS)
Cayaponia biflora	BRA(RGS, SCA)
Cayaponia bonariensis	ARG(BAI, COR, DFE, ERI, FOR, MIS, SFE) / BRA(PAR, RGS) / PRY(APA, COA) / URY(CAS, FLO, LAV, MAL, MON, PAY, RNO, SAO, SJO, SOR, TAC)
Cayaponia cabocla	BRA(PAR, RGS, SCA)
Cayaponia citrullifolia	ARG(CAT, CHA, COR, COS, ERI, FOR, JUJ, LRI, SAL, SDE, SFE, TUC) / BRA(Fuera del área del proyecto) / PRY(APA, APY, CAN, CEN, CON, COA, GUA, ÑEE, PAI) / URY(CAS, MON, PAY)
Cayaponia cordifolia	BRA(SCA)
Cayaponia diversifolia	ARG(JUJ) / BRA(PAR, RGS) / PRY(APA, CAN, PAI)
Cayaponia espelina	BRA(PAR) / PRY(APA, AMA, CAU, CAN, SPE)
Cayaponia fluminensis	BRA(SCA)
Cayaponia laxa	BRA(SCA)
Cayaponia martiana	ARG(BAI, ERI, MIS) / BRA(PAR, RGS) / URY(MON, ROC)
Cayaponia membranacea	BRA(SCA)
Cayaponia palmata	ARG(MIS) / BRA(PAR, SCA)
Cayaponia pilosa	ARG(MIS) / BRA(PAR, RGS, SCA)
Cayaponia podantha	ARG(BAI, CHA, COR, COS, ERI, FOR, JUJ, LRI, SAL, SFE) / BRA(RGS) / PRY(APY, CEN, CON, COA, PAI, PHA) / URY(PAY)
Cayaponia tayuya	BRA(PAR)
Cayaponia ternata	BRA(PAR, RGS, SCA)
Cayaponia tibiricae	BRA(PAR, RGS)
Cayaponia trifoliolata	BRA(PAR, RGS, SCA)
Cayaponia trilobata	BRA(PAR, SCA)
Cayaponia ulei	BRA(RGS, SCA)
Cayaponia villosissima	BRA(PAR)
Cecropia glaziovii	BRA(PAR, RGS, SCA)
Cecropia pachystachya	ARG(CHA, COS, FOR, MIS, SFE) / BRA(PAR, RGS, SCA) / PRY(APA, AMA, CAU, CAA, CAN, CEN, COA, GUA, ÑEE, PAI)
Cedrela angustifolia	ARG(CAT, JUJ, SAL, TUC)
Cedrela balansae	ARG(CAT, JUJ, SAL, TUC) / PRY(COA)
Cedrela fissilis	ARG(COS, MIS, SAL, TUC) / BRA(PAR, RGS, SCA) / PRY(APA, AMA, CAU, CAA, CAN, CEN, CON, COA, GUA, PAI)
Cedrela odorata	ARG(MIS, SAL) / BRA(PAR) / PRY(CAN, CEN, COA, PAI)
Cedrela saltensis	ARG(JUJ, SAL)
Ceiba chodatii	ARG(BAI, CAT, CHA, FOR, JUJ, LRI, SAL, SDE, TUC) / PRY(APY, CEN, PHA)
Ceiba pubiflora var. pubiflora	ARG(MIS) / BRA(PAR) / PRY(COA, GUA, PAI, SPE)
Ceiba pubiflora var. glabriflora	PRY(COA)
Ceiba samauma	PRY(APY)
Ceiba speciosa	ARG(CHA, COS, FOR, MIS, SFE) / BRA(PAR, RGS, SCA) / PRY(APA, CAU, CEN, COA, GUA)
Celosia argentea f. cristata	BRA(SCA) / PRY(AMA, CAN, CEN)
Celosia argentea f. argentea	ARG(BAI) / BRA(PAR, RGS, SCA) / PRY(AMA, CEN)
Celosia corymbifera	BRA(SCA)
Celosia grandifolia	BRA(RGS, SCA)
Celtis brasiliensis	ARG(COS, FOR, JUJ, SAL, TUC) / BRA(PAR, RGS, SCA) / PRY(APA, AMA, CAU, CAA, CAN, CEN, CON, COA, GUA, ITA, MIE, PAI, PHA, SPE)
Celtis chichape	ARG(CAT, CHA, COR, COS, ERI, FOR, JUJ, LRI, SAL, SDE, SFE, TUC) / BRA(RGS) / PRY(APY, BOQ, CEN, CHO, CON, COA, PAI, PHA) / URY(MAL)
Celtis ehrenbergiana var. discolor	ARG(CAT, FOR, JUJ, SAL, SDE, TUC) / PRY(APY)
Celtis ehrenbergiana var. ehrenbergiana	ARG(BAI, CAT, CHA, COR, COS, DFE, ERI, FOR, JUJ, LPA, LRI, MEN, SAL, SDE, SFE, SJU, SLU, TUC) / BRA(RGS, SCA) / PRY(APY, AMA, CAA, CAN, CEN, COA, ITA, PAI, PHA) / URY(ART, CAS, CLA, COL, CLA, FLA, LAV, MON, PAY, RIV, ROC, SAO, SJO, SJO, TAC)
Celtis iguanaea	ARG(BAI, CAT, CHA, COR, COS, ERI, FOR, JUJ, MIS, SAL, SFE, TUC) / BRA(PAR, RGS, SCA) / PRY(APA, APY, AMA, CAU, CAA, CAN, CEN, CON, COA, GUA, ITA, MIE, ÑEE, PAI, PHA, SPE) / URY(COL, LAV, MAL, PAY, RIV, ROC, TAC, TYT)
Cenchrus americanus	BRA(RGS, SCA)
Cenchrus chilensis	ARG(CAT, COR, JUJ, LRI, SAL, SJU, SLU, TUC) / CHL(TAR, ANT, ATA, COQ, VAL, BIO, RME)
Cenchrus ciliaris	ARG(CAT, CHA, COR, FOR, JUJ, LRI, SAL, SLU, SDE, TUC) / BRA(PAR, RGS) / PRY(APY, BOQ, CHO, GUA, NAS, PHA)
Cenchrus clandestinus	ARG(CHA, COS) / BRA(PAR, RGS) / CHL(ATA, COQ, VAL, LBO, RME, IPA) / PRY(CEN) / URY(MON)
Cenchrus echinatus	ARG(BAI, CHA, COR, COS, ERI, FOR, JUJ, MIS, SAL, SFE, SDE, TUC) / BRA(PAR, RGS, SCA) / CHL(TAR, LLA, IPA) / PRY(APA, APY, BOQ, CEN, CON, COA, GUA, PAI, PHA, SPE) / URY(ART, RIV, SAO)
Cenchrus latifolius	ARG(BAI, CAT, COR, COS, DFE, ERI, JUJ, MIS, SAL, TUC) / BRA(PAR, RGS, SCA) / PRY(APA, APY, AMA, BOQ, CAU, CAA, ITA) / URY(CLA, MON, RIV, ROC, SAO)
Cenchrus longisetus	ARG(BAI, DFE, FOR, JUJ, MEN, SFE, TUC) / BRA(Fuera del área del proyecto) / CHL(RME) / URY(MON)
Cenchrus longispinus	ARG(COR, ERI, LRI, SAL)
Cenchrus mutilatus	ARG(CAT, COR, JUJ, LRI, SAL, SJU, TUC)
Cenchrus myosuroides	ARG(BAI, CAT, CHA, COR, COS, DFE, ERI, FOR, JUJ, LPA, LRI, MEN, MIS, SAL, SJU, SLU, SFE, SDE, TUC) / BRA(RGS) / CHL(TAR, ATA, MAU) / PRY(APY, COA, GUA, ÑEE, NAS, PAI) / URY(COL, MON, PAY, RNO, SAO)
Cenchrus nervosus	ARG(CAT, CHA, COR, COS, DFE, ERI, FOR, JUJ, MIS, SAL, SFE, SDE) / BRA(PAR) / PRY(APA, APY, BOQ, CEN, CON, COA, ITA, PHA, SPE) / URY(MON)
Cenchrus pilcomayensis	ARG(BAI, CAT, CHA, COR, ERI, FOR, JUJ, MIS, SAL, SFE, SDE, TUC) / PRY(APY, PHA)
Cenchrus polystachios	ARG(CAT, CHA, COR) / BRA(RGS)
Cenchrus purpureus	ARG(COS, DFE, FOR, JUJ, MIS, SAL) / BRA(PAR, RGS) / PRY(APA, CAN, CEN, PAI) / URY(ART)
Cenchrus rigidus	ARG(COR, SLU)
Cenchrus setiger	
Cenchrus spinifex	ARG(BAI, CAT, COR, COS, ERI, JUJ, LPA, LRI, MEN, SAL, SJU, SLU, SFE, SDE, TUC) / BRA(PAR, RGS, SCA) / CHL(ATA) / PRY(CEN) / URY(CAS, MAL, MON, PAY, RNO, RIV, ROC, SJO, SJO, TAC, TYT)
Cenchrus tribuloides	BRA(PAR, RGS, SCA)
Cenchrus tristachyus	ARG(JUJ, SAL, TUC)
Centaurea atacamensis	CHL(ANT, ATA, VAL)
Centaurea benedicta	ARG(CHU, COS, LPA, MEN, NEU) / BRA(SCA) / CHL(VAL, MAU, RME) / URY(ART, CLA)
Centaurea bulbosa	CHL(COQ, VAL, BIO, ARA, LLA)
Centaurea cachinalensis	CHL(ANT, ATA, COQ)
Centaurea calcitrapa	ARG(BAI, CHA, COR, COS, DFE, ERI, LPA, MEN, MIS, NEU, RNE, SJU, SLU, SFE) / CHL(VAL, RME) / URY(CAS, CLA, COL, FLA, LAV, MON, PAY, SJO, SOR)
Centaurea chilensis var. stenolepis	CHL(ATA, COQ)
Centaurea chilensis var. breviloba	CHL(COQ, VAL)
Centaurea chilensis var. chilensis	CHL(ATA, COQ, VAL, LBO, RME)
Centaurea cyanus	ARG(BAI, COR, DFE, LPA, RNE) / CHL(AIS, RME)
Centaurea debeauxii	URY(MON)
Centaurea diffusa	ARG(BAI, COR, LPA)
Centaurea floccosa	CHL(COQ, VAL)
Centaurea gayana	CHL(COQ)
Centaurea iberica	ARG(BAI, DFE, NEU, RNE)
Centaurea jacea	ARG(BAI, NEU, RNE) / CHL(ARA)
Centaurea melitensis	ARG(BAI, CAT, CHA, CHU, COR, COS, DFE, ERI, JUJ, LPA, LRI, MEN, MIS, NEU, RNE, SAL, SDE, SFE, SJU, SLU, TUC) / BRA(RGS) / CHL(TAR, ANT, ATA, COQ, VAL, LBO, MAU, BIO, ARA, LLA, MAG, RME, JFE, IPA) / URY(CAS, FLA, MON, PAY, RIV, SAO, SJO, SOR, TAC)
Centaurea monocephala	CHL(BIO)
Centaurea nigra	CHL(ARA)
Centaurea nigrescens	ARG(BAI)
Centaurea solstitialis	ARG(BAI, CHA, CHU, COR, DFE, ERI, LPA, MEN, NEU, RNE, SAL, SJU, SLU, SFE) / CHL(RME) / URY(ART, CAS, COL, FLA, LAV, MON, PAY)
Centaurium ameghinoi	ARG(CHU, NEU, RNE)
Centaurium cachanlahuen	ARG(CHU, NEU, RNE) / CHL(ANT, ATA, COQ, VAL, LBO, MAU, BIO, ARA, LLA, RME, JFE)
Centaurium erythraea	ARG(NEU, RNE)
Centaurium littorale	ARG(BAI)
Centaurium pulchellum	ARG(BAI, CHA, CHU, COR, COS, ERI, FOR, JUJ, LPA, LRI, MEN, SAL, SJU, SFE, SDE, TUC) / BRA(RGS) / CHL(LLA) / URY(ART, MON)
Centaurodendron dracaenoides	CHL(JFE)
Centaurodendron palmiforme	CHL(JFE)
Centella asiatica	ARG(BAI, CAT, CHA, COS, ERI, MIS, SAL, SFE, TUC) / BRA(PAR, RGS, SCA) / CHL(MAU, BIO, ARA, LLA, AIS, RME, JFE) / PRY(AMA, PAI) / URY(CAS, CLA, COL, MON, ROC, TYT)
Centipeda elatinoides	ARG(NEU) / CHL(COQ, LBO, MAU, BIO, ARA, LLA)
Centranthus ruber	ARG(BAI, JUJ, MEN)
Centratherum camporum	ARG(COS, MIS, SFE) / BRA(RGS) / PRY(APA, AMA, CAU, CAA, CAN, CON, COA, MIE, PAI, SPE)
Centratherum punctatum	ARG(COS, MIS, SFE) / BRA(PAR, RGS, SCA) / PRY(APA, AMA, CAU, CAA, CAN, CEN, CON, COA, GUA, ITA, MIE, ÑEE, PAI)
Centrolobium microchaete	BRA(PAR, SCA)
Centrolobium tomentosum	BRA(PAR)
Centrosema angustifolium	BRA(PAR)
Centrosema arenarium	BRA(PAR)
Centrosema bracteosum	BRA(PAR)
Centrosema brasilianum	ARG(MIS) / BRA(PAR, SCA) / PRY(CAN, SPE)
Centrosema kermesi	ARG(CHA, FOR)
Centrosema pascuorum	BRA(PAR) / PRY(APY)
Centrosema plumieri	BRA(PAR) / PRY(APA, CEN, COA, GUA, PAI)
Centrosema sagittatum	ARG(COS, JUJ, MIS, SAL) / BRA(PAR, RGS) / PRY(APA, AMA, CAU, CAA, GUA, ITA, PAI)
Centrosema variifolium	ARG(SAL)
Centrosema virginianum	ARG(CAT, COR, COS, ERI, FOR, JUJ, MIS, SAL, SFE, TUC) / BRA(PAR, RGS, SCA) / PRY(APY, APA, CEN, MIE, PAI, PHA, SPE) / URY(CLA, MAL, MON, RIV, ROC, SOR, TAC)
Centunculus minimus	ARG(BAI, CAT, CHA, COR, COS, DFE, ERI, FOR, JUJ, LPA, MIS, RNE, SAL, SFE, SLU, TUC) / BRA(PAR, RGS, SCA) / CHL(ANT, COQ, VAL, LBO, MAU, BIO, ARA, LLA, RME, JFE) / PRY(CEN, COA, PAI) / URY(FLO, MAL, MON)
Cephalanthus glabratus	ARG(BAI, CHA, COS, ERI, MIS, SFE) / BRA(PAR, RGS) / PRY(APA, CAA, CAN, CEN, CON, COA, ITA, ÑEE, PAI, PHA, SPE) / URY(ART, CLA, COL, DUR, FLA, LAV, MAL, PAY, ROC, SAO, SJO, SOR, TAC, TYT)
Ceradenia albidula	BRA(PAR, RGS, SCA)
Ceradenia spixiana	BRA(PAR, SCA)
Cerastium argentinum	ARG(COR)
Cerastium arvense	ARG(BAI, CAT, CHU, COR, LRI, MEN, NEU, RNE, SAL, SCR, SDE, SJU, SLU, TDF, TUC) / CHL(ATA, COQ, VAL, LBO, MAU, BIO, ARA, LLA, AIS, MAG, RME)
Cerastium commersonianum var. commersonianum	ARG(COS, ERI, MIS) / BRA(PAR, RGS, SCA) / URY(MON)
Cerastium commersonianum var. darwinianum	ARG(BAI)
Cerastium dicrotrichum	ARG(BAI) / BRA(PAR, SCA) / URY(LAV)
Cerastium fontanum ssp. vulgare	ARG(CHU, MEN, NEU, RNE, SCR, TDF) / CHL(ATA, COQ, VAL, LBO, MAU, BIO, ARA, LLA, AIS, MAG, RME, JFE)
Cerastium glomeratum	ARG(BAI, CAT, COR, COS, ERI, JUJ, LPA, MEN, NEU, RNE, SAL, SCR, SFE, SLU, TUC) / BRA(RGS, SCA) / CHL(COQ, VAL, LBO, MAU, BIO, ARA, LLA, AIS, MAG, RME, JFE, IPA) / URY(CAS, MON)
Cerastium hieronymi	ARG(CAT)
Cerastium humifusum	ARG(BAI, COR, ERI, MEN, SJU, SFE) / BRA(RGS) / CHL(ANT, COQ, VAL, RME) / URY(CLA)
Cerastium junceum	ARG(BAI, CHA, COR, COS, ERI, LPA, RNE, SLU, SCR, SFE, TUC) / BRA(RGS) / PRY(Desconocida) / URY(Desconocida)
Cerastium kunthii	ARG(JUJ)
Cerastium lanceolatum	CHL(MAG)
Cerastium mollissimum var. mollissimum	ARG(BAI, COR, SLU) / BRA(Fuera del área del proyecto) / URY(RIV)
Cerastium mollissimum var. lorentzii	ARG(BAI)
Cerastium mucronatum 	CHL(TAR)
Cerastium rivulare	ARG(BAI, COS, ERI, MIS, SFE) / BRA(PAR, RGS, SCA) / PRY(APY, APA, CAN, GUA, ITA, MIE)
Cerastium rivulariastrum	ARG(BAI, CAT, CHA, COR, COS, ERI, FOR, JUJ, LPA, LRI, MIS, SAL, SDE, SFE, SLU, TUC) / BRA(PAR, RGS) / PRY(CAN, CEN, GUA, MIE, PAI) / URY(MON, SJO)
Cerastium soratense	ARG(CAT, JUJ, LRI, SJU)
Cerastium tucumanense	ARG(CAT, JUJ, LRI, SAL, TUC)
Cerastium verecundum	CHL(RME)
Ceratocephalus falcatus	ARG(MEN)
Ceratophyllum demersum	ARG(BAI, COR, COS, ERI, FOR, LRI, RNE, SAL, SFE) / BRA(RGS, SCA) / CHL(VAL, BIO, RME) / PRY(APY) / URY(CLA, COL, ROC, SJO)
Ceratophyllum muricatum ssp. australe	ARG(TUC)
Ceratopteris pteridoides	ARG(BAI, CHA, COS, FOR, MIS) / BRA(Fuera del área del proyecto) / PRY(APY, CEN, CON, COA)
Ceratosanthes hilariana	ARG(FOR, MIS) / BRA(PAR, RGS) / PRY(APA, AMA, CON)
Ceratosanthes multiloba	ARG(CHA, COS, FOR, MIS, SAL, SDE, TUC) / BRA(PAR) / PRY(APA, AMA, CAU, PHA) / URY(RIV, TAC)
Ceratostigma plumbaginoides	ARG(COR)
Cercidium andicola	ARG(JUJ, TUC)
Cercidium praecox ssp. glaucum	ARG(CAT, LPA, LRI, MEN, NEU, RNE, SAL, SJU, SLU, SFE, SDE, TUC)
Cercidium praecox ssp. praecox	ARG(CAT, CHA, COR, FOR, JUJ, SAL, SDE, SFE, SLU, TUC) / PRY(APY, AMA, PHA)
Cereus aethiops	ARG(BAI, CAT, COR, LPA, LRI, MEN, RNE, SAL, SFE, SJU, SLU, TUC)
Cereus alacriportamus	BRA(RGS)
Cereus argentinensis	ARG(COS, ERI)
Cereus forbesii	ARG(CAT, CHA, COR, FOR, JUJ, LRI, SAL, SFE)
Cereus haenkeanus	ARG(CAT, JUJ, SAL)
Cereus hildmannianus	BRA(PAR, RGS, SCA)
Cereus paraguayensis	PRY(CAU, COA)
Cereus stenogonus	ARG(CHA, COS, FOR, MIS, SAL) / PRY(APY, AMA, BOQ, CEN, CON, ÑEE, PAI, SPE) / URY(RNO)
Cereus uruguayanus	ARG(BAI, ERI) / BRA(RGS) / URY(ART, CAS, COL, RIV, TAC, TYT)
Cestrum auriculatum	CHL(TAR)
Cestrum bracteatum	ARG(MIS) / BRA(PAR, SCA)
Cestrum cordatum	BRA(Fuera del área del proyecto) / PRY(COA)
Cestrum coriaceum	BRA(PAR)
Cestrum corymbosum var. hirsutum	BRA(SCA)
Cestrum corymbosum var. corymbosum	BRA(PAR, RGS, SCA) / PRY(AMA, CAA, CAN, COA, PAI, SPE) / URY(ART, CLA, PAY, RNO, SJO, TAC, TYT)
Cestrum euanthes	ARG(BAI, COS, ERI, MIS) / BRA(PAR, RGS, SCA) / PRY(PHA) / URY(CAS, SJO)
Cestrum guaraniticum	ARG(CHA, COS, ERI, FOR, MIS, SFE) / PRY(CON, PAI, PHA)
Cestrum hassleri	PRY(AMA)
Cestrum intermedium	BRA(PAR, RGS, SCA) / PRY(APA)
Cestrum kunthii	ARG(CAT, SAL, TUC)
Cestrum laevigatum	ARG(COS, MIS) / BRA(Fuera del área del proyecto) / PRY(CAA, GUA, ÑEE, SPE)
Cestrum lorentzianum	ARG(CAT, COR, JUJ, SAL, TUC)
Cestrum mariquitense	ARG(COS, MIS) / PRY(APY, APA, AMA, CAU, CAA, CAN, CEN, CON, COA, ITA, PAI, SPE)
Cestrum parqui	ARG(BAI, CAT, CHA, COR, COS, ERI, FOR, JUJ, LRI, MEN, MIS, RNE, SAL, SDE, SFE, SJU, SLU, TUC) / BRA(RGS) / CHL(TAR, ANT, ATA, COQ, VAL, LBO, MAU, BIO, ARA, LLA, RME, JFE) / PRY(COA, PHA) / URY(ROC, TAC)
Cestrum reflexum	ARG(SAL) / BRA(Fuera del área del proyecto)
Cestrum strigilatum	ARG(CAT, CHA, COS, FOR, JUJ, LRI, MIS, SAL, SFE, SDE, TUC) / BRA(PAR, RGS, SCA) / PRY(APA, AMA, CAA, CAN, CEN, COA, GUA, ÑEE, PAI, PHA) / URY(RIV, TAC)
Cestrum tubulosum	BRA(Fuera del área del proyecto) / PRY(AMA)
Cestrum velutinum	ARG(CAT, JUJ, SAL) / BRA(Fuera del área del proyecto) / PRY(AMA)
Ceterach officinarum	ARG(BAI, SFE)
Chacoa pseudoprasiifolia	ARG(CHA, COS, FOR, MIS, SFE) / BRA(SCA) / PRY(APY, AMA, CEN, CHO, CON, COA, GUA, PAI, PHA, SPE)
Chaetanthera albiflora	CHL(ANT, ATA, COQ, VAL)
Chaetanthera australis	ARG(NEU, RNE)
Chaetanthera chilensis var. chilensis	CHL(COQ, VAL, LBO, MAU, BIO, ARA, RME, JFE)
Chaetanthera chilensis var. tenuifolia	ARG(MEN)
Chaetanthera ciliata	CHL(VAL, LBO, MAU, BIO, ARA, RME)
Chaetanthera depauperata	CHL(ATA, COQ, VAL, RME)
Chaetanthera elegans var. pratensis	ARG(NEU)
Chaetanthera elegans var. pulchra	ARG(CHU, NEU)
Chaetanthera elegans var. elegans	ARG(NEU) / CHL(LBO, MAU, BIO, ARA, LLA)
Chaetanthera euphrasioides	ARG(MEN, NEU, RNE, SJU) / CHL(COQ, VAL, LBO, MAU, RME)
Chaetanthera flabellata	CHL(VAL, MAU, RME)
Chaetanthera flabellifolia	CHL(COQ)
Chaetanthera frayjorgensis	CHL(ATA, COQ)
Chaetanthera glabrata	CHL(ANT, ATA, COQ, VAL, LBO, RME)
Chaetanthera glandulosa	CHL(COQ, VAL, RME)
Chaetanthera glandulosa var. gracilis	CHL(VAL)
Chaetanthera incana	CHL(COQ, VAL, RME)
Chaetanthera kalinae	CHL(ATA, COQ)
Chaetanthera lanata	ARG(LRI, SJU) / CHL(ANT, ATA, COQ, VAL, RME)
Chaetanthera limbata	ARG(SJU) / CHL(ANT, ATA, COQ, VAL, LBO, RME)
Chaetanthera linearis var. linearis	CHL(ANT, ATA, COQ, VAL, LBO, RME)
Chaetanthera microphylla var. microphylla	ARG(NEU) / CHL(VAL, LBO, MAU, BIO, RME)
Chaetanthera moenchioides	ARG(NEU, RNE) / CHL(COQ, VAL, LBO, MAU, BIO, ARA, LLA, RME)
Chaetanthera multicaulis	CHL(VAL, LBO, RME)
Chaetanthera perpusilla	CHL(TAR)
Chaetanthera pubescens	CHL(ATA, COQ)
Chaetanthera ramosissima	CHL(ATA, COQ, VAL, LBO, MAU, RME)
Chaetanthera renifolia	CHL(RME)
Chaetanthera serrata	CHL(VAL, LBO, MAU, BIO, ARA, LLA, RME)
Chaetanthera spathulifolia	ARG(MEN, SJU) / CHL(COQ, VAL)
Chaetanthera splendens	ARG(SJU) / CHL(COQ, RME)
Chaetanthera taltalensis	CHL(ANT, ATA, COQ)
Chaetanthera villosa	ARG(MEN, NEU, RNE) / CHL(LBO, MAU, BIO, ARA, RME)
Chaetocalyx brasiliensis	ARG(CHA, COS, FOR, MIS, SAL, TUC) / BRA(PAR, SCA) / PRY(APA, CEN, CON, COA, GUA, PHA)
Chaetocalyx chacoensis	PRY(APY)
Chaetocalyx latifolia var. setulifera	ARG(SAL) / PRY(CEN)
Chaetocalyx latifolia var. latifolia	ARG(COS, MIS) / BRA(Fuera del área del proyecto) / PRY(CEN, COA)
Chaetocalyx longiflora	ARG(COS, MIS, SAL) / BRA(PAR) / PRY(APA, COA)
Chaetocalyx nigricans	ARG(COS, ERI, MIS) / BRA(PAR, SCA) / PRY(APA) / URY(ART, SAO)
Chaetostoma armatum	BRA(PAR)
Chaetostoma pungens	BRA(PAR)
Chaetotropis asperigluma	ARG(CHU, NEU) / CHL(ARA)
Chaetotropis parvula	ARG(SFE) / URY(TAC)
Chamaecrista absus	PRY(COA)
Chamaecrista amambaya	PRY(AMA, SPE)
Chamaecrista arachiphylla	ARG(SAL) / PRY(APY)
Chamaecrista calycioides	ARG(COS, SDE) / PRY(CAU, CON)
Chamaecrista campestris	PRY(AMA, CAN)
Chamaecrista cordistipula	PRY(COA, PAI)
Chamaecrista desvauxii var. piribebuiensis	PRY(COA, PAI)
Chamaecrista desvauxii var. mollissima	ARG(MIS) / BRA(PAR, SCA) / PRY(APY, AMA, CAU, COA, SPE)
Chamaecrista desvauxii var. langsdorffii	BRA(PAR) / PRY(AMA, PAI)
Chamaecrista desvauxii var. desvauxii	BRA(PAR, SCA)
Chamaecrista desvauxii var. latistipula	ARG(COS, MIS) / BRA(PAR) / PRY(AMA)
Chamaecrista desvauxii var. brevipes	BRA(Fuera del área del proyecto) / PRY(AMA, CAN)
Chamaecrista flexuosa	ARG(COS, ERI, MIS) / BRA(PAR, RGS, SCA) / PRY(APY, CEN, COA, PAI) / URY(COL, RNO, SAO)
Chamaecrista gonoclada	ARG(COS) / BRA(PAR) / PRY(AMA)
Chamaecrista hassleri	PRY(AMA)
Chamaecrista incana	BRA(PAR)
Chamaecrista nictitans ssp. disadena	BRA(Fuera del área del proyecto) / PRY(AMA)
Chamaecrista nictitans var. ramosa	BRA(PAR, RGS, SCA)
Chamaecrista nictitans var. patellaria	ARG(CHA, COR, COS, FOR, MIS, SFE) / BRA(PAR, RGS, SCA) / PRY(GUA, ÑEE)
Chamaecrista nictitans ssp. brachypoda	BRA(Fuera del área del proyecto) / PRY(COA, PHA)
Chamaecrista nictitans var. paraguariensis	BRA(PAR) / PRY(CAA, CAN, COA)
Chamaecrista nictitans var. jaliscensis	ARG(JUJ, SAL)
Chamaecrista nictitans var. pilosa	BRA(RGS, SCA) / PRY(AMA)
Chamaecrista punctata	BRA(PAR, SCA)
Chamaecrista ramosa var. parvifoliola	BRA(PAR)
Chamaecrista repens	ARG(COR, COS, ERI, JUJ, MIS, SAL, SFE) / BRA(PAR, RGS, SCA) / PRY(AMA, CAA, ITA, MIE) / URY(ART, PAY, RIV, SAO)
Chamaecrista rotundifolia var. rotundifolia	ARG(COS, ERI, FOR, MIS, SFE) / BRA(PAR, RGS) / PRY(APY, AMA, CAU, CAA, CEN, COA) / URY(COL, PAY, RNO, TAC)
Chamaecrista rotundifolia var. grandiflora	ARG(COS) / BRA(Fuera del área del proyecto) / PRY(AMA)
Chamaecrista serpens var. grandiflora	ARG(COS, MIS) / BRA(Fuera del área del proyecto) / PRY(CEN, COA) / URY(RNO)
Chamaecrista serpens var. serpens	ARG(CHA, COS, ERI, MIS) / BRA(Fuera del área del proyecto) / PRY(APY)
Chamaecrista venturiana	ARG(COR, SAL, TUC) / PRY(CAU, ITA)
Chamaecrista vestita	BRA(PAR, SCA) / PRY(AMA)
Chamaecrista viscosa var. paraguayensis	ARG(COS) / PRY(CAN, COA)
Chamissoa acuminata	ARG(COS, JUJ, MIS) / BRA(PAR, RGS, SCA) / PRY(APA, CAN, GUA, SPE)
Chamissoa altissima	ARG(CHA, COS, FOR, JUJ, MIS, SAL, TUC) / BRA(PAR, RGS, SCA) / PRY(APA, AMA, CAA, CAN, CON, COA, GUA, ITA, MIE, PAI, SPE) / URY(ART)
Chamissoa maximiliani	ARG(COS, JUJ, MIS, SAL) / BRA(PAR) / PRY(APY, AMA, CAU, CAN, CEN, CON, GUA, PAI)
Chaptalia arechavaletae	ARG(BAI, COS, DFE, ERI, MIS) / BRA(RGS) / URY(CAS, CLA, COL, FLA, LAV, MAL, MON, PAY, RNO, ROC, SJO, SOR, TYT)
Chaptalia cordifolia	BRA(PAR, RGS, SCA)
Chaptalia exscapa var. chilensis	CHL(VAL, MAU, BIO, ARA, RME)
Chaptalia exscapa var. exscapa	ARG(BAI, COR, DFE, ERI, SFE, SLU) / BRA(PAR, RGS, SCA) / URY(CAS, FLO, FLA, MAL, MON, RNO, ROC, SOR)
Chaptalia ignota	ARG(BAI, COS, ERI, SFE) / BRA(RGS) / URY(ART, CLA, PAY, RNO, SAO)
Chaptalia integerrima	ARG(BAI, CAT, CHA, COR, COS, ERI, JUJ, LPA, LRI, MIS, SAL, SJU, SLU, SFE, SDE, TUC) / BRA(PAR, RGS, SCA) / PRY(APY, APA, AMA, CAU, CAA, CAN, CEN, CON, COA, GUA, MIE, PAI) / URY(CLA, COL, LAV, MAL, MON, PAY, RNO, RIV, TAC)
Chaptalia modesta	ARG(CAT, JUJ, SAL, SJU, TUC)
Chaptalia nutans	ARG(BAI, CAT, CHA, COR, COS, ERI, FOR, JUJ, LRI, MIS, SAL, SDE, SFE, SJU, SLU, TUC) / BRA(PAR, RGS, SCA) / PRY(APA, AMA, CAU, CAA, CAN, CEN, COA, GUA, PAI, PHA) / URY(ART, RIV, SAO, TAC)
Chaptalia piloselloides	ARG(BAI, CAT, CHA, COR, COS, ERI, FOR, JUJ, LPA, LRI, MIS, SAL, SFE, TUC) / BRA(PAR, RGS, SCA) / PRY(COA, GUA, ITA, PAI, SPE) / URY(CAS, FLO, FLA, MAL, MON, PAY, RNO, ROC, SJO, TAC)
Chaptalia similis	ARG(CAT, COR, JUJ, LRI, MEN, SAL, SJU, SLU, TUC)
Chaptalia sinuata	ARG(BAI, CAT, CHA, COR, COS, ERI, FOR, JUJ, LPA, MIS, SAL, SJU, SLU, SFE, TUC) / BRA(PAR, RGS, SCA) / PRY(APY, APA, AMA, CAU, CAA, CEN, CON, COA, GUA, MIE, PAI) / URY(COL, LAV, MAL, PAY, RNO, RIV, SAO)
Chascolytrum bidentatum	BRA(PAR, RGS) / URY(RIV, TYT)
Chascolytrum brachychaetum	BRA(PAR, RGS, SCA)
Chascolytrum brasiliense	BRA(PAR, RGS)
Chascolytrum brizoides	ARG(BAI) / BRA(RGS) / CHL(LBO, BIO, ARA) / URY(CAS, CLA, CLA, FLO, FLA, LAV, MAL, MON, PAY, RNO, SAO, SJO, SJO, TAC)
Chascolytrum bulbosum	BRA(RGS) / URY(CLA, LAV, MAL, ROC)
Chascolytrum calotheca	ARG(COS, ERI, MIS) / BRA(PAR, RGS, SCA) / PRY(APA, AMA, CAN, COA, GUA, MIE, PAI, SPE) / URY(FLA, MON, RIV, SJO, TAC)
Chascolytrum erectum	ARG(BAI, CHA, COR, COS, ERI, MIS, SLU, SFE) / BRA(RGS, SCA) / PRY(CAU, MIE, PAI) / URY(CAS, CLA, COL, FLA, LAV, MAL, MON, PAY, RNO, RIV, ROC, SAO, SJO, TAC, TYT)
Chascolytrum juergensii var. juergensii	BRA(PAR, RGS, SCA)
Chascolytrum juergensii var. angustilemma	BRA(RGS, SCA)
Chascolytrum koelerioides	CHL(VAL, MAU, BIO, ARA, LLA)
Chascolytrum lamarckianum	ARG(COS, ERI, MIS, SFE) / BRA(PAR, RGS, SCA) / URY(CAS, CLA, FLA, LAV, MAL, MON, PAY, RNO, RIV, ROC, SJO, SJO, TAC, TYT)
Chascolytrum latifolium	BRA(RGS, SCA)
Chascolytrum monandrum	ARG(JUJ, SAL, TUC) / BRA(PAR, SCA)
Chascolytrum paleapiliferum	ARG(CAT, COR, LRI, MEN, SLU)
Chascolytrum parodianum	BRA(PAR, RGS, SCA) / URY(LAV, MAL)
Chascolytrum poomorphum	ARG(COS, ERI, MIS, SFE) / BRA(PAR, RGS, SCA) / PRY(GUA) / URY(CLA, COL, LAV, MAL, MON, ROC, SJO, SJO, TAC, TYT)
Chascolytrum rhomboideum	CHL(VAL, LBO, RME)
Chascolytrum rufum	ARG(BAI, COS, ERI, SLU) / BRA(PAR, RGS, SCA) / URY(CLA, FLO, LAV, MAL, MON, ROC, SJO, TYT)
Chascolytrum scabrum	BRA(RGS)
Chascolytrum subaristatum	ARG(BAI, CAT, CHA, CHU, COR, COS, ERI, JUJ, LPA, MIS, NEU, RNE, SAL, SLU, SFE, SDE, TUC) / BRA(PAR, RGS, SCA) / CHL(COQ, VAL, LBO, MAU, BIO, ARA, LLA, RME, JFE) / PRY(CAU, CON, GUA, ITA, PAI) / URY(ART, CAS, CLA, COL, CLA, FLO, FLA, LAV, MAL, MON, PAY, RNO, RIV, ROC, SAO, SJO, SJO, TAC, TYT)
Chascolytrum uniolae	ARG(BAI, CHA, COS, ERI, FOR, JUJ, MIS, SAL, SFE, TUC) / BRA(PAR, RGS, SCA) / PRY(APA, CAU, CAA, CEN, COA, GUA, ITA, MIE, ÑEE, PAI, PHA) / URY(CAS, MAL, MON, RIV, SJO, TYT)
Chasmanthe floribunda	ARG(BAI)
Cheilanthes andina	CHL(LLA)
Cheilanthes arequipensis	ARG(JUJ, SAL, TUC) / CHL(TAR)
Cheilanthes buchtienii	ARG(BAI, CAT, COR, JUJ, LPA, LRI, MEN, SAL, SJU, SLU, SDE, TUC)
Cheilanthes glauca	ARG(CHU, MEN, NEU, RNE, SCR) / CHL(COQ, VAL, LBO, MAU, BIO, ARA, LLA, AIS, RME)
Cheilanthes hassleri	PRY(CON)
Cheilanthes hieronymi	ARG(BAI, CAT, LPA, MEN) / BRA(RGS) / URY(LAV, RIV, SOR, TAC)
Cheilanthes hypoleuca	ARG(CHU, MEN, RNE) / CHL(ANT, ATA, COQ, VAL, LBO, MAU, BIO, ARA, RME)
Cheilanthes juergensii	BRA(RGS) / URY(RIV)
Cheilanthes micropteris	ARG(BAI, CAT, COR, COS, ERI, LPA, LRI, MEN, MIS, SAL, SDE, SJU, SLU, TUC) / BRA(RGS, SCA) / PRY(COA, PAI) / URY(LAV, SOR, TAC, TYT)
Cheilanthes mollis	CHL(TAR, ANT, ATA, COQ, VAL, LBO, RME)
Cheilanthes obducta	ARG(CAT, CHA, COR, COS, FOR, JUJ, LRI, SAL, SJU, SLU, SDE, TUC) / PRY(APY)
Cheilanthes pilosa	ARG(BAI, CAT, COR, JUJ, MEN, SAL, SLU, TUC) / CHL(TAR)
Cheilanthes poeppigiana	ARG(CAT, JUJ, SAL, TUC)
Cheilanthes pruinata	ARG(CAT, COR, JUJ, LRI, MEN, SAL, SJU, SLU, TUC) / CHL(TAR, ANT)
Cheilanthes regularis	BRA(PAR, RGS, SCA) / PRY(APA)
Cheilanthes sarmientoi	ARG(CAT, LPA, MEN, SAL, SJU)
Cheilanthes squamosa	ARG(BAI, CAT, COR, JUJ, LRI, MEN, SAL, SDE, SJU, SLU, TUC)
Cheilanthes volcanensis	ARG(CAT, JUJ, TUC)
Cheiloclinium serratum	BRA(PAR, SCA)
Chelidonium majus	ARG(BAI, MEN, NEU, RNE)
Chelonanthus grandiflorus	PRY(AMA)
Chelonanthus viridiflorus	ARG(COS, MIS) / BRA(Fuera del área del proyecto) / PRY(APA, CAU, CAN, ITA, SPE)
Chenopodiastrum murale	ARG(BAI, CAT, CHU, COR, COS, ERI, LPA, MEN, SAL, SJU, SLU, SFE, SDE, TUC) / CHL(TAR, ANT, ATA, COQ, VAL, LBO, MAU, BIO, ARA, LLA, RME, IDE, JFE) / URY(MAL, MON, PAY, RNO, SJO)
Chenopodium album	ARG(BAI, CAT, CHA, CHU, COR, COS, ERI, FOR, JUJ, LPA, LRI, MEN, MIS, NEU, RNE, SAL, SJU, SLU, SCR, SFE, TUC) / CHL(AYP, TAR, ANT, ATA, COQ, VAL, LBO, MAU, BIO, ARA, LLA, AIS, MAG, RME) / PRY(SPE) / URY(COL, MON, PAY, RNO, SJO)
Chenopodium antarcticum	ARG(SCR, TDF) / CHL(MAG)
Chenopodium borbasii	ARG(BAI, CHA, COR, COS, DFE, ERI, FOR, LPA, LRI, MEN, MIS, RNE, SDE, SJU, TUC)
Chenopodium carnosulum	ARG(CHU, JUJ, SAL, SCR, TDF, TUC) / CHL(VAL, LLA, AIS, MAG)
Chenopodium cordobense	ARG(BAI, CAT, COR, LPA, MEN, NEU, SDE, SJU)
Chenopodium crusoeanum	CHL(JFE)
Chenopodium dessicatum var. leptophylloides	ARG(BAI, COR, COS, LPA, LRI, MEN, NEU, RNE, SJU, SLU, SFE, SDE)
Chenopodium ficifolium	CHL(VAL, LLA, MAG)
Chenopodium frigidum	ARG(CAT, LRI, MEN, NEU, SAL, SJU) / CHL(TAR, ANT, ATA, COQ, RME)
Chenopodium giganteum	ARG(BAI, COR, DFE, MEN)
Chenopodium hircinum ssp. catamarcensis	ARG(CAT, LRI, TUC)
Chenopodium hircinum ssp. hircinum	ARG(BAI, CAT, CHA, COR, COS, DFE, ERI, FOR, JUJ, LPA, LRI, MEN, NEU, RNE, SAL, SJU, SLU, SFE, SDE, TUC) / CHL(TAR, ANT, ATA, COQ, VAL, LBO, LLA, RME) / PRY(COA) / URY(MON)
Chenopodium mandonii	ARG(CAT, JUJ, LRI, SAL, SJU, TUC) / CHL(VAL)
Chenopodium nesodendron	CHL(JFE)
Chenopodium obscurum	ARG(BAI, COR)
Chenopodium pallidicaule	ARG(JUJ, SAL)
Chenopodium papulosum	ARG(BAI, CAT, COR, LPA, MEN, SJU, SLU) / CHL(ATA, COQ, VAL, LLA)
Chenopodium parodii	ARG(CHU, MEN, NEU, RNE, SCR)
Chenopodium petiolare	ARG(JUJ) / CHL(TAR, ANT, ATA, COQ, VAL)
Chenopodium philippianum	ARG(MEN, NEU) / CHL(COQ, VAL, LBO, MAU, RME)
Chenopodium pilcomayense	ARG(CHA, COR, FOR, JUJ, LRI, SAL, SDE, SFE) / PRY(APY, PHA)
Chenopodium purpurascens	ARG(BAI)
Chenopodium quinoa var. quinoa	ARG(COR) / CHL(TAR, ANT, BIO, LLA)
Chenopodium quinoa var. melanospermum	ARG(JUJ, SAL)
Chenopodium ruiz-lealii	ARG(MEN)
Chenopodium sanctae-clarae	CHL(JFE)
Chenopodium sancti-ambrosii	CHL(IDE)
Chenopodium scabricaule	ARG(CHU, MEN, NEU, RNE, SCR, SJU)
Chenopodium vulvaria	ARG(CHU, MEN, TDF) / CHL(TAR, ANT, MAU, RME)
Chersodoma arequipensis	CHL(TAR, ANT)
Chersodoma argentina	ARG(CAT, JUJ, LRI, SAL, TUC)
Chersodoma candida	ARG(JUJ, SAL) / CHL(TAR, ANT)
Chersodoma glabriuscula	ARG(CAT, JUJ, LRI, SAL, TUC)
Chersodoma jodopappa	ARG(CAT, JUJ, LRI, SAL, TUC) / CHL(TAR, ANT)
Chevreulia acuminata	ARG(BAI, CAT, CHA, COR, COS, ERI, JUJ, MIS, SAL, SFE, SLU, TUC) / BRA(PAR, RGS, SCA) / PRY(CAU) / URY(CAS, CLA, MON, PAY, RNO, TAC)
Chevreulia diemii	ARG(CHU, NEU) / CHL(MAU, ARA, LLA)
Chevreulia lycopodioides	ARG(TDF) / CHL(ARA, LLA)
Chevreulia pusilla	ARG(CHU) / CHL(VAL, BIO, ARA, LLA)
Chevreulia revoluta	BRA(RGS)
Chevreulia sarmentosa	ARG(BAI, COR, COS, DFE, ERI, JUJ, LPA, LRI, MIS, RNE, SAL, SFE, SLU, TUC) / BRA(PAR, RGS, SCA) / CHL(BIO, ARA, LLA) / PRY(GUA, ITA, PAI) / URY(ART, CAS, CLA, FLA, MAL, MON, PAY, RNO, ROC)
Chileorchis disoides	CHL(COQ, VAL, LBO, BIO, ARA, RME)
Chiliophyllum densifolium	ARG(MEN, SJU)
Chiliotrichiopsis keidelii	ARG(CAT, JUJ, LRI, SAL, TUC)
Chiliotrichiopsis ledifolia	ARG(CAT, LRI)
Chiliotrichum diffusum	ARG(CHU, MEN, NEU, RNE, SCR, TDF) / CHL(LBO, MAU, BIO, ARA, LLA, AIS, MAG)
Chiliotrichum fuegianum	ARG(TDF) / CHL(MAG)
Chilocardamum castellanosii	ARG(CHU, RNE, SCR)
Chilocardamum longistylum	ARG(CHU, NEU)
Chilocardamum onuridifolium	ARG(CHU, SCR)
Chilocardamum patagonicum	ARG(CHU, SCR)
Chiococca alba	ARG(COS, MIS) / BRA(PAR, RGS, SCA) / PRY(CAN) / URY(ROC)
Chionanthus crassifolius	BRA(PAR)
Chionanthus filiformis	BRA(PAR, SCA)
Chionanthus trichotomus	ARG(COS, MIS) / BRA(PAR, RGS) / PRY(AMA)
Chiropetalum anisotrichum	BRA(RGS)
Chiropetalum argentinense	ARG(CAT, CHA, COR, LPA, LRI, SDE, SFE, SLU, TUC)
Chiropetalum berterianum var. berterianum	CHL(ATA, COQ, VAL, LBO, MAU, ARA, RME)
Chiropetalum berterianum var. psiladenium	CHL(ATA, COQ, VAL)
Chiropetalum boliviense	ARG(CAT, JUJ, LRI, SAL, TUC)
Chiropetalum canescens	CHL(ANT, ATA)
Chiropetalum cremnophilum	CHL(ANT, ATA, COQ)
Chiropetalum griseum	ARG(BAI, CHA, COR, COS, ERI, FOR, SFE, SLU) / PRY(APY, ÑEE, PHA) / URY(SJO)
Chiropetalum gymnadenium	BRA(RGS)
Chiropetalum intermedium	ARG(BAI) / URY(CAS, FLO, FLA)
Chiropetalum molle	BRA(RGS)
Chiropetalum patagonicum	ARG(CHU, COR, LPA, MEN, RNE, SCR, SLU)
Chiropetalum phalacradenium	BRA(RGS, SCA)
Chiropetalum pilosistylum	BRA(RGS, SCA)
Chiropetalum puntaloberense	URY(ROC)
Chiropetalum ramboi	BRA(RGS)
Chiropetalum tricoccum	ARG(COR, COS, ERI, FOR, JUJ, MIS) / BRA(PAR, RGS, SCA) / PRY(CEN, COA, ÑEE, PAI) / URY(DUR, FLO, FLA, RNO, SAO)
Chiropetalum tricuspidatum	ARG(CAT, COR, LRI, SLU, TUC) / CHL(VAL, LBO, MAU, BIO, ARA)
Chlidanthus marginatus	ARG(JUJ)
Chlidanthus yaviensis	ARG(JUJ)
Chloraea alpina	ARG(CHU, NEU, RNE, SCR) / CHL(LBO, MAU, BIO, ARA, AIS, RME)
Chloraea barbata	ARG(NEU) / CHL(VAL, BIO, ARA, RME)
Chloraea bella	ARG(ERI)
Chloraea bidentata	ARG(NEU) / CHL(BIO, ARA)
Chloraea biserialis	ARG(CAT, TUC)
Chloraea bletioides	CHL(COQ, VAL, LBO, MAU, BIO, RME)
Chloraea castillonii	ARG(SAL, TUC)
Chloraea chrysantha	CHL(COQ, VAL, LBO, MAU, BIO, ARA, RME)
Chloraea chrysochlora	ARG(CHU, NEU) / CHL(BIO, ARA, LLA)
Chloraea cogniauxii	ARG(JUJ)
Chloraea crispa	CHL(VAL, BIO, ARA, LLA)
Chloraea cristata	CHL(VAL, LBO, BIO, LLA)
Chloraea cuneata	CHL(MAU, BIO, ARA, LLA)
Chloraea curicana	CHL(MAU)
Chloraea deflexa	CHL(COQ)
Chloraea disoides var. picta	ARG(MEN) / CHL(COQ, LBO, RME)
Chloraea elegans	ARG(SAL)
Chloraea galeata	CHL(MAU)
Chloraea gaudichaudii	ARG(NEU, RNE, SCR, TDF) / CHL(ARA, LLA, AIS, MAG)
Chloraea gavilu	CHL(VAL, LBO, MAU, BIO, ARA, LLA)
Chloraea heteroglossa	CHL(VAL)
Chloraea lamellata	CHL(LBO, BIO, ARA, LLA)
Chloraea laxiflora	ARG(SAL, TUC)
Chloraea longipetala	CHL(VAL, MAU, BIO, ARA, LLA)
Chloraea magellanica	ARG(CHU, NEU, RNE, SCR) / CHL(ARA, LLA, AIS, MAG)
Chloraea major	CHL(RME)
Chloraea membranacea	ARG(BAI, COS, ERI, SFE) / BRA(PAR, RGS, SCA) / URY(CAS, CLA, FLA, MAL, MON, RIV, SJO, SOR, TAC, TYT)
Chloraea multiflora	CHL(VAL, LBO, MAU, BIO, ARA)
Chloraea nudilabia	CHL(MAU, BIO, ARA, LLA)
Chloraea philippii	ARG(CHU, NEU, RNE) / CHL(BIO, ARA, LLA, AIS)
Chloraea phoenicea	ARG(SAL, TUC)
Chloraea praecincta	ARG(CAT, JUJ, TUC)
Chloraea prodigiosa	CHL(LBO, MAU, LLA)
Chloraea reticulata	ARG(CAT, JUJ, SAL)
Chloraea riojana	ARG(LRI)
Chloraea speciosa	ARG(CHU, NEU) / CHL(BIO, ARA, LLA)
Chloraea subpandurata	ARG(JUJ, SAL, TUC)
Chloraea tectata	CHL(COQ)
Chloraea virescens	ARG(CHU, NEU, RNE) / CHL(VAL, ARA, LLA)
Chloraea viridiflora	ARG(NEU) / CHL(BIO)
Chloraea volkmannii	ARG(NEU) / CHL(BIO, ARA)
Chloris affinis	ARG(TUC)
Chloris barbata	ARG(BAI, FOR, MIS, SLU) / BRA(Fuera del área del proyecto) / PRY(PHA)
Chloris castilloniana var. pubescens	ARG(FOR, LRI, MEN, SAL, SJU, SLU) / PRY(APY)
Chloris castilloniana var. castilloniana	ARG(CAT, CHA, ERI, FOR, JUJ, LRI, MEN, SAL, SDE, SJU, SLU, TUC) / PRY(APY)
Chloris ciliata f. breviseta	ARG(BAI, CAT, CHA, COR, COS, ERI, LPA, LRI, MEN, SAL, SDE, SFE, SLU, TUC) / PRY(APY)
Chloris ciliata f. ciliata	ARG(BAI, CAT, CHA, COR, COS, ERI, FOR, JUJ, LPA, MEN, MIS, SDE, SFE, SLU, TUC) / BRA(RGS) / PRY(APY) / URY(ART, CAS, COL, FLA, MAL, MON, PAY, RNO, ROC, SAO, SOR, TAC)
Chloris ciliata f. reptans	ARG(COS, FOR, JUJ, SAL)
Chloris gayana	ARG(BAI, CAT, CHA, COR, COS, DFE, ERI, FOR, JUJ, LPA, LRI, MEN, MIS, SAL, SDE, SFE, SLU, TUC) / BRA(PAR, RGS) / CHL(IPA) / PRY(APY)
Chloris grandiflora	ARG(BAI, COR, COS, ERI, FOR, SFE, SLU) / BRA(RGS) / URY(ART, CLA, COL, FLO, LAV, PAY, RNO, RIV, SAO, SJO, SOR, TAC)
Chloris halophila var. halophila	ARG(BAI, CAT, CHA, COR, COS, DFE, ERI, JUJ, SAL, SDE, SFE, SLU, TUC)
Chloris halophila var. humilis	ARG(CAT, CHA, COR, FOR, JUJ, LRI, SAL, SDE, SFE, SLU, TUC)
Chloris orthonoton	ARG(COS) / BRA(RGS)
Chloris parodiana	ARG(CHA, COS, FOR) / PRY(CEN, CON, PAI)
Chloris pycnothrix	ARG(CHA, COR, COS, FOR, MIS, SAL, SFE, TUC) / BRA(PAR, RGS, SCA) / PRY(APY, AMA, COA, GUA, PAI)
Chloris radiata	BRA(RGS) / CHL(TAR)
Chloris sesquiflora	ARG(COS, ERI) / PRY(APY)
Chloris truncata	ARG(SFE)
Chloris virgata	ARG(BAI, CAT, CHA, COR, COS, DFE, ERI, JUJ, LPA, LRI, MEN, RNE, SAL, SDE, SFE, SJU, SLU, TUC) / BRA(Fuera del área del proyecto) / CHL(TAR) / PRY(APY)
Chloroleucon chacöense	ARG(JUJ, SAL) / PRY(APY)
Chloroleucon foliolosum	ARG(JUJ, SAL)
Chloroleucon tenuiflorum	ARG(CHA, COS, FOR, JUJ, MIS, SAL, SFE, TUC) / BRA(Fuera del área del proyecto) / PRY(CAA, CEN, CON, COA, PAI, PHA)
Chomelia brasiliana	BRA(RGS, SCA) / PRY(CAU, CAN, CEN, CON, COA, ITA, PAI)
Chomelia obtusa var. obtusa	ARG(COS, MIS) / BRA(PAR, RGS, SCA) / PRY(APY, CAU, CAA, CAN, CEN, CON, COA, ITA, ÑEE, PAI, PHA)
Chomelia obtusa var. pubescens	PRY(AMA)
Chomelia parviflora	BRA(PAR)
Chomelia pedunculosa	BRA(PAR, SCA)
Chomelia pohliana	BRA(Fuera del área del proyecto) / PRY(AMA)
Chondrilla juncea	ARG(BAI)
Chorispora tenella	ARG(CHU, MEN, NEU, RNE, SCR) / CHL(RME)
Chorizanthe commissuralis	ARG(SJU) / CHL(TAR, ANT, ATA, COQ)
Chorizanthe dasyantha	CHL(ATA, COQ, VAL)
Chorizanthe densa	CHL(VAL)
Chorizanthe deserticola	CHL(ANT, ATA)
Chorizanthe flavescens	CHL(COQ)
Chorizanthe frankenioides	CHL(COQ)
Chorizanthe glabrescens	CHL(COQ)
Chorizanthe kingii	CHL(ATA, COQ)
Chorizanthe paniculata	CHL(COQ, VAL, LBO, RME)
Chorizanthe peduncularis	CHL(ATA, COQ)
Chorizanthe vaginata	CHL(COQ, VAL)
Chorizanthe virgata	CHL(LBO, RME)
Chorizanthe viridis	CHL(COQ)
Chresta plantaginifolia	BRA(PAR)
Chresta sphaerocephala	BRA(PAR)
Christianella multiglandulosa	PRY(AMA, SPE)
Chromolaena arnottiana	ARG(CAT, CHA, COR, COS, ERI, FOR, JUJ, LRI, MIS, SAL, SJU, SLU, SFE, SDE, TUC)
Chromolaena caaguazuensis	ARG(MIS) / BRA(RGS) / PRY(AMA, CAU, CAA, CON, COA, GUA, PAI, SPE) / URY(RIV, TAC)
Chromolaena christieana	ARG(CHA, COS, ERI, FOR, JUJ, MIS, SAL, SFE, SDE) / PRY(APY, BOQ, CAA, CEN, CHO, CON, COA, MIE, PAI, PHA, SPE)
Chromolaena connivens	ARG(JUJ, SAL)
Chromolaena elliptica	ARG(COR, ERI, MIS) / BRA(PAR) / PRY(CAU, CAA, CAN, COA, ITA, PAI)
Chromolaena hirsuta	ARG(BAI, CHA, COR, COS, ERI, FOR, MIS, SFE) / BRA(PAR, RGS, SCA) / PRY(AMA, CAU, CAA, CON, COA, GUA, ITA, MIE, ÑEE, PAI, PHA, SPE) / URY(ART, COL, FLO, LAV, MAL, MON, RIV, SJO, SJO, TAC, TYT)
Chromolaena hookeriana	ARG(CAT, COR, JUJ, SAL, TUC)
Chromolaena ivifolia	ARG(BAI, CHA, COS, ERI, FOR, JUJ, MIS, SAL, SFE, TUC) / BRA(PAR, RGS, SCA) / PRY(APA, APY, AMA, CAU, CAA, CAN, CEN, CON, COA, GUA, ITA, PAI, PHA, SPE) / URY(ART, CLA, PAY, RNO, ROC, SAO, SJO, SJO, TAC, TYT)
Chromolaena laevigata var. arenaria	ARG(COS, MIS) / URY(CLA, COL, ROC)
Chromolaena laevigata var. submembranacea	ARG(SAL)
Chromolaena laevigata	ARG(BAI, CHA, COS, ERI, FOR, JUJ, MIS, SAL, SFE, TUC) / BRA(PAR, RGS, SCA) / PRY(APA, AMA, CAU, CAN, CEN, CON, COA, GUA, PAI, PHA, SPE) / URY(CLA, COL, PAY, RIV, SJO, SJO, TAC)
Chromolaena odorata	ARG(CHA, COS, FOR, JUJ, MIS, SAL, TUC) / BRA(PAR) / PRY(APA, AMA, CAU, CAA, CEN, COA, GUA, MIE, PAI, PHA, SPE)
Chromolaena orbignyana	ARG(CHA, COS, FOR) / PRY(APY, AMA, CAA, CEN, CON, COA, GUA, ÑEE, PAI, PHA, SPE)
Chromolaena pedunculosa	ARG(CHA, COS, ERI, FOR, MIS) / BRA(PAR, RGS, SCA) / PRY(CAU, CAN, CEN, COA, GUA, ITA, PAI)
Chromolaena squarroso-ramosa	ARG(BAI, CAT, CHA, COR, COS, ERI, FOR, JUJ, LRI, SAL, SLU, SFE, SDE, TUC) / PRY(APY, BOQ, CEN, CHO, CON, GUA, PAI, PHA, SPE)
Chromolaena squarrulosa	ARG(BAI, COS, ERI, FOR, MIS, SFE) / BRA(PAR, RGS, SCA) / PRY(APA, AMA, CAU, CAN, CON, COA, GUA, MIE, ÑEE, PAI, SPE) / URY(COL, LAV, TAC)
Chromolaena toldensis	ARG(JUJ, SAL)
Chromolaena tunariensis	ARG(JUJ, SAL)
Chromolaena verbenacea	ARG(CHA, COS, FOR, MIS, SFE, SDE) / BRA(PAR, RGS, SCA) / PRY(AMA, CAU, CAN, CON, COA, GUA, MIE, PAI, SPE) / URY(RIV, TAC)
Chrysanthellum indicum ssp. afroamericanum	ARG(CAT, CHA, COR, COS, JUJ, LRI, SAL, SJU, SLU, SFE, SDE, TUC) / BRA(Fuera del área del proyecto)
Chrysanthemoides monilifera	CHL(VAL, RME)
Chrysanthemum coronarium	ARG(BAI, LPA) / CHL(ATA, COQ, VAL, MAU, BIO, JFE) / URY(CAS, MON)
Chrysanthemum segetum	CHL(LLA)
Chrysolaena candelabrum	PRY(CAU)
Chrysolaena cognata	ARG(CHA, COS, ERI, FOR, MIS, SFE) / BRA(PAR, RGS, SCA) / PRY(APA, AMA, CAU, CAN, CEN, CON, COA, GUA, ITA, MIE, PAI, SPE) / URY(COL, RIV, TAC)
Chrysolaena cordifolia	ARG(COS, MIS)
Chrysolaena cristobaliana	BRA(Fuera del área del proyecto) / PRY(AMA, CAN, SPE)
Chrysolaena desertorum	BRA(PAR)
Chrysolaena dusenii	BRA(PAR)
Chrysolaena flexuosa	ARG(BAI, CHA, COR, COS, ERI, FOR, MIS, SDE, SFE) / BRA(PAR, RGS, SCA) / PRY(AMA, CAU, CAN, CEN, CON, COA, GUA, ITA, MIE, PAI, SPE) / URY(ART, CAS, CLA, COL, FLA, LAV, MAL, MON, RIV, ROC, SAO, SJO, TAC)
Chrysolaena guaranitica	PRY(CAU, CAN, CON)
Chrysolaena lithospermifolia	ARG(COS, MIS, SFE) / BRA(PAR, RGS, SCA) / PRY(APA, AMA, CAU, CAA, CAN, CEN, CON, GUA, ITA, MIE, PAI, SPE)
Chrysolaena nicolackii	BRA(PAR)
Chrysolaena obovata	BRA(PAR)
Chrysolaena oligophylla	BRA(PAR, RGS, SCA)
Chrysolaena platensis	ARG(BAI, COS, ERI, FOR, MIS) / BRA(PAR, RGS, SCA) / PRY(AMA, CON, COA, GUA, MIE, PAI, SPE) / URY(MON, RNO, RIV, ROC, SJO, SJO, TAC)
Chrysolaena propinqua var. propinqua	ARG(COS, MIS) / BRA(PAR, RGS, SCA) / PRY(APA, AMA, CAN, GUA, ITA, MIE, PHA, SPE)
Chrysolaena propinqua var. canescens	ARG(MIS) / BRA(PAR, RGS) / PRY(AMA, COA, PAI)
Chrysolaena sceptrum	BRA(Fuera del área del proyecto) / PRY(AMA, CAU, CAN, SPE)
Chrysolaena simplex	BRA(PAR, SCA)
Chrysolaena verbascifolia	ARG(COS, MIS) / BRA(PAR, RGS, SCA) / PRY(APA, AMA, CAU, COA, GUA, PAI)
Chrysophyllum gonocarpum	ARG(CHA, COS, ERI, FOR, JUJ, MIS, SAL, SFE, TUC) / BRA(PAR, RGS, SCA) / PRY(APA, AMA, CAA, CAN, CEN, CON, COA, GUA, ITA, ÑEE, PAI, SPE) / URY(RIV, ROC, TAC, TYT)
Chrysophyllum inornatum	BRA(PAR, RGS, SCA)
Chrysophyllum marginatum ssp. marginatum	ARG(CAT, CHA, COR, COS, ERI, FOR, JUJ, MIS, SAL, SFE, TUC) / BRA(PAR, RGS, SCA) / PRY(APA, AMA, CAU, CAA, CAN, CEN, CON, COA, GUA, ITA, MIE, ÑEE, PAI, SPE) / URY(ART, RNO, SAO)
Chrysophyllum marginatum ssp. tomentosum	BRA(PAR)
Chrysophyllum paranaense	BRA(PAR)
Chrysophyllum viride	BRA(PAR, SCA)
Chrysopogon zizanioides	ARG(CAT, COS, MIS) / PRY(CEN, PAI)
Chrysosplenium macranthum	ARG(TDF) / CHL(MAG)
Chrysosplenium valdivicum	ARG(NEU) / CHL(ARA, LLA)
Chuquiraga acanthophylla	ARG(JUJ)
Chuquiraga atacamensis	ARG(CAT, JUJ, LRI, SAL) / CHL(TAR, ANT, ATA)
Chuquiraga aurea	ARG(CHU, RNE, SCR)
Chuquiraga avellanedae	ARG(CHU, MEN, NEU, RNE, SCR)
Chuquiraga calchaquina	ARG(CAT, JUJ, SAL, TUC)
Chuquiraga echegarayi	ARG(SJU)
Chuquiraga erinacea ssp. hystrix	ARG(CAT, CHU, LPA, LRI, MEN, NEU, RNE, SJU, SLU)
Chuquiraga erinacea ssp. erinacea	ARG(BAI, CAT, CHU, JUJ, LPA, LRI, MEN, NEU, RNE, SAL, SJU, SLU, TUC)
Chuquiraga kuschelii	CHL(TAR)
Chuquiraga longiflora	ARG(CAT, JUJ, LRI, SAL, TUC)
Chuquiraga morenonis	ARG(CHU, SCR)
Chuquiraga oppositifolia	ARG(MEN, NEU, SJU) / CHL(COQ, VAL, LBO, MAU, RME)
Chuquiraga parviflora	ARG(CAT, JUJ, LRI, SAL, SJU, TUC)
Chuquiraga rosulata	ARG(LPA, MEN, NEU, RNE, SJU)
Chuquiraga ruscifolia	ARG(CAT, LRI, MEN, SJU)
Chuquiraga spinosa ssp. australis	ARG(JUJ) / CHL(ANT, ATA)
Chuquiraga spinosa ssp. rotundifolia	CHL(TAR, ANT)
Chuquiraga straminea	ARG(CHU, NEU, RNE, SCR)
Chuquiraga ulicina ssp. ulicina	CHL(TAR, ANT, ATA, COQ)
Chuquiraga ulicina ssp. acicularis	CHL(ATA, COQ, VAL)
Chusquea anelytra	BRA(PAR, SCA)
Chusquea anelytroides	BRA(PAR)
Chusquea bambusoides var. bambusoides	BRA(PAR, RGS, SCA)
Chusquea bambusoides var. minor	BRA(SCA)
Chusquea capitata	BRA(PAR, SCA)
Chusquea capituliflora var. pubescens	BRA(RGS, SCA)
Chusquea capituliflora var. capituliflora	BRA(PAR, RGS, SCA)
Chusquea ciliata	CHL(VAL, RME)
Chusquea culeou	ARG(CHU, NEU, RNE) / CHL(COQ, MAU, BIO, ARA, LLA, AIS)
Chusquea cumingii	CHL(COQ, VAL, LBO, MAU, BIO, RME)
Chusquea deficiens	ARG(JUJ, SAL)
Chusquea egluma	ARG(SAL)
Chusquea fernandeziana	CHL(VAL, JFE)
Chusquea floribunda	ARG(SAL)
Chusquea gracilis	BRA(RGS, SCA)
Chusquea ibiramae	BRA(PAR, SCA)
Chusquea juergensii	ARG(MIS) / BRA(PAR, RGS, SCA) / URY(MAL, RIV, TYT)
Chusquea leptophylla	BRA(PAR, RGS, SCA)
Chusquea lorentziana	ARG(CAT, JUJ, SAL, TUC)
Chusquea macrostachya	CHL(LLA, AIS)
Chusquea meyeriana	BRA(PAR, RGS, SCA)
Chusquea mimosa ssp. mimosa	BRA(PAR, RGS, SCA)
Chusquea mimosa ssp. australis	BRA(RGS, SCA)
Chusquea montana f. nigricans	CHL(LLA, AIS)
Chusquea montana f. montana	ARG(NEU, RNE) / CHL(BIO, LLA, AIS)
Chusquea nudiramea	BRA(SCA)
Chusquea oligophylla	BRA(PAR, SCA)
Chusquea oxylepis	BRA(PAR, SCA)
Chusquea pinifolia	BRA(PAR, SCA)
Chusquea quila	CHL(VAL, LBO, MAU, BIO, ARA)
Chusquea ramosissima	ARG(COS, MIS) / BRA(PAR, RGS, SCA) / PRY(APA, CAN, GUA, ITA, ÑEE, PAI) / URY(ART, MAL, RIV, TAC, TYT)
Chusquea sellowii	BRA(PAR, RGS, SCA)
Chusquea tenella	ARG(MIS) / BRA(PAR, RGS, SCA) / URY(CLA, LAV, MAL, RIV, TAC, TYT)
Chusquea uliginosa	CHL(LLA, AIS)
Chusquea urelytra	BRA(PAR, SCA)
Chusquea valdiviensis	ARG(NEU) / CHL(BIO, ARA, LLA)
Chusquea windischii	BRA(SCA)
Cicendia quadrangularis	ARG(BAI, CHU, ERI, NEU) / CHL(ANT, COQ, VAL, LBO, MAU, BIO, ARA, LLA, RME) / URY(ART, COL, FLO, MON, SJO)
Cichorium intybus	ARG(BAI, CHU, COR, DFE, ERI, JUJ, LPA, MEN, NEU, RNE, SAL, SFE, TUC) / BRA(SCA) / CHL(ATA, COQ, VAL, LBO, MAU, BIO, ARA, LLA, MAG, RME, JFE, IPA) / URY(ART, CAS, MON, RNO)
Cienfuegosia affinis	BRA(Fuera del área del proyecto) / PRY(AMA)
Cienfuegosia argentina	ARG(CAT, COR, JUJ, SAL, SDE, SFE, TUC) / PRY(APY, PHA)
Cienfuegosia conciliata	PRY(APY)
Cienfuegosia drummondii	ARG(CHA, COR, COS, ERI, FOR, SAL, SDE, SFE, TUC) / BRA(RGS) / PRY(APY, BOQ, CEN, COA, GUA, ÑEE, PAI, PHA)
Cienfuegosia hasslerana	ARG(COS) / PRY(AMA, CON)
Cienfuegosia hispida	ARG(SAL, SDE, SFE, TUC)
Cienfuegosia integrifolia	PRY(AMA, CAU, CAN)
Cienfuegosia lanceolata	BRA(Fuera del área del proyecto) / PRY(AMA)
Cienfuegosia saraviae	ARG(SAL)
Cienfuegosia schulzii	ARG(FOR)
Cienfuegosia subprostrata	PRY(CAN, SPE)
Cienfuegosia subternata	BRA(Fuera del área del proyecto) / PRY(APY, AMA, CON)
Cienfuegosia sulphurea	ARG(BAI, CHA, COR, COS, ERI, SFE) / BRA(RGS) / PRY(CON, ÑEE) / URY(ART, PAY, RNO, SAO, SOR)
Cienfuegosia ulmifolia	ARG(CHA, COS, ERI, FOR, SFE) / PRY(APY, CON, ÑEE, PHA)
Cinnamodendron axillare	BRA(PAR, SCA)
Cinnamomum amoenum	ARG(MIS) / BRA(PAR, RGS, SCA) / URY(RIV)
Cinnamomum glanduliferum	ARG(BAI, DFE)
Cinnamomum glaziovii	BRA(PAR, RGS, SCA)
Cinnamomum hatschbachii	BRA(PAR, SCA)
Cinnamomum pseudoglaziovii	BRA(PAR, RGS, SCA)
Cinnamomum riedelianum	BRA(PAR, SCA)
Cinnamomum sellowianum	BRA(PAR, RGS, SCA)
Cinnamomum triplinerve	BRA(PAR, SCA) / PRY(CAN, SPE)
Cinnamomum verum	ARG(MIS)
Cipura paludosa ssp. boliviensis	PRY(APY, AMA, CAA, CON, COA, GUA, ÑEE, SPE)
Cirrhaea dependens var. dependens	BRA(PAR, RGS, SCA)
Cirrhaea dependens var. ornata	BRA(SCA)
Cirrhaea loddigesii	BRA(PAR, RGS, SCA)
Cirrhaea longiracemosa	BRA(SCA)
Cirrhaea saccata	BRA(PAR, RGS, SCA)
Cirsium arvense	ARG(SCR, TDF) / CHL(VAL, BIO, ARA, MAG, RME)
Cirsium vulgare	ARG(BAI, CAT, CHU, COR, COS, DFE, ERI, FOR, JUJ, LPA, LRI, MEN, MIS, NEU, RNE, SAL, SCR, SDE, SFE, SJU, SLU, TDF, TUC) / BRA(PAR, RGS, SCA) / CHL(COQ, VAL, LBO, MAU, BIO, ARA, LLA, AIS, MAG, RME, JFE, IPA) / PRY(ÑEE) / URY(CAS, CLA, FLA, MON, PAY, RNO, SJO, SOR)
Cissampelos andromorpha	ARG(COS, MIS) / BRA(PAR, RGS, SCA)
Cissampelos arenicola	ARG(SAL) / PRY(APY, PHA)
Cissampelos glaberrima	BRA(Fuera del área del proyecto) / PRY(APA, AMA, CAU, CAN, CEN, COA, GUA, PAI, SPE)
Cissampelos laxiflora	BRA(Fuera del área del proyecto) / PRY(APY, GUA)
Cissampelos ovalifolia	ARG(MIS) / BRA(PAR, SCA) / PRY(APA, AMA, CAN, CON, SPE)
Cissampelos pareira	ARG(CAT, CHA, COS, FOR, JUJ, MIS, SAL, SDE, SFE, TUC) / BRA(PAR, RGS, SCA) / PRY(APY, AMA, BOQ, CAU, CAA, CEN, CON, COA, GUA, ÑEE, PAI, PHA, SPE) / URY(RNO)
Cissampelos tropaeolifolia	BRA(PAR, RGS) / PRY(APA, CAN, PAI)
Cissarobryon elegans	CHL(VAL, LBO, MAU, BIO, ARA, RME)
Cissus campestris	BRA(Fuera del área del proyecto) / PRY(AMA, CON)
Cissus duarteana	BRA(Fuera del área del proyecto) / PRY(AMA, CON, SPE)
Cissus erosa	BRA(PAR) / PRY(AMA)
Cissus palmata	ARG(BAI, CHA, COS, ERI, FOR, JUJ, MIS, SAL, SFE) / BRA(PAR, RGS) / PRY(APY, BOQ, CEN, CHO, CON, ITA, MIE, ÑEE, PHA, SPE) / URY(CAS, FLA, MON)
Cissus paulliniifolia	BRA(PAR, SCA)
Cissus simsiana	ARG(JUJ, SAL) / BRA(PAR) / PRY(CON)
Cissus spinosa	ARG(FOR) / BRA(PAR) / PRY(APY, CEN, CON, ÑEE, PHA)
Cissus stipulata	BRA(PAR, SCA)
Cissus striata ssp. argentina	ARG(BAI, CAT, COS, ERI, JUJ, MIS, SAL, SFE, TUC) / BRA(PAR, RGS, SCA) / PRY(APA, ITA) / URY(COL, LAV, MAL, MON, ROC, SJO)
Cissus striata ssp. striata	ARG(CHU) / CHL(COQ, VAL, LBO, MAU, BIO, ARA, LLA, MAG, RME)
Cissus subrhomboidea	BRA(Fuera del área del proyecto) / PRY(AMA, CAN)
Cissus sulcicaulis	ARG(COS, MIS) / BRA(PAR, RGS, SCA) / PRY(APA, CAU, CEN, CON, COA, GUA, PAI, SPE)
Cissus tweediana	ARG(CAT, JUJ, SAL, TUC) / PRY(SPE)
Cissus verticillata	ARG(BAI, CAT, CHA, COR, COS, ERI, FOR, JUJ, MIS, SAL, SDE, SFE, TUC) / BRA(PAR, RGS, SCA) / PRY(APA, APY, AMA, BOQ, CAA, CAN, CEN, CHO, CON, COA, GUA, ITA, MIE, ÑEE, NAS, PAI, PHA, SPE) / URY(RIV, SAO)
Cistanthe amarantoides	CHL(TAR, ANT, ATA, COQ)
Cistanthe arancioana	CHL(ANT)
Cistanthe arenaria	ARG(RNE) / CHL(ATA, COQ, VAL, LBO, MAU, BIO, ARA, RME)
Cistanthe cabrerae	ARG(SJU) / CHL(ANT, ATA)
Cistanthe cachinalensis	CHL(ANT, ATA)
Cistanthe calycina	CHL(ANT, ATA, COQ)
Cistanthe celosioides	CHL(TAR, ANT, ATA)
Cistanthe cephalophora	CHL(ANT, ATA)
Cistanthe chrysantha	CHL(ANT)
Cistanthe coquimbensis	CHL(COQ)
Cistanthe cymosa	CHL(ANT, ATA, COQ)
Cistanthe densiflora	ARG(MEN, SAL, SJU) / CHL(TAR, ANT, ATA, COQ)
Cistanthe fenzlii	CHL(LBO, BIO, ARA)
Cistanthe frigida	ARG(MEN, SJU) / CHL(ATA, COQ, VAL, RME)
Cistanthe grandiflora	CHL(COQ, VAL, LBO, MAU, BIO, ARA, RME)
Cistanthe humilis	ARG(SJU) / CHL(COQ)
Cistanthe lamprosperma	CHL(ANT)
Cistanthe laxiflora	CHL(COQ, VAL)
Cistanthe longiscapa	CHL(ANT, ATA, COQ)
Cistanthe minuscula	ARG(CAT, LRI, MEN, SJU) / CHL(TAR, ANT)
Cistanthe picta	ARG(CAT, LRI, MEN, NEU, SAL, SJU) / CHL(ANT, ATA, COQ, VAL, LBO, RME)
Cistanthe salsoloides	ARG(SJU) / CHL(TAR, ANT, ATA, COQ)
Cistanthe stricta	ARG(SJU) / CHL(ATA)
Cistanthe thyrsoidea	CHL(TAR, ATA, COQ)
Citharexylum andinum	ARG(JUJ)
Citharexylum joergensenii	ARG(CAT, SAL, TUC)
Citharexylum montevidense	ARG(BAI, COS, ERI, MIS) / BRA(RGS) / PRY(CAN, MIE, PAI) / URY(MAL, RIV, ROC, SOR, TAC, TYT)
Citharexylum myrianthum	ARG(COS, FOR, MIS) / BRA(PAR, RGS, SCA) / PRY(APA, CAU, CAN, CEN, COA, MIE, SPE)
Citharexylum solanaceum	BRA(PAR, RGS, SCA)
Citronella apogon	ARG(JUJ, SAL)
Citronella engleriana	BRA(PAR, SCA)
Citronella gongonha	ARG(COS, FOR, MIS) / BRA(PAR, RGS, SCA) / PRY(APA, CAU, CAA, CAN, CEN, COA, GUA, ITA, PAI) / URY(ROC, TAC, TYT)
Citronella mucronata	CHL(COQ, VAL, LBO, MAU, BIO, ARA, LLA, RME)
Citronella paniculata	ARG(MIS) / BRA(PAR, RGS, SCA) / PRY(APA, AMA, COA, PAI, SPE) / URY(RIV, TAC)
Citronella toledoi	BRA(PAR)
Citrullus colocynthis	ARG(BAI, COR, SDE) / PRY(APY)
Citrullus lanatus ssp. vulgaris	ARG(CAT, ERI, FOR, JUJ, LPA, MEN, MIS, SAL) / BRA(RGS)
Citrullus lanatus ssp. lanatus	ARG(BAI, COR, LPA, SLU)
Citrus aurantium	ARG(BAI, CHA, COR, COS, FOR, JUJ, MIS, SAL, SFE, TUC) / PRY(APA, AMA, CAU, CAA, CAN, CEN, GUA, PAI)
Cladanthus mixtus	ARG(BAI, COR, DFE, ERI) / BRA(RGS) / CHL(VAL, BIO) / URY(CAS, CLA, COL, CLA, FLO, FLA, MAL, MON, RNO, ROC, SJO, TYT)
Cladium jamaicense	ARG(COS, SAL) / BRA(PAR, RGS, SCA) / PRY(APY) / URY(CAS, MON, ROC)
Clara gracilis	BRA(RGS)
Clara ophiopogonoides	ARG(MIS) / BRA(RGS) / PRY(MIE) / URY(CAS, FLA, RIV, TAC)
Clara stricta	ARG(MIS) / BRA(RGS)
Clarkia amoena	ARG(NEU, RNE)
Clarkia tenella ssp. tenella	ARG(CHU, NEU, RNE) / CHL(COQ, VAL, LBO, MAU, BIO, ARA, LLA, RME)
Clarkia tenella ssp. araucana	CHL(BIO, ARA, LLA)
Clarkia tenella ssp. tenuifolia	CHL(COQ, VAL, RME)
Clarkia tenella ssp. ambigua	CHL(BIO, ARA)
Clavija nutans	BRA(PAR) / PRY(AMA, CAN, CON)
Claytonia perfoliata	ARG(NEU, RNE, TDF)
Cleistes aphylla	BRA(PAR)
Cleistes australis	BRA(RGS)
Cleistes brasiliensis	BRA(PAR)
Cleistes castanoides	BRA(PAR)
Cleistes catharinensis	BRA(SCA)
Cleistes cipoana	BRA(PAR)
Cleistes fragrans	BRA(PAR)
Cleistes gert-hatschbachiana	BRA(PAR)
Cleistes gracilis	BRA(PAR)
Cleistes humidicola	BRA(PAR)
Cleistes itatiaiae	BRA(PAR)
Cleistes libonii	BRA(PAR, SCA)
Cleistes macrantha	BRA(PAR, SCA)
Cleistes magnifica	BRA(PAR, SCA)
Cleistes paranaensis	BRA(PAR, RGS, SCA) / PRY(AMA, CAN)
Cleistes pluriflora	BRA(PAR)
Cleistes quadricallosa	BRA(PAR)
Cleistes ramboi	ARG(MIS) / BRA(PAR, RGS)
Cleistes revoluta	BRA(PAR, SCA)
Cleistes uliginosa	BRA(PAR, SCA)
Cleistes vinosa	BRA(PAR, SCA)
Cleistocactus baumannii	ARG(CAT, CHA, COR, COS, ERI, FOR, JUJ, LRI, SAL, SDE, SFE, TUC) / PRY(APY, COA, GUA, PAI, PHA)
Cleistocactus ferrarii	ARG(JUJ, SAL)
Cleistocactus hyalacanthus	ARG(JUJ, SAL)
Cleistocactus smaragdiflorus	ARG(CAT, JUJ, SAL)
Clematis bonariensis	ARG(BAI, COS, ERI, MIS) / BRA(PAR, RGS, SCA) / CHL(BIO, ARA) / PRY(APA, COA, ITA, MIE, PAI) / URY(RIV, TYT)
Clematis campestris	ARG(MIS) / BRA(PAR, RGS, SCA) / PRY(APA, CAU)
Clematis dioica var. australis	ARG(ERI, MIS) / BRA(PAR, RGS, SCA) / PRY(APA, AMA, CAA, GUA, SPE) / URY(MAL)
Clematis dioica var. brasiliana	ARG(MIS) / BRA(PAR, RGS, SCA) / PRY(APA, AMA, CAU)
Clematis haenkeana	ARG(CAT, JUJ, SAL, TUC)
Clematis montevidensis var. montevidensis	ARG(BAI, CAT, CHA, COR, COS, ERI, FOR, JUJ, LPA, LRI, MEN, MIS, RNE, SAL, SDE, SFE, SJU, SLU, TUC) / BRA(RGS) / CHL(ATA) / PRY(APY, APA, AMA, CAN, CEN, COA, ITA, MIE, ÑEE, PAI, PHA) / URY(FLA, MON, SAO)
Clematis montevidensis var. denticulata	BRA(PAR, SCA)
Cleome aculeata var. aculeata	ARG(CHA, COS, FOR, JUJ, SAL, SFE, SJU, SLU) / BRA(Fuera del área del proyecto) / PRY(CEN, CON, COA, ITA, PAI)
Cleome chilensis	CHL(TAR, ANT, ATA)
Cleome chodatiana	PRY(CAU, SPE)
Cleome crenopetala	BRA(PAR, RGS)
Cleome eosina	BRA(Fuera del área del proyecto) / PRY(APY, AMA, CON, PHA)
Cleome guaranitica	PRY(COA)
Cleome lanceolata var. paraguarensis	BRA(Fuera del área del proyecto) / PRY(AMA, PHA)
Cleome rosea	ARG(COS, MIS) / BRA(PAR, SCA)
Cleome serrata ssp. paludosa	ARG(CHA, COS, FOR, JUJ, SAL, SFE) / BRA(Fuera del área del proyecto) / PRY(APY, BOQ, CON, ÑEE, PHA)
Cleome titubans	ARG(BAI, ERI, SFE) / BRA(RGS) / URY(CLA, MON, ROC, SJO)
Cleome trachycarpa	ARG(BAI, CHA, COS, DFE, ERI, FOR, MIS, SFE) / BRA(PAR, RGS) / PRY(CEN, CON, PHA) / URY(CAS, CLA, COL, FLA, MAL, PAY, RNO, RIV, ROC, SJO, SOR)
Cleome viridiflora	ARG(JUJ, MIS, SAL, TUC) / BRA(PAR, RGS, SCA) / PRY(APA, AMA, GUA, PAI)
Clerodendrum chinense	ARG(SAL, TUC) / PRY(CEN)
Clerodendrum ekmani	ARG(MIS) / BRA(PAR, RGS) / PRY(COA)
Clerodendrum thomsoniae	BRA(PAR) / PRY(CEN)
Clethra scabra var. scabra	ARG(SAL) / BRA(PAR, SCA)
Clethra scabra var. venosa	BRA(PAR, RGS, SCA)
Clethra scabra var. laevigata	BRA(PAR, RGS, SCA)
Clethra uleana	BRA(PAR, RGS, SCA)
Clibadium armanii	BRA(PAR) / PRY(APA, AMA, CAU, CAN, SPE)
Clibadium peruvianum	ARG(JUJ, SAL, TUC)
Clidemia biserrata	ARG(MIS) / BRA(PAR) / PRY(AMA)
Clidemia blepharodes	BRA(PAR, SCA)
Clidemia bullosa	PRY(AMA, CAN)
Clidemia capitellata	BRA(PAR, SCA)
Clidemia hirta	ARG(MIS) / BRA(PAR, RGS, SCA) / PRY(AMA, CAN, COA)
Clidemia urceolata	BRA(PAR, SCA)
Clinanthus humilis	ARG(JUJ, TUC) / CHL(TAR)
Clinopodium bolivianum ssp. tarijense	ARG(JUJ, SAL)
Clinopodium bolivianum ssp. bolivianum	ARG(JUJ, SAL, SLU, TUC)
Clinopodium brownei	ARG(CHA, COS, ERI, MIS) / BRA(RGS) / PRY(PAI) / URY(ART, RIV)
Clinopodium chilense	CHL(COQ, VAL, LBO, MAU, BIO, ARA, RME)
Clinopodium darwinii	ARG(CHU, NEU, RNE, SCR, TDF) / CHL(MAG)
Clinopodium gilliesii	ARG(CAT, COR, JUJ, LRI, MEN, SAL, SJU, TUC) / CHL(TAR, ANT, COQ, VAL, LBO, MAU, BIO, ARA, RME)
Clinopodium multiflorum	CHL(MAU, BIO, ARA, LLA)
Clinopodium odorum	ARG(CAT, COR, JUJ, SAL, SLU, TUC)
Clinopodium vulgare	BRA(PAR, RGS, SCA)
Cliococca selaginoides	ARG(BAI, COR, COS, ERI, LPA, MIS, SDE) / BRA(PAR, RGS, SCA) / CHL(VAL, ARA) / PRY(APY) / URY(MON, ROC)
Clitoria cordobensis	ARG(CAT, COR, ERI, SFE)
Clitoria densiflora	BRA(PAR) / PRY(AMA, CAN)
Clitoria epetiolata var. latiuscula	BRA(PAR) / PRY(AMA)
Clitoria epetiolata var. epetiolata	ARG(COS) / PRY(AMA, CAN, COA)
Clitoria epetiolata var. angustissima	BRA(PAR)
Clitoria falcata	BRA(PAR, RGS, SCA) / PRY(COA, SPE)
Clitoria guianensis	BRA(Fuera del área del proyecto) / PRY(AMA)
Clitoria nana	ARG(COS, MIS) / BRA(RGS, SCA) / URY(RIV, TAC)
Clusia criuva	BRA(PAR, RGS, SCA)
Clusia parviflora	BRA(PAR, SCA)
Cnicothamnus azafran	ARG(JUJ, SAL) / PRY(APY)
Cnicothamnus lorentzii	ARG(CAT, JUJ, SAL, TUC)
Cnidoscolus albomaculatus	ARG(CHA, COS, JUJ, MIS, SAL, TUC) / PRY(APY, AMA, CAA, CEN, CON, COA, PAI, SPE)
Cnidoscolus appendiculatus	ARG(MIS, TUC) / PRY(APY, AMA, CAU, CAA, CON, SPE)
Cnidoscolus campanulatus	PRY(APA, AMA, CAA, CON, COA, SPE)
Cnidoscolus hasslerianus	PRY(CEN, COA, PAI)
Cnidoscolus loasoides	ARG(CHA, COS, MIS) / PRY(ITA)
Cnidoscolus maracayensis	PRY(CAN)
Cnidoscolus pteroneurus	PRY(APY)
Cnidoscolus serrulatus	PRY(AMA, CAN)
Cnidoscolus subinteger	PRY(ITA)
Cnidoscolus tenuifolius	ARG(Desconocida) / PRY(APY)
Cnidoscolus tetracyclus	PRY(AMA)
Cnidoscolus tubulosus var. trilobus	ARG(CAT, COR, FOR, JUJ, LRI, SAL, SJU, TUC) / PRY(AMA, PAI)
Cnidoscolus urens	ARG(COS, JUJ, MIS) / BRA(PAR) / PRY(APY, GUA, PAI)
Cnidoscolus vitifolius var. cnicodendrum	ARG(JUJ, LRI, SAL) / PRY(APY, PAI)
Coccocypselum capitatum	BRA(PAR, RGS, SCA)
Coccocypselum condalia	BRA(PAR, RGS, SCA) / PRY(APA)
Coccocypselum geophiloides	BRA(PAR, RGS, SCA)
Coccocypselum glabrifolium	BRA(PAR)
Coccocypselum hasslerianum	ARG(MIS) / BRA(SCA) / PRY(APA, COA)
Coccocypselum lanceolatum	ARG(MIS, SAL) / BRA(PAR, RGS, SCA) / PRY(APA, AMA, CAA, CAN, COA, GUA, PAI)
Coccocypselum lyman-smithii	BRA(PAR, RGS, SCA)
Coccocypselum monanthos	PRY(AMA)
Coccocypselum pulchellum	ARG(MIS) / BRA(PAR, RGS, SCA)
Coccoloba arborescens	BRA(PAR, SCA)
Coccoloba argentinensis	ARG(CHA, COS, ERI, JUJ, SAL, SFE, TUC) / PRY(APY, PAI) / URY(SAO)
Coccoloba cordata	ARG(CAT, CHA, COS, FOR, JUJ, MIS, SAL, TUC) / BRA(RGS) / PRY(APY, CAN, CEN, CON, ITA, ÑEE, PAI, PHA)
Coccoloba cujabensis	BRA(RGS) / PRY(APY)
Coccoloba glaziovii	BRA(PAR, SCA)
Coccoloba guaranitica	PRY(APY, AMA)
Coccoloba paraguariensis	ARG(CHA, COS, FOR) / PRY(APY, CEN, COA, ITA, PAI, PHA)
Coccoloba spinescens	ARG(FOR, SAL) / PRY(APY, CEN, CON, COA, PAI, PHA)
Coccoloba tiliacea	ARG(JUJ, SAL, TUC)
Coccoloba warmingii	BRA(PAR, SCA)
Cochlearia officinalis	ARG(TDF)
Cochlidium punctatum	BRA(PAR, RGS, SCA)
Cochlidium serrulatum	BRA(PAR, SCA)
Cochlospermum regium	BRA(PAR) / PRY(APY, AMA, CAN, CON, SPE)
Cochlospermum tetraporum	ARG(JUJ, SAL) / PRY(APY)
Codonanthe cordifolia	BRA(SCA)
Codonanthe devosiana	BRA(PAR, RGS, SCA)
Codonanthe gracilis	BRA(PAR, RGS, SCA)
Codonorchis canisoi	BRA(RGS)
Codonorchis lessonii	ARG(CHU, NEU, RNE, SCR, TDF) / CHL(MAU, BIO, ARA, LLA, AIS, MAG)
Coix lacryma-jobi	ARG(COR, MIS) / BRA(PAR, RGS, SCA) / PRY(AMA)
Colanthelia cingulata	BRA(PAR, RGS, SCA)
Colanthelia intermedia	BRA(PAR, RGS, SCA)
Colanthelia lanciflora	BRA(PAR, RGS, SCA)
Colanthelia rhizantha	ARG(MIS) / BRA(RGS, SCA)
Coleataenia prionitis	ARG(BAI, CHA, COS, ERI, FOR, MIS, SFE) / BRA(PAR, RGS) / PRY(APA, CAU, CEN, CON, COA, GUA, ÑEE, PAI, PHA) / URY(ART, FLA, TAC)
Coleostephus myconis	ARG(BAI) / BRA(RGS) / CHL(MAU, ARA) / URY(CAS, CLA, LAV, MAL, MON, SJO)
Colignonia glomerata	ARG(CAT, JUJ, SAL, TUC)
Collaea argentina	ARG(COR, COS, JUJ, MIS, SAL, SLU, TUC)
Collaea aschersoniana	BRA(PAR)
Collaea paraguariensis	ARG(MIS) / PRY(AMA, CAU)
Collaea riparia	BRA(RGS)
Collaea speciosa	BRA(PAR, RGS, SCA)
Collaea stenophylla	ARG(COS, ERI, MIS) / BRA(PAR, RGS, SCA) / PRY(AMA, CAA, CAN, COA, SPE) / URY(CLA, COL, MON, PAY, RIV, SAO, SOR, TAC)
Colletia hystrix	ARG(CHU, NEU, RNE, SCR) / CHL(ATA, COQ, VAL, LBO, MAU, BIO, ARA, LLA, AIS, RME)
Colletia paradoxa	ARG(BAI) / BRA(RGS, SCA) / URY(FLA, MAL, MON, ROC)
Colletia spartioides	CHL(JFE)
Colletia spinosissima	ARG(BAI, CAT, COR, COS, ERI, JUJ, LRI, MEN, SAL, SDE, SJU, SLU, TUC) / URY(COL)
Colletia ulicina	CHL(COQ, VAL, LBO, MAU, RME)
Colliguaja brasiliensis	BRA(PAR, RGS, SCA)
Colliguaja dombeyana	CHL(COQ, LBO, MAU, BIO, RME)
Colliguaja integerrima	ARG(CHU, LRI, MEN, NEU, RNE, SJU, SCR, SDE) / CHL(COQ, VAL, LBO, MAU, AIS, MAG, RME)
Colliguaja odorifera	CHL(ANT, ATA, COQ, VAL, LBO, MAU, RME)
Colliguaja salicifolia	CHL(COQ, VAL, MAU, BIO, RME)
Collomia biflora	ARG(CHU, MEN, NEU, RNE, SCR) / CHL(VAL, LBO, MAU, BIO, ARA, LLA, AIS, MAG, RME)
Collomia grandiflora	ARG(RNE)
Colobanthus lycopodioides	ARG(CHU, MEN, NEU, RNE, SCR, SJU, TDF) / CHL(MAG, RME)
Colobanthus quitensis	ARG(CAT, CHU, JUJ, MEN, NEU, SAL, SJU, SCR, TDF) / CHL(TAR, ANT, ATA, COQ, VAL, MAU, BIO, ARA, LLA, AIS, MAG, RME)
Colobanthus subulatus	ARG(CHU, MEN, NEU, RNE, SCR, SJU, TDF) / CHL(AIS, MAG, RME)
Colocasia esculenta	ARG(COS, MIS, TUC) / PRY(AMA, CEN) / URY(ART, CLA)
Cologania broussonetii	ARG(CAT, COR, JUJ, SAL, SLU, TUC)
Colubrina glandulosa var. reitzii	BRA(PAR, SCA) / PRY(AMA, SPE)
Colubrina retusa var. latifolia	ARG(COS, MIS) / BRA(PAR) / PRY(APA, CAN, ITA, MIE, PAI)
Colutea arborescens	ARG(LPA)
Combera minima	CHL(LLA)
Combera paradoxa	ARG(NEU, RNE) / CHL(BIO, AIS)
Combretum duarteanum	BRA(Fuera del área del proyecto) / PRY(AMA, CAN, CON)
Combretum fruticosum	ARG(BAI, CHA, COS, ERI, FOR, MIS) / BRA(PAR, RGS, SCA) / PRY(APA, AMA, CAU, CAA, CAN, CON, COA, GUA, PAI, PHA, SPE) / URY(RNO, SAO)
Combretum lanceolatum	BRA(Fuera del área del proyecto) / PRY(APY, CON, PHA, SPE)
Combretum laxum	ARG(CHA, COS, FOR, MIS) / BRA(PAR) / PRY(APY, APA, CEN, CON, PAI, SPE)
Combretum leprosum	ARG(FOR) / BRA(Fuera del área del proyecto) / PRY(AMA, CON)
Combretum mellifluum	ARG(MIS) / BRA(Fuera del área del proyecto) / PRY(AMA)
Commelina benghalensis	ARG(MIS)
Commelina diffusa var. gigas	ARG(BAI, CHA, COS, ERI, FOR, JUJ, MIS, SAL, SFE, TUC) / PRY(CEN, COA, PAI)
Commelina diffusa var. diffusa	ARG(BAI, CHA, COS, DFE, ERI, FOR, JUJ, MIS, SAL, SFE, TUC) / BRA(RGS, SCA) / PRY(CON, GUA, ÑEE, PAI) / URY(ART, CLA, RNO, SAO, SOR, TYT)
Commelina erecta f. dielsii	ARG(ERI)
Commelina erecta var. angustifolia f. hamipila	ARG(BAI, CAT, COR, LRI, SAL, SDE, SJU, SLU, TUC)
Commelina erecta f. roseo-purpurea	ARG(CHA, ERI, TUC)
Commelina erecta var. angustifolia	ARG(BAI, CAT, CHA, COR, COS, DFE, ERI, FOR, JUJ, MIS, SAL, SFE, SJU, SLU) / BRA(RGS) / PRY(COA) / URY(MON, PAY)
Commelina erecta var. erecta	ARG(BAI, CAT, CHA, COR, COS, DFE, ERI, FOR, JUJ, MIS, SAL, SDE, SFE, SJU, SLU, TUC) / BRA(PAR, RGS, SCA) / CHL(RME) / PRY(AMA, CAN, CEN, ÑEE, PAI, PHA) / URY(ROC)
Commelina erecta f. candida	ARG(BAI, COS, ERI, MIS, TUC)
Commelina fasciculata ssp. chacoensis	ARG(SAL, TUC)
Commelina obliqua	ARG(COS, JUJ, MIS) / BRA(PAR, RGS, SCA) / PRY(APA, AMA, CAN, COA) / URY(ART)
Commelina platyphylla	ARG(CHA, COS, ERI, FOR, MIS) / BRA(RGS) / PRY(APY, CAU, CEN, CON, COA, ÑEE, PAI, PHA) / URY(ART)
Commelina tuberosa	ARG(CAT, JUJ, SAL, TUC)
Commelina vilavelhensis	BRA(PAR, SCA)
Commiphora leptophloeos	BRA(Fuera del área del proyecto) / PRY(APY)
Comparettia coccinea	BRA(PAR)
Conanthera bifolia	CHL(VAL, LBO, MAU, ARA, RME)
Conanthera campanulata	CHL(TAR, ANT, COQ, VAL, MAU, BIO, ARA, RME)
Conanthera parvula	CHL(VAL, LBO, MAU, BIO, ARA)
Conanthera trimaculata	CHL(VAL, LBO, BIO, RME)
Conanthera urceolata	CHL(ATA)
Conchocarpus gaudichaudianus	BRA(SCA)
Condalia buxifolia	ARG(CAT, COR, JUJ, LPA, LRI, SAL, TUC) / BRA(PAR, SCA) / PRY(APY) / URY(CLA, LAV, MON, RIV, SJO)
Condalia megacarpa	ARG(MEN, NEU)
Condalia microphylla	ARG(BAI, CAT, CHU, COR, JUJ, LPA, LRI, MEN, RNE, SAL, SDE, SJU, SLU, TUC)
Condalia montana	ARG(CAT, COR, LRI)
Condea elegans	ARG(COS, MIS) / BRA(PAR) / PRY(AMA, CAA, CEN, COA, MIE, PAI)
Condea fastigiata	ARG(BAI, COS, DFE, ERI, MIS) / BRA(PAR, RGS, SCA) / PRY(APY, ITA) / URY(CAS, MON, SJO, SJO)
Condea floribunda	ARG(BAI, CHA, COR, COS, ERI, FOR, LRI, MIS, RNE, SAL, SFE, TUC) / BRA(PAR, RGS) / PRY(CAN, CEN, COA, PAI) / URY(FLO, MON)
Condea undulata	ARG(BAI, CHA, COS, ERI, MIS, SFE) / BRA(PAR, RGS, SCA) / PRY(CAU) / URY(CAS, CLA, MON, SJO, TAC)
Condylocarpon isthmicum	ARG(COS, ERI, MIS) / BRA(PAR, RGS, SCA) / PRY(APA, AMA, CAA, CAN) / URY(ART, SAO)
Conium maculatum	ARG(BAI, CHU, COR, ERI, LPA, MEN, NEU, RNE, SAL, SCR, SDE, TDF) / BRA(PAR, RGS) / CHL(COQ, VAL, LBO, MAU, BIO, ARA, LLA, AIS, MAG, RME, JFE) / URY(MON)
Connarus rostratus	BRA(PAR, SCA)
Conobea glechomoides	ARG(COS, ERI, FOR) / BRA(Desconocida) / URY(FLO, PAY, SAO, SOR, TAC)
Conobea scoparioides	BRA(PAR)
Conocarpus erectus	BRA(PAR)
Constantia australis	BRA(SCA)
Constantia rupestris	BRA(SCA)
Convolvulus arvensis	ARG(BAI, CAT, CHA, CHU, COR, ERI, JUJ, LPA, MEN, NEU, RNE, SCR, SFE, SJU, SLU) / CHL(TAR, ANT, ATA, COQ, VAL, LBO, MAU, BIO, ARA, LLA, RME, JFE) / URY(CAS, COL, MON)
Convolvulus bonariensis	ARG(BAI, CAT, COR, COS, ERI, JUJ, LPA, LRI, MEN, MIS, NEU, RNE, SAL, SJU, SLU, TUC) / BRA(PAR, RGS) / CHL(VAL, RME) / PRY(COA) / URY(Desconocida)
Convolvulus chilensis	CHL(ANT, ATA, COQ, VAL, LBO, BIO, RME)
Convolvulus crenatifolius ssp. crenatifolius	ARG(BAI, CAT, CHA, COR, COS, ERI, FOR, JUJ, LRI, MIS, RNE, SAL, SDE, SFE, TUC) / BRA(PAR, RGS) / PRY(APY, CEN, COA, GUA, ÑEE, SPE) / URY(CAS, CLA, COL, FLA, MAL, PAY, RNO, ROC, SJO, SOR, TAC)
Convolvulus crenatifolius ssp. montevidensis	BRA(PAR, RGS) / URY(MON)
Convolvulus demissus	ARG(MEN, NEU) / CHL(COQ, MAU, RME)
Convolvulus ensifolius	BRA(PAR, RGS)
Convolvulus hasslerianus	ARG(COS, MIS) / BRA(PAR, RGS) / PRY(CAU, SPE)
Convolvulus hermanniae ssp. erosus	BRA(RGS) / CHL(RME) / PRY(COA) / URY(MON)
Convolvulus hermanniae ssp. hermanniae	ARG(BAI, CAT, CHA, COR, COS, ERI, JUJ, LRI, MEN, MIS, NEU, RNE, SAL, SFE, SLU, TUC) / CHL(COQ, VAL, MAU, BIO, ARA) / URY(MON, TAC)
Convolvulus laciniatus var. laciniatus	ARG(BAI, CAT, COR, COS, ERI, JUJ, LPA, RNE, SAL, SFE, SJU, SLU, TUC) / BRA(RGS) / CHL(ATA, COQ, VAL) / URY(ART, CAS, FLO, FLA, MAL, MON, RIV, SOR, TAC)
Convolvulus laciniatus var. hirsutus	ARG(BAI, COS, ERI) / CHL(ATA, COQ) / URY(MON, SAO)
Convolvulus lilloi	ARG(COS, MIS) / BRA(Fuera del área del proyecto)
Convolvulus montanus	ARG(BAI, MEN)
Convolvulus ottonis	BRA(PAR, RGS)
Convolvulus schulzei	ARG(CHA, COS)
Conyza andina	CHL(COQ, VAL, RME)
Conyza arabidifolia	CHL(VAL, LBO, RME)
Conyza blakei	ARG(BAI, CHU, COR, COS, ERI, LPA, LRI, MIS, SJU, SLU, SFE) / BRA(RGS, SCA) / PRY(AMA, CAU, CAN) / URY(CAS, CLA, COL, FLO, FLA, MAL, MON, PAY, RNO, RIV, ROC, TAC)
Conyza boelckei	ARG(NEU)
Conyza bonariensis var. angustifolia	ARG(BAI, CAT, CHA, CHU, COR, COS, ERI, FOR, JUJ, LPA, LRI, MEN, MIS, NEU, RNE, SJU, SLU, SCR, SFE, SDE) / BRA(RGS, SCA) / CHL(VAL) / PRY(CEN) / URY(MON)
Conyza bonariensis var. bonariensis	ARG(BAI, CAT, CHA, COR, COS, DFE, ERI, FOR, JUJ, LPA, LRI, MEN, MIS, NEU, RNE, SAL, SJU, SLU, SFE, SDE, TUC) / BRA(PAR, RGS, SCA) / CHL(TAR, ANT, ATA, COQ, VAL, MAU, BIO, ARA, LLA, MAG, RME, JFE, IPA) / PRY(APY, AMA, CAU, CAA, CEN, COA, GUA, PAI, PHA) / URY(ART, CAS, CLA, FLO, FLA, MAL, MON, PAY, RNO, ROC, SAO, SJO, SOR, TAC)
Conyza burkartii	ARG(CAT, COR, LPA, LRI, MEN, SJU, SLU)
Conyza bustillosiana	CHL(VAL, RME)
Conyza catharinensis	ARG(MIS) / BRA(PAR, SCA)
Conyza copiapina	CHL(ATA)
Conyza cordata	ARG(CAT, JUJ, LRI, SAL, TUC)
Conyza coronopifolia	ARG(JUJ)
Conyza depilis	CHL(BIO)
Conyza deserticola	ARG(CAT, JUJ, LRI, SAL, SJU, TUC) / CHL(TAR, ANT)
Conyza foliosa	CHL(ARA)
Conyza gayana	CHL(COQ, VAL, LBO, MAU, BIO, ARA, RME)
Conyza glabrata	CHL(RME)
Conyza glandulitecta	ARG(COS, JUJ, MIS, SAL) / BRA(SCA) / PRY(CAU, GUA)
Conyza laevigata	ARG(BAI, LPA, MEN, RNE, SLU)
Conyza larrainiana	ARG(CHU, MEN, NEU, RNE, SCR) / CHL(LLA, MAG)
Conyza lateralis	CHL(COQ, RME)
Conyza lechleri	ARG(CHU, COR, LPA, LRI, NEU, RNE, SJU, SLU, SCR, TDF) / CHL(LLA, MAG)
Conyza lorentzii	ARG(BAI, CAT, CHA, COR, COS, ERI, LPA, LRI, MEN, SDE, SFE, SLU, TUC) / URY(RNO)
Conyza macrophylla	BRA(PAR, RGS, SCA) / URY(CAS, MAL, MON, PAY, ROC, TAC)
Conyza magnimontana	ARG(RNE, SJU)
Conyza monorchis	ARG(BAI, CHA, COR, COS, ERI, LPA, SFE) / BRA(RGS) / URY(CAS, CLA, COL, FLO, FLA, LAV, MAL, MON, PAY, RNO, SJO, SOR, TAC)
Conyza oligantha	ARG(NEU, SCR)
Conyza pampeana	ARG(BAI, CHA, COR, COS, ERI, LPA, MIS, SFE) / BRA(RGS) / URY(ART, CAS, COL, FLO, FLA, LAV, PAY, SJO, SOR, TAC)
Conyza pencana	CHL(BIO)
Conyza primulifolia	ARG(BAI, CAT, CHA, COR, COS, DFE, ERI, FOR, JUJ, LRI, MEN, MIS, RNE, SAL, SLU, SFE, SDE, TUC) / BRA(PAR, RGS, SCA) / CHL(MAU, ARA, LLA) / PRY(APY, CAU, CAN, COA, ITA, ÑEE, PAI, PHA) / URY(ART, CAS, CLA, FLO, FLA, MAL, MON, PAY, RNO, RIV, ROC, SAO, SJO, SOR, TAC, TYT)
Conyza reitziana	BRA(PAR, SCA)
Conyza retirensis	BRA(SCA)
Conyza saltensis	ARG(LRI, MEN, SAL, SJU)
Conyza serrana	ARG(BAI, COS, JUJ, SAL) / BRA(PAR, RGS) / URY(SJO)
Conyza spiciformis	ARG(CAT, JUJ, SAL, TUC)
Conyza spiculosa	CHL(VAL, MAU, RME)
Conyza stenophylla	CHL(MAU, BIO, ARA, LLA)
Conyza suffruticosa	CHL(RME)
Conyza sumatrensis var. leiotheca	ARG(BAI, CAT, CHU, COR, COS, DFE, ERI, JUJ, LPA, LRI, MEN, MIS, NEU, RNE, SAL, SJU, SLU, SCR, SFE, TUC) / BRA(PAR, RGS, SCA) / CHL(ATA, COQ, VAL, LBO, MAU, BIO, ARA, LLA, RME) / PRY(APA, AMA, CAU, CEN, GUA, ITA, PAI) / URY(ART, CAS, CLA, FLA, MAL, MON, RIV, ROC, SJO, SOR, TAC)
Conyza sumatrensis var. sumatrensis	ARG(BAI, CAT, CHA, COR, COS, ERI, JUJ, LPA, LRI, MEN, MIS, RNE, SAL, SLU, SFE, SDE, TUC) / BRA(RGS, SCA) / PRY(AMA) / URY(MON, SOR)
Conyza tenera	CHL(VAL)
Conyza thermarum	CHL(BIO)
Conyza tunariensis	ARG(CAT, JUJ, LRI, SAL, TUC)
Conyza valdiviana	CHL(LLA)
Copaifera laevis	PRY(AMA)
Copaifera langsdorffii var. langsdorfii	ARG(MIS) / BRA(PAR) / PRY(AMA, CAU, CAA, CAN, CEN, CON, COA, GUA, PAI, SPE)
Copaifera langsdorffii var. glabra	PRY(AMA, PAI)
Copaifera langsdorfii var. laxa	BRA(Fuera del área del proyecto) / PRY(AMA, COA)
Copaifera langsdorfii var. grandifolia	BRA(Fuera del área del proyecto) / PRY(COA)
Copernicia alba	ARG(CHA, COS, FOR, JUJ, SAL, SDE, SFE) / BRA(Fuera del área del proyecto) / PRY(APY, CEN, CON, COA, ÑEE, PAI, PHA)
Copiapoa ahremephiana	CHL(ANT)
Copiapoa boliviana	CHL(ANT)
Copiapoa calderana	CHL(ATA)
Copiapoa cinerascens	CHL(ANT, ATA)
Copiapoa cinerea var. cinerea	CHL(ANT)
Copiapoa cinerea var. gigantea	CHL(ANT)
Copiapoa cinerea var. columna-alba	CHL(ANT, ATA)
Copiapoa coquimbana var. coquimbana	CHL(ATA, COQ)
Copiapoa coquimbana var. fiedleriana	CHL(ATA)
Copiapoa dealbata	CHL(ATA)
Copiapoa decorticans	CHL(ANT)
Copiapoa echinata	CHL(ATA)
Copiapoa echinoides	CHL(ATA)
Copiapoa eremophila	CHL(TAR)
Copiapoa grandiflora	CHL(ANT, ATA)
Copiapoa humilis var. tocopillana	CHL(ANT)
Copiapoa humilis var. esmeraldana	CHL(ANT)
Copiapoa humilis var. humilis	CHL(ANT)
Copiapoa humilis var. taltalensis	CHL(ANT)
Copiapoa humilis var. longispina	CHL(ATA)
Copiapoa humilis var. tenuissima	CHL(ANT)
Copiapoa humilis var. varispinata	CHL(ANT)
Copiapoa hypogaea var. montana	CHL(ANT)
Copiapoa hypogaea var. hypogaea	CHL(ANT, ATA)
Copiapoa krainziana	CHL(ANT)
Copiapoa laui	CHL(ANT, ATA)
Copiapoa longistaminea	CHL(ANT)
Copiapoa marginata var. bridgesii	CHL(ANT, ATA)
Copiapoa marginata var. marginata	CHL(ATA)
Copiapoa megarhiza	CHL(ATA)
Copiapoa rarissima	CHL(ANT)
Copiapoa rupestris	CHL(ANT)
Copiapoa serpentisulcata	CHL(ATA)
Copiapoa solaris	CHL(ANT)
Coprosma oliveri	CHL(JFE)
Coprosma pyrifolia	CHL(JFE)
Corchorus argutus	ARG(CHA, COS, ERI, FOR, MIS, SFE) / BRA(PAR, RGS, SCA) / PRY(APA, AMA, CAU, CAN, CEN, CON, COA, GUA, ITA, PAI, PHA, SPE) / URY(ART)
Corchorus hirtus	ARG(CHA, FOR, JUJ, MIS, SAL, TUC) / BRA(RGS, SCA) / PRY(APY, APA, AMA, CAN, CEN, CON, COA, ÑEE, PHA, SPE)
Cordia alliodora	ARG(JUJ, SAL) / BRA(Fuera del área del proyecto) / PRY(APA, AMA, CON, GUA)
Cordia americana	ARG(CHA, COS, FOR, JUJ, MIS, SAL, SFE) / BRA(PAR, RGS, SCA) / PRY(APA, AMA, CAA, CAN, COA, ÑEE, PAI, PHA) / URY(ART)
Cordia bordasii	PRY(APY)
Cordia decandra	CHL(ATA, COQ)
Cordia ecalyculata	ARG(COS, MIS) / BRA(PAR, RGS) / PRY(APA, APY, CAA, CAN, CEN, COA, GUA, ÑEE, PAI, SPE)
Cordia glabrata	BRA(Fuera del área del proyecto) / PRY(APY, BOQ, CEN, CON, COA, PAI)
Cordia glazioviana	BRA(Fuera del área del proyecto) / PRY(APY)
Cordia magnoliifolia	BRA(PAR, SCA)
Cordia rufescens	BRA(PAR)
Cordia saccelia	ARG(JUJ, SAL, TUC)
Cordia sellowiana	BRA(PAR, SCA) / PRY(AMA)
Cordia silvestris	BRA(PAR, SCA)
Cordia taguahyensis	BRA(PAR)
Cordia trichotoma	ARG(COS, JUJ, MIS, SAL, TUC) / BRA(PAR, RGS, SCA) / PRY(APA, AMA, CAU, CAA, CAN, CEN, CON, COA, GUA, PAI, SPE)
Cordiera concolor	ARG(MIS) / BRA(PAR, RGS, SCA) / PRY(APY, CAN, COA)
Cordiera humilis	PRY(AMA, CAN, SPE)
Cordiera sessilis	BRA(Fuera del área del proyecto) / PRY(AMA, CAN, CON, COA, SPE)
Cordobia argentea	ARG(CAT, CHA, COR, FOR, LRI, SAL, SDE, SJU, SLU, TUC) / PRY(APY)
Cordyline sellowiana	ARG(COS, MIS, SAL) / BRA(PAR, RGS, SCA) / PRY(APA, CAN)
Coreopsis grandiflora	ARG(LPA)
Coreopsis lanceolata	ARG(COR, COS, ERI, LPA, MIS) / BRA(RGS) / URY(SAO)
Coreopsis suaveolens	CHL(TAR)
Coreopsis tinctoria	ARG(COR, LPA, MIS, SJU)
Coriandrum sativum	ARG(BAI, CAT, CHA, CHU, COR, COS, LPA, MIS, SAL, SJU, SCR, SFE) / BRA(RGS, SCA) / CHL(JFE) / PRY(PAI)
Coriaria ruscifolia	ARG(CHU, NEU, RNE) / CHL(MAU, BIO, ARA, LLA, AIS)
Coronilla varia	ARG(BAI, SFE)
Correorchis cylindrostachya	ARG(CHU, NEU, RNE, SCR) / CHL(VAL, MAU, BIO, ARA, LLA, RME)
Corrigiola crassifolia	CHL(COQ)
Corrigiola propinqua	CHL(COQ, VAL, LBO)
Corrigiola squamosa var. latifolia	CHL(COQ, VAL)
Corrigiola squamosa var. squamosa	CHL(COQ, VAL, RME)
Corrigiola squamosa var. poeppigii	CHL(COQ, VAL, LBO, BIO, RME)
Corryocactus brevistylus	CHL(TAR)
Cortaderia araucana	ARG(CHU, NEU, RNE, SCR) / CHL(COQ, VAL, LBO, MAU, BIO, ARA, LLA, AIS, RME)
Cortaderia egmontiana	ARG(CHU, MEN, NEU, RNE, SCR, TDF) / CHL(MAU, BIO, ARA, LLA, AIS, MAG, RME)
Cortaderia hieronymi	ARG(CAT, COR, JUJ, LRI, MEN, SAL, SJU, SLU, SDE, TUC)
Cortaderia selloana ssp. jubata	ARG(CAT, JUJ, LRI, SAL, SJU, TUC) / CHL(TAR, ANT, ATA, COQ)
Cortaderia selloana ssp. selloana	ARG(BAI, CAT, CHA, CHU, COR, COS, ERI, FOR, JUJ, LPA, LRI, MEN, NEU, RNE, SAL, SJU, SLU, SFE, TUC) / BRA(PAR, RGS, SCA) / CHL(TAR, ATA, VAL, LBO, BIO, ARA, LLA, AIS, MAG, RME) / URY(CAS, MAL, MON, RIV, ROC, SJO, SOR)
Cortaderia speciosa	ARG(CAT, COR, JUJ, LRI, MEN, SAL, SJU) / CHL(TAR, ANT, ATA, COQ, VAL, RME)
Cortaderia vaginata	BRA(SCA)
Corymborkis flava	ARG(COS, MIS) / BRA(PAR, RGS, SCA) / PRY(APA, CAA)
Corynabutilon bicolor	ARG(CHU, NEU, RNE, SCR) / CHL(COQ, RME)
Corynabutilon ceratocarpum	CHL(VAL, LBO, RME)
Corynabutilon hirsutum	CHL(BIO, ARA)
Corynabutilon ochsenii	CHL(ARA, LLA)
Corynabutilon salicifolium	CHL(BIO, ARA)
Corynabutilon viride	CHL(LBO, MAU, BIO)
Corynabutilon vitifolium	CHL(VAL, BIO, ARA, LLA)
Corynephorus divaricatus	CHL(BIO)
Corynephorus fasciculatus	ARG(BAI)
Cosmos bipinnatus	ARG(CAT, COR, JUJ, LPA, SAL)
Cosmos peucedanifolius var. tiraquensis	ARG(JUJ, SAL)
Cosmos peucedanifolius var. peucedanifolius	ARG(CAT, JUJ, SAL, TUC)
Cosmos sulphureus	ARG(BAI, COR, COS, LPA, MIS, SDE) / PRY(AMA)
Costus arabicus	ARG(COS, MIS) / BRA(PAR, SCA) / PRY(AMA, CAN, SPE)
Costus scaber	BRA(SCA)
Costus spiralis	BRA(PAR, SCA)
Cotoneaster franchetii	ARG(NEU, RNE)
Cotoneaster glaucophyllus	ARG(COR)
Cotoneaster horizontalis	ARG(COR)
Cotoneaster pannosus	ARG(COR)
Cottea pappophoroides	ARG(CAT, COR, JUJ, LPA, LRI, MEN, SAL, SDE, SJU, SLU, TUC)
Cotula australis	ARG(BAI, CAT, CHA, COR, DFE, ERI, JUJ, LPA, MEN, SAL, SLU, SFE, SDE) / BRA(RGS) / CHL(COQ, VAL, LBO, MAU, BIO, ARA, RME, IDE, JFE, IPA) / URY(CAS, CLA, COL, MON, SJO, SOR, TAC)
Cotula coronopifolia	ARG(BAI, COR, ERI, LPA, MEN, NEU, RNE, SJU) / BRA(RGS) / CHL(ANT, ATA, COQ, VAL, LBO, MAU, BIO, ARA, LLA, RME, IDE, JFE) / URY(CAS, MAL, MON, ROC, SJO)
Cotula mexicana	ARG(CAT, COR, JUJ, LRI, SAL, TUC) / CHL(TAR, ANT, COQ)
Couepia grandiflora	BRA(PAR) / PRY(AMA, CAN, CON)
Couepia uiti	BRA(Fuera del área del proyecto) / PRY(CON)
Coursetia brachyrhachis	ARG(JUJ, SAL, TUC)
Coursetia hassleri	ARG(CAT, COR, JUJ, LRI, SAL, SDE, TUC) / BRA(Fuera del área del proyecto) / PRY(APY, CEN)
Coussapoa microcarpa	BRA(PAR, RGS, SCA)
Coussarea contracta	ARG(MIS) / BRA(PAR, RGS, SCA) / PRY(AMA, CAU, CAA, CAN, COA)
Coussarea platyphylla	ARG(MIS) / BRA(Fuera del área del proyecto) / PRY(AMA, CAN, COA, PAI, SPE)
Coutarea hexandra	ARG(COS, JUJ, MIS, SAL) / BRA(PAR, RGS, SCA) / PRY(APY, APA, AMA, CEN, CON, COA, GUA, MIE, PAI)
Cranichis bradei	BRA(PAR)
Cranichis candida	ARG(JUJ, MIS, SAL) / BRA(PAR, RGS, SCA)
Cranichis castellanosii	ARG(JUJ, SAL)
Cranichis ciliata	ARG(JUJ)
Cranichis hassleri	PRY(AMA)
Craniolaria integrifolia	ARG(CAT, COS, ERI, FOR, JUJ, LRI, MIS, SAL, TUC) / BRA(Fuera del área del proyecto) / PRY(APY, BOQ, CEN, COA, PAI, PHA) / URY(RNO)
Crassula caudiculata	ARG(BAI, ERI) / URY(FLA, SJO)
Crassula closiana	CHL(COQ, VAL, LBO, RME)
Crassula connata var. connata	ARG(BAI, CAT, CHU, COR, JUJ, LRI, NEU, SAL, SCR, TUC) / CHL(TAR, ANT, ATA, COQ, VAL, LBO, BIO, LLA, RME) / URY(CAS, LAV, MAL, SOR)
Crassula connata var. muscoides	CHL(LLA)
Crassula connata var. erectoides	CHL(VAL, MAU, RME)
Crassula decumbens	CHL(VAL)
Crassula drummondii	ARG(BAI, ERI, MIS, SJU) / CHL(MAU, RME) / PRY(PAI) / URY(CAS)
Crassula longipes	ARG(COS, ERI, FOR, SFE) / BRA(RGS) / URY(FLA, PAY)
Crassula minutissima	ARG(SCR)
Crassula moschata	ARG(RNE, SCR, TDF) / CHL(LLA, AIS, MAG)
Crassula peduncularis	ARG(BAI, CAT, CHA, CHU, COR, COS, DFE, ERI, FOR, JUJ, MEN, MIS, NEU, RNE, SCR, SFE, SJU, SLU, TUC) / BRA(RGS) / CHL(COQ, VAL, LBO, BIO, ARA, LLA, AIS, RME) / URY(CAS, COL, FLA, LAV, MON)
Crassula phascoides	ARG(SAL, TUC)
Crassula solieri	CHL(MAU, BIO, RME)
Crassula tillaea	CHL(COQ, VAL, MAU, BIO, RME) / URY(MON)
Crassula venezuelensis	ARG(COR)
Crataegus monogyna	ARG(NEU, RNE)
Crateva tapia	ARG(CHA, COR, COS, FOR, SFE) / BRA(PAR) / PRY(CEN, CON, COA, PAI, PHA)
Cratylia intermedia	ARG(MIS) / BRA(PAR)
Cremolobus chilensis	ARG(JUJ, TUC) / CHL(TAR)
Cremolobus subscandens	ARG(JUJ)
Crenias scaturiginum	BRA(SCA)
Crenias weddelliana	BRA(RGS, SCA)
Crepidomanes pyxidiferum var. australe	ARG(MIS) / BRA(PAR, RGS, SCA)
Crepidomanes pyxidiferum var. pyxidiferum	ARG(SAL)
Crepis capillaris	ARG(BAI, CHA, CHU, COR, MEN, NEU, RNE, SLU, SCR, TDF) / CHL(LBO, MAU, BIO, ARA, LLA, AIS, MAG, RME, JFE, IPA) / URY(CAS)
Crepis foetida	ARG(BAI, LPA)
Crepis pulchra	ARG(COR) / CHL(MAU, BIO)
Crepis setosa	ARG(BAI, COR, DFE, ERI, LPA, RNE, SFE) / BRA(RGS) / CHL(ARA) / URY(COL, SOR)
Crepis vesicaria ssp. taraxacifolia	ARG(BAI) / CHL(BIO, ARA)
Cressa nudicaulis	ARG(CAT, COR, LRI, MEN, SJU, SLU)
Cressa truxillensis	ARG(BAI, CHA, CHU, COR, COS, LPA, LRI, MEN, NEU, RNE, SAL, SCR, SFE, SJU, SLU, TUC) / CHL(TAR, ANT, ATA, COQ, RME) / PRY(APY) / URY(MON)
Crinodendron brasiliense	BRA(SCA)
Crinodendron hookerianum	CHL(ARA, LLA)
Crinodendron patagua	CHL(VAL, LBO, MAU, BIO, RME)
Crinodendron tucumanum	ARG(CAT, JUJ, SAL, TUC)
Crinum americanum	ARG(COS, MIS) / BRA(PAR, SCA) / PRY(CEN, PAI)
Criscia stricta	ARG(BAI, COS, ERI, MIS) / BRA(RGS) / URY(CAS, CLA, FLO, FLA, LAV, MAL, MON, PAY, RNO, RIV, ROC, SAO, SJO, SOR, TAC)
Cristaria adenophora	CHL(ATA)
Cristaria andicola	ARG(CAT, LRI, SAL, SJU) / CHL(ANT, ATA, COQ)
Cristaria argyliifolia	CHL(ATA)
Cristaria aspera var. formosula	CHL(ANT, ATA)
Cristaria aspera var. sadae	CHL(ATA)
Cristaria aspera var. aspera	CHL(ANT, ATA, COQ)
Cristaria calderana	CHL(ATA)
Cristaria cordato-rotundifolia	CHL(ATA)
Cristaria cyanea	CHL(TAR, ATA, COQ)
Cristaria dissecta var. glandulosa	ARG(MEN, SJU) / CHL(ATA, COQ)
Cristaria dissecta var. dissecta	ARG(MEN, NEU, SAL, SJU) / CHL(TAR, ANT, ATA, COQ, VAL, LBO, RME)
Cristaria dissecta var. inconspicua	ARG(SJU) / CHL(COQ)
Cristaria fuentesiana	CHL(ANT, ATA)
Cristaria glaucophylla var. glaucophylla	CHL(ATA, COQ, VAL)
Cristaria glaucophylla var. eriantha	CHL(COQ, VAL, MAU, RME)
Cristaria gracilis	CHL(TAR, ANT, ATA, COQ)
Cristaria integerrima var. lobulata	CHL(ANT, ATA)
Cristaria integerrima var. integerrima	CHL(TAR, ANT, ATA)
Cristaria leucantha	CHL(ANT)
Cristaria molinae	CHL(TAR, ANT, ATA, COQ)
Cristaria multiflora	CHL(ATA, COQ, VAL)
Cristaria ovata	CHL(ANT, ATA)
Cristaria tenuissima	CHL(TAR, ANT)
Cristaria viridiluteola var. viridiluteola	CHL(TAR, ANT, ATA, COQ)
Cristaria viridiluteola var. pinnata	CHL(TAR, ANT, ATA)
Cristobalia bella	ARG(COS, MIS) / BRA(RGS)
Cristobalia hirsutissima	ARG(SAL)
Critonia arachnoidea	ARG(JUJ)
Critonia megaphylla	ARG(CHA, FOR, JUJ, MIS, SAL, TUC) / BRA(RGS) / PRY(APA, AMA, CAU, CAA, CEN, COA, GUA, PAI, SPE)
Crocanthemum brasiliense	ARG(BAI, COR, COS, ERI, MIS, SAL, SJU) / BRA(RGS, SCA) / URY(PAY, SJO)
Crocosmia crocosmiiflora	ARG(BAI, MIS, SAL) / CHL(VAL, ARA, LLA, JFE)
Crotalaria balansae	ARG(COS, JUJ, MIS) / BRA(PAR, RGS, SCA) / PRY(AMA, CAU)
Crotalaria breviflora	BRA(PAR)
Crotalaria chaco-serranensis	ARG(CAT, COR, JUJ, SAL, SDE, TUC)
Crotalaria hilariana	BRA(PAR, RGS, SCA)
Crotalaria incana	ARG(CHA, COR, COS, ERI, FOR, JUJ, MIS, SAL, SDE, SFE, TUC) / BRA(PAR, RGS, SCA) / CHL(ANT) / PRY(APY, BOQ, CAU, CAA, CAN, COA, GUA, PAI, PHA) / URY(SAO)
Crotalaria juncea	BRA(PAR, RGS, SCA) / PRY(APY)
Crotalaria lanceolata	BRA(PAR, RGS, SCA) / PRY(APA)
Crotalaria martiana ssp. mohlenbrockii	ARG(MIS) / BRA(Fuera del área del proyecto) / PRY(AMA, CAU, CON, COA, GUA, PAI)
Crotalaria maypurensis	ARG(COS, JUJ, SAL) / BRA(PAR) / PRY(APY, AMA, CON)
Crotalaria micans	ARG(BAI, CHA, COS, ERI, FOR, JUJ, MIS, SAL, SFE, TUC) / BRA(PAR, RGS, SCA) / PRY(APY, ÑEE, SPE) / URY(COL, SOR)
Crotalaria pallida	BRA(PAR, RGS, SCA)
Crotalaria paulina	BRA(Fuera del área del proyecto)
Crotalaria pilosa	ARG(CHA, FOR) / BRA(Fuera del área del proyecto) / PRY(AMA)
Crotalaria pumila	ARG(CAT, JUJ, SAL, TUC)
Crotalaria retusa	BRA(PAR, SCA)
Crotalaria sagittalis	ARG(JUJ, SAL) / BRA(Fuera del área del proyecto) / PRY(CAU)
Crotalaria spectabilis	ARG(CHA, COS, MIS) / BRA(PAR, RGS, SCA)
Crotalaria stipularia	ARG(CHA, COS, FOR, JUJ, MIS, SAL, TUC) / PRY(CAN, CEN)
Crotalaria tweediana	ARG(COS, MIS) / BRA(PAR, RGS, SCA) / URY(RIV)
Crotalaria vespertilio	ARG(COS, MIS) / BRA(PAR, SCA) / PRY(APA)
Crotalaria virgulata	BRA(RGS)
Crotalaria vitellina	BRA(PAR, SCA)
Croton ackermannianus	BRA(PAR, SCA) / PRY(CAA, PAI)
Croton allemii	BRA(PAR, RGS, SCA) / PRY(CAN)
Croton andinus	ARG(CAT, CHA, COR, FOR, JUJ, SAL, SDE, TUC) / PRY(APY, AMA, CEN, CON, COA, PHA)
Croton antisyphiliticus	BRA(PAR, SCA)
Croton apostolon	ARG(MIS) / BRA(PAR, RGS, SCA)
Croton argenteus	ARG(BAI, CHA, COS, ERI, FOR, JUJ, SAL, SDE, SFE, TUC) / PRY(APY, AMA, BOQ, CAA, CAN, CEN, ITA, ÑEE, PHA)
Croton argentinus	ARG(BAI, COR, SLU) / BRA(RGS) / URY(MON)
Croton argyrophyllus	PRY(APY, CAN)
Croton beetlei	ARG(JUJ, SAL)
Croton berberifolius	PRY(AMA)
Croton bonplandianus	ARG(CAT, CHA, COR, COS, ERI, FOR, JUJ, LRI, MIS, SAL, SDE, SFE, SJU, SLU, TUC) / PRY(APY, BOQ, COA, ÑEE, PHA) / URY(ART)
Croton bresolinii	BRA(SCA)
Croton calonervosus	ARG(MIS) / BRA(PAR, RGS, SCA)
Croton calyciglandulosus	BRA(RGS)
Croton calycireduplicatus	BRA(RGS, SCA)
Croton campestris	BRA(PAR)
Croton catamarcensis	ARG(CAT, COR, SDE)
Croton catharinensis	BRA(SCA)
Croton ceanothifolius	BRA(PAR, RGS, SCA)
Croton celtidifolius	BRA(PAR, RGS, SCA)
Croton chaetophorus	BRA(PAR, SCA)
Croton chamaepitys	URY(LAV, MAL)
Croton chilensis	CHL(ANT)
Croton chloroleucos	BRA(SCA)
Croton chodatii	PRY(CAN)
Croton cinerellus	PRY(Desconocida)
Croton confinis	BRA(SCA)
Croton cooperianus	ARG(MIS) / BRA(PAR, RGS, SCA) / PRY(AMA)
Croton cordobensis	ARG(CAT, COR, SDE, SLU)
Croton cuchillae-nigrae	BRA(RGS) / URY(MON, RIV, TAC)
Croton curiosus	ARG(SAL, TUC)
Croton curuguatyensis	PRY(CAN)
Croton didrichsenii	ARG(COS, MIS) / BRA(PAR, RGS, SCA) / PRY(APY, BOQ, CAN, CEN, COA, PAI)
Croton doctoris	PRY(APY)
Croton doratophylloides	ARG(COS, MIS) / BRA(PAR, RGS, SCA) / PRY(AMA)
Croton dusenii	BRA(SCA)
Croton echinulatus	ARG(COS, ERI) / BRA(RGS) / URY(SAO)
Croton emporiorum	ARG(SAL)
Croton ericoideus	BRA(RGS)
Croton erythroxyloides	BRA(SCA)
Croton eskuchei	ARG(COS) / PRY(CEN, ÑEE)
Croton flavispicatus	ARG(COS, MIS) / BRA(PAR, RGS, SCA) / PRY(AMA, CAU, CAA, CAN, SPE)
Croton floribundus	BRA(PAR) / PRY(AMA, CAN)
Croton glandulosus	ARG(COS, ERI, MIS, SAL, SJU) / BRA(PAR, RGS, SCA) / PRY(APA, AMA, CAA, CAN, CEN, CON, COA, GUA, ITA, PAI) / URY(SAO)
Croton glechomifolius	ARG(MIS) / BRA(PAR, RGS, SCA) / PRY(AMA, CAU)
Croton gnaphalii	ARG(COS, ERI) / BRA(RGS) / URY(COL, SJO)
Croton goyazensis	BRA(Fuera del área del proyecto) / PRY(CAN)
Croton gracilipes	BRA(PAR) / PRY(APY, BOQ, CEN, CON, COA, ÑEE, PAI, PHA)
Croton grandivelus	BRA(PAR) / PRY(AMA, CAN, COA)
Croton helichrysum	BRA(RGS)
Croton heterodoxus	BRA(PAR, RGS, SCA)
Croton heteroneurus	BRA(RGS) / URY(MON)
Croton hieronymi	ARG(CAT, FOR, JUJ, SAL, SDE, SFE, TUC) / PRY(APY, PHA)
Croton hilarii	URY(LAV, ROC, TYT)
Croton hirtus	ARG(CAT, COR, COS, FOR, JUJ, LRI, MIS, SAL, SFE, SDE, TUC) / BRA(PAR, RGS, SCA) / PRY(APY, AMA, CAU, CAA, CAN, PAI, SPE)
Croton holodiscus	BRA(RGS) / PRY(CAU)
Croton ichthygaster	BRA(PAR, SCA)
Croton integrilobus	PRY(APY)
Croton isabellei	BRA(RGS)
Croton julopsidium	BRA(RGS)
Croton kleinii	BRA(SCA)
Croton lachnostachyus	ARG(CAT, CHA, COR, COS, ERI, FOR, JUJ, LRI, MIS, SAL, SDE, SFE, SLU, TUC) / PRY(APY, CEN, COA, PHA, SPE)
Croton lachnostephanus	URY(MAL)
Croton lanatus var. tatacuensis	ARG(COS)
Croton lanatus var. lorentzii	ARG(CAT, COR, LRI)
Croton lanatus var. lanatus	BRA(PAR, RGS, SCA) / URY(LAV, MAL, MON)
Croton lanatus var. astrogynus	ARG(COS, MIS) / BRA(PAR, RGS, SCA) / PRY(CAA, COA, PAI)
Croton lanatus var. ruderalis	ARG(ERI)
Croton landoltii	ARG(COS, MIS)
Croton laureltyanus	ARG(COS, ERI)
Croton leptophyllus	BRA(PAR)
Croton linearifolius	BRA(PAR, SCA)
Croton lombardianus	URY(CAS, MON)
Croton lundianus	ARG(COS) / BRA(PAR, RGS, SCA)
Croton macrobothrys	BRA(PAR, SCA)
Croton malacotrichus	
Croton malvoides	ARG(SAL) / BRA(PAR, RGS) / PRY(PHA) / URY(Desconocida)
Croton microcarpus	PRY(CEN)
Croton missionum	ARG(COS, MIS) / BRA(RGS) / PRY(CAU, GUA)
Croton montevidensis	BRA(RGS) / URY(FLA, LAV, MAL)
Croton muellerianus	BRA(PAR)
Croton myrianthus	BRA(PAR, RGS, SCA)
Croton nitrariifolius	BRA(RGS) / URY(LAV, MAL, MON, RIV, TAC, TYT)
Croton occidentalis	PRY(CAN, CEN, COA, PAI)
Croton odontadenius	PRY(APA)
Croton orbignyanus	ARG(CAT, COR) / PRY(APY)
Croton paraguayensis	PRY(AMA, COA, GUA, PAI)
Croton parvifolius	ARG(BAI, CHA, COR, ERI, LPA, SLU, SFE, SDE) / BRA(RGS) / URY(ROC, TYT)
Croton patrum	BRA(SCA)
Croton pedersenii	BRA(Fuera del área del proyecto) / PRY(CAU)
Croton perviscosus	PRY(AMA)
Croton phyllanthus	BRA(RGS) / PRY(CAN, SPE)
Croton piluliferus	ARG(JUJ, SAL)
Croton polygonoides	BRA(PAR)
Croton pycnocephalus	BRA(RGS) / URY(MAL, MON)
Croton pygmaeus	BRA(RGS)
Croton pyrosoma	BRA(PAR, RGS, SCA) / PRY(AMA) / URY(Desconocida)
Croton quintasii	BRA(RGS)
Croton ramboi	BRA(RGS)
Croton ramellae	PRY(APA, AMA)
Croton reitzii	ARG(MIS) / BRA(PAR, RGS, SCA)
Croton robustior	ARG(MIS) / BRA(SCA) / PRY(CEN) / URY(Desconocida)
Croton rupestris	ARG(MIS) / PRY(AMA, CAA, CAN, CON, COA, PAI)
Croton rutilus	BRA(RGS) / PRY(CAA, CAN)
Croton saltensis	ARG(JUJ, SAL, TUC)
Croton santolinus	ARG(COS)
Croton senescens	PRY(CAU, COA)
Croton serpyllifolius	BRA(PAR, SCA)
Croton serratifolius	ARG(COR, COS, MIS) / BRA(PAR, RGS, SCA) / PRY(APY, AMA, CAU, CAN, COA, GUA, PAI, SPE)
Croton serratus	BRA(SCA)
Croton setiger	CHL(MAU, RME)
Croton spissirameus	ARG(MIS) / BRA(PAR, RGS, SCA) / PRY(AMA)
Croton splendidus	BRA(PAR, RGS, SCA)
Croton stenotrichus	BRA(RGS, SCA)
Croton subcinerellus	PRY(AMA, CAN, CEN, PAI)
Croton subpannosus	ARG(CHA, COR, COS, ERI, FOR, MIS, SAL, SFE, TUC) / BRA(PAR, RGS) / PRY(COA, ÑEE) / URY(DUR)
Croton thellungianus	URY(Desconocida)
Croton thymelinus	BRA(RGS)
Croton tricolor	BRA(PAR)
Croton triqueter	ARG(COS, MIS) / BRA(PAR, RGS, SCA) / PRY(CAU, PAI, SPE)
Croton urucurana	ARG(CHA, COS, ERI, FOR, MIS, SFE) / BRA(PAR, RGS, SCA) / PRY(APA, AMA, CAA, CAN, CEN, CON, COA, GUA, ITA, ÑEE, PAI) / URY(PAY, SAO)
Croton uruguayensis	ARG(COS, ERI, MIS) / BRA(RGS, SCA) / PRY(APA) / URY(FLO, PAY, ROC, SAO, SOR, TYT)
Croton venturii	ARG(CAT, COR, LRI, SAL, SDE, TUC) / PRY(APY, AMA, PHA)
Croton verbascoides	ARG(MIS) / BRA(PAR, RGS, SCA) / PRY(AMA, CAA, CAN, SPE)
Croton villosissimus	ARG(TUC) / BRA(PAR, RGS) / PRY(CAN, ÑEE) / URY(Desconocida)
Croton viridulus	BRA(PAR, RGS, SCA)
Croton vulnerarius	BRA(PAR)
Croton yacaensis	PRY(COA)
Croton yerbalium	PRY(SPE)
Cruckshanksia hymenodon	ARG(SJU) / CHL(ANT, ATA, COQ, VAL, RME)
Cruckshanksia lithiophila	CHL(ATA)
Cruckshanksia macrantha	ARG(LRI, SJU) / CHL(ATA, COQ)
Cruckshanksia montiana	CHL(ATA, COQ)
Cruckshanksia palmae	ARG(SJU) / CHL(COQ, VAL, RME)
Cruckshanksia pumila	CHL(ANT, ATA, COQ)
Cruckshanksia verticillata	CHL(ANT, ATA, COQ)
Crumenaria erecta	BRA(PAR) / PRY(AMA, CAN, COA)
Crumenaria lilloi	ARG(COS, MIS) / BRA(PAR) / PRY(APA, AMA, CAU, CAA, CAN, CON, GUA, ITA, SPE)
Cryptantha albida	ARG(CAT, JUJ, LRI, MEN, SAL)
Cryptantha alfalfalis	CHL(LBO, RME)
Cryptantha alyssoides	CHL(VAL, LBO, MAU, RME)
Cryptantha aprica	CHL(ATA, COQ, VAL, LBO, RME)
Cryptantha argentea	CHL(ANT, ATA)
Cryptantha aspera	CHL(ATA, COQ)
Cryptantha calycina	CHL(ANT, ATA, COQ)
Cryptantha calycotricha	CHL(COQ, VAL)
Cryptantha capituliflora	ARG(MEN, SJU) / CHL(COQ, VAL, RME)
Cryptantha chaetocalyx	CHL(ANT, ATA)
Cryptantha chispae	CHL(COQ)
Cryptantha circumscissa	ARG(MEN, NEU)
Cryptantha clandestina	CHL(ANT, COQ, VAL, LBO, MAU, RME)
Cryptantha cynoglossoides	ARG(MEN, SJU) / CHL(COQ)
Cryptantha dichita	CHL(ATA)
Cryptantha diffusa	ARG(CAT, JUJ, LRI, MEN, NEU, RNE, SAL, SJU) / CHL(TAR, ANT, ATA, COQ)
Cryptantha dimorpha	CHL(ATA, COQ, VAL, RME)
Cryptantha diplotricha	ARG(CAT, JUJ, LPA, LRI, MEN, SAL, SJU) / CHL(TAR)
Cryptantha dolichophylla	CHL(COQ)
Cryptantha filaginea	CHL(ANT, ATA, COQ)
Cryptantha filiformis	CHL(TAR, ANT)
Cryptantha gayi	CHL(ATA, COQ)
Cryptantha globulifera	ARG(CHU, LPA, MEN, NEU, RNE) / CHL(TAR, ATA, COQ, VAL, RME)
Cryptantha glomerata ssp. quadrinuculata	CHL(COQ, VAL)
Cryptantha glomerata ssp. glomerata	CHL(TAR, ANT, COQ, VAL, LBO, BIO, RME)
Cryptantha glomerulifera	ARG(MEN, SJU) / CHL(TAR, COQ, VAL, RME)
Cryptantha gnaphalioides	CHL(ANT, ATA, COQ)
Cryptantha haplostachya	CHL(ATA)
Cryptantha hispida	CHL(ANT, ATA)
Cryptantha involucrata	CHL(ATA, COQ, RME)
Cryptantha kingii	CHL(ATA, COQ)
Cryptantha latefissa	ARG(SJU)
Cryptantha limensis	CHL(ANT)
Cryptantha linearis	CHL(ANT, COQ, VAL, LBO, MAU, RME)
Cryptantha longifolia	CHL(COQ)
Cryptantha marioricardiana	CHL(ATA)
Cryptantha maritima var. pilosa	ARG(MEN, SJU)
Cryptantha marticorenae	CHL(ATA, COQ)
Cryptantha mendocina	ARG(LPA, MEN, SLU)
Cryptantha papillosa	ARG(NEU)
Cryptantha patagonica	ARG(CHU, MEN, NEU, RNE, SCR, SJU)
Cryptantha phaceloides	CHL(ATA)
Cryptantha romanii	CHL(ANT, ATA)
Cryptantha spathulata	CHL(LBO)
Cryptantha subamplexicaulis	CHL(ANT)
Cryptantha taltalensis	CHL(ANT, ATA, COQ)
Cryptantha volckmannii	CHL(COQ)
Cryptantha werdermanniana	CHL(ANT)
Cryptocarya alba	CHL(COQ, VAL, LBO, MAU, BIO, ARA, RME)
Cryptocarya aschersoniana	ARG(MIS) / BRA(PAR, RGS, SCA)
Cryptocarya moschata	BRA(PAR, RGS, SCA)
Cryptogramma fumariifolia	ARG(NEU, RNE) / CHL(COQ, VAL, LBO, MAU, BIO, RME)
Cryptophoranthus cryptanthus	BRA(PAR, RGS)
Cryptophoranthus fenestratus var. -	BRA(PAR, RGS, SCA)
Ctenanthe casupoides var. subtropicalis	ARG(MIS)
Ctenanthe lanceolata	BRA(PAR, SCA)
Ctenanthe marantifolia	BRA(PAR, SCA)
Ctenanthe muelleri	BRA(RGS, SCA)
Ctenitis abyssi	BRA(RGS)
Ctenitis ampla	ARG(JUJ, SAL)
Ctenitis anniesii	BRA(PAR, RGS, SCA)
Ctenitis aspidioides	BRA(PAR)
Ctenitis bigarellae	BRA(PAR)
Ctenitis deflexa	BRA(SCA)
Ctenitis distans	BRA(PAR, RGS, SCA)
Ctenitis eriocaulis	BRA(PAR) / PRY(CAA, CAN)
Ctenitis falciculata	BRA(PAR, SCA) / PRY(CAN)
Ctenitis fenestralis	BRA(PAR, RGS, SCA)
Ctenitis laetevirens	BRA(SCA)
Ctenitis paranaensis	BRA(PAR, RGS, SCA)
Ctenitis pedicellata	BRA(PAR, SCA)
Ctenitis submarginalis	ARG(BAI, CHA, COS, ERI, FOR, JUJ, MIS, SAL, SFE, TUC) / BRA(PAR, RGS) / PRY(APA, CAA, CAN) / URY(ART, CLA, ROC, SJO, SOR, TAC, TYT)
Ctenium brachystachyum	BRA(PAR) / PRY(AMA, CAN)
Ctenium brevispicatum	BRA(PAR)
Ctenium cirrosum	BRA(PAR)
Ctenium polystachyum	BRA(PAR) / PRY(AMA, CAN)
Cuatrecasasiella argentina	ARG(JUJ, LRI) / CHL(TAR, ANT)
Cucumis anguria	ARG(BAI, CHA, COS, ERI, FOR, JUJ, LPA, MEN, SAL, SJU, SLU) / BRA(SCA) / PRY(APY)
Cucumis melo var. dudaim	ARG(ERI, SDE)
Cucurbita maxima ssp. andreana	ARG(BAI, COR, ERI, LRI, MEN, SDE, SLU) / URY(SOR)
Cucurbita maxima ssp. maxima	ARG(COR, ERI, JUJ, MEN)
Cucurbita moschata	ARG(BAI, COR, FOR)
Cucurbita pepo	ARG(COR, ERI, SFE) / BRA(PAR)
Cucurbitella asperata	ARG(BAI, CAT, CHA, COR, COS, ERI, FOR, JUJ, LPA, LRI, MEN, MIS, SAL, SJU, SLU, SFE, SDE, TUC) / BRA(Desconocida) / PRY(APY, CEN, CON, PAI, PHA) / URY(MON, SOR)
Cuminia eriantha var. fernandezia	CHL(JFE)
Cuminia eriantha var. eriantha	CHL(JFE)
Cumulopuntia dactylifera	CHL(ANT)
Cumulopuntia pentlandii	ARG(CHA, JUJ)
Cumulopuntia sphaerica	CHL(TAR, ANT, ATA, COQ, VAL)
Cunila angustifolia	ARG(MIS) / BRA(PAR, RGS, SCA)
Cunila fasciculata	BRA(RGS)
Cunila galioides	ARG(Desconocida) / BRA(RGS, SCA) / URY(RIV)
Cunila incana	ARG(COS, MIS) / BRA(PAR, RGS, SCA) / URY(ART, RIV)
Cunila incisa	BRA(RGS, SCA)
Cunila menthiformis	BRA(PAR, RGS) / URY(CLA)
Cunila menthoides	URY(MON)
Cunila microcephala	ARG(COS, ERI, SFE) / BRA(PAR, RGS) / URY(CLA, FLO, FLA, MON, RIV, SOR, TYT)
Cunila platyphylla	BRA(PAR, RGS, SCA)
Cunila spicata	ARG(COS, MIS) / BRA(PAR, RGS, SCA) / PRY(CAU) / URY(ROC, SAO, TYT)
Cunila tenuifolia	BRA(SCA)
Cupania oblongifolia	BRA(PAR, SCA)
Cupania tenuivalvis	BRA(PAR)
Cupania vernalis	ARG(CHA, COR, COS, ERI, FOR, JUJ, MIS, SAL, TUC) / BRA(PAR, RGS, SCA) / PRY(APA, AMA, CAU, CAA, CAN, CEN, COA, GUA, ITA, MIE, ÑEE, PAI, SPE) / URY(ART, CLA, PAY, RNO, RIV, ROC, SAO, SOR, TAC, TYT)
Cuphea acinifolia	BRA(PAR, SCA)
Cuphea aperta	BRA(SCA)
Cuphea bonplandii	ARG(COS, ERI, MIS) / BRA(SCA) / PRY(COA, GUA, MIE, ÑEE, PAI)
Cuphea calophylla ssp. calophylla	BRA(PAR, RGS, SCA) / PRY(CAA, PAI)
Cuphea calophylla ssp. mesostemon	ARG(CAT, CHA, JUJ, MIS, SAL, TUC) / BRA(PAR, RGS, SCA) / PRY(CAU, CAA, CAN, CEN, CON, COA, GUA, ITA, PAI)
Cuphea campylocentra	ARG(COS, ERI, FOR) / BRA(PAR, RGS) / PRY(AMA, CAU, CAA, CON, COA, GUA, MIE, PAI, PHA, SPE) / URY(TYT)
Cuphea carthagenensis	ARG(CHA, COS, FOR, JUJ, MIS) / BRA(PAR, RGS, SCA) / PRY(APA, AMA, CAU, CAA, CAN, CEN, CON, COA, GUA, ITA, MIE, ÑEE, PAI, PHA, SPE) / URY(CLA, RIV, TYT)
Cuphea confertiflora	ARG(MIS) / BRA(PAR, RGS, SCA) / PRY(APA, CAU, CAA, GUA)
Cuphea cordata	ARG(JUJ)
Cuphea corisperma ssp. hexasperma	PRY(APY, CEN, CON, COA, GUA, MIE, PAI)
Cuphea corisperma ssp. corisperma	PRY(APY, CAU, CEN, GUA, MIE, PAI)
Cuphea dusenii	BRA(PAR)
Cuphea flava var. pseudobrachiata	PRY(Desconocida)
Cuphea flava var. flava	BRA(PAR) / PRY(Desconocida)
Cuphea fruticosa	ARG(BAI, COR, COS, ERI, MIS) / BRA(PAR, RGS, SCA) / PRY(CAU, ITA) / URY(COL, MON, PAY, RNO)
Cuphea glaziovii	ARG(MIS) / BRA(PAR, SCA)
Cuphea glutinosa	ARG(BAI, CHA, COR, COS, ERI, FOR, LRI, MIS, SAL, SLU, SFE, TUC) / BRA(PAR, RGS, SCA) / PRY(APA, CAU, CEN, COA, GUA, ITA, MIE, ÑEE, PAI) / URY(CLA, COL, DUR, MAL, MON, PAY, ROC)
Cuphea hatschbachii	BRA(PAR)
Cuphea hirsutissima	ARG(MIS) / BRA(SCA)
Cuphea inaequalifolia	BRA(Fuera del área del proyecto) / PRY(AMA, CAN)
Cuphea ingrata	ARG(BAI, CHA, COR, COS, MIS, SFE, SLU, TUC) / BRA(PAR, RGS, SCA) / PRY(APA, GUA, ITA) / URY(CLA, COL, MAL, MON, PAY, ROC)
Cuphea laeviuscula	ARG(COS, MIS, SFE)
Cuphea linarioides	ARG(COS, MIS) / BRA(PAR, RGS, SCA) / PRY(APA, ITA, PAI)
Cuphea lindmaniana	BRA(PAR, RGS, SCA)
Cuphea linifolia	BRA(PAR, RGS)
Cuphea lysimachioides	ARG(CHA, COS, FOR, MIS) / BRA(PAR, RGS) / PRY(APA, APY, AMA, CAU, CAA, CAN, CEN, CON, COA, GUA, ITA, MIE, ÑEE, PAI, PHA, SPE) / URY(ART, RIV)
Cuphea melvilla	ARG(COS, MIS) / BRA(PAR, RGS, SCA) / PRY(AMA, CAA, CAN, CON, ITA)
Cuphea micrantha	BRA(Fuera del área del proyecto) / PRY(AMA, CON)
Cuphea niederleinii	ARG(MIS) / PRY(ITA)
Cuphea paranensis	BRA(PAR)
Cuphea persistens	ARG(FOR, JUJ, SAL, SDE, TUC) / BRA(Fuera del área del proyecto) / PRY(APY, AMA, BOQ, CON, COA, SPE)
Cuphea polymorpha var. polymorpha	BRA(PAR) / PRY(APA, CAU, CAN, CON, SPE)
Cuphea polymorpha var. vincoides	BRA(Fuera del área del proyecto) / PRY(APA, CAU)
Cuphea pterosperma	ARG(COS) / BRA(PAR) / PRY(AMA, CAU, CAA, CAN, CEN, COA, GUA, MIE, PAI, SPE)
Cuphea punctulata	BRA(Fuera del área del proyecto) / PRY(Desconocida)
Cuphea racemosa ssp. racemosa	ARG(BAI, CHA, CHU, COR, COS, ERI, FOR, JUJ, MIS, RNE, SAL, SFE, TUC) / BRA(PAR, RGS, SCA) / PRY(APA, AMA, CAU, CAA, CAN, CEN, CON, COA, GUA, ITA, MIE, ÑEE, PAI, PHA, SPE) / URY(ART, CAS, CLA, COL, DUR, FLO, FLA, LAV, MAL, MON, PAY, RNO, RIV, ROC, SAO, SJO, SOR, TAC, TYT)
Cuphea racemosa ssp. longiflora	ARG(COS, ERI, MIS) / BRA(Fuera del área del proyecto) / PRY(APA, CAA, CEN, COA, ITA, PAI)
Cuphea racemosa var. ramosior	ARG(CHA, COS, MIS) / BRA(PAR) / PRY(APA, CAU, CAA, COA, GUA, ITA, MIE, PAI, SPE)
Cuphea racemosa var. palustris	ARG(BAI, CHA, COR, COS, ERI, FOR, MIS, SCR, SFE) / BRA(PAR) / PRY(APA, CAU, CAA, CAN, CEN, COA, GUA, ITA, MIE, ÑEE, PAI, SPE) / URY(CLA, FLA, MON, PAY, RIV, SAO, SJO)
Cuphea reitzii	BRA(SCA)
Cuphea rusbyi	PRY(APY, CON)
Cuphea sessiliflora	ARG(CHA, COS, FOR) / BRA(Fuera del área del proyecto) / PRY(APY, AMA, BOQ, CEN, CON, COA, PHA, SPE)
Cuphea sessilifolia	BRA(Fuera del área del proyecto) / PRY(CAN)
Cuphea stenopetala	PRY(APA, CAU, CAA, CAN, GUA, SPE)
Cuphea strigulosa	BRA(Fuera del área del proyecto) / PRY(AMA, CON)
Cuphea thymoides var. saturejoides	BRA(PAR, RGS, SCA) / PRY(MIE, PAI)
Cuphea thymoides var. thymoides	ARG(COS, MIS) / BRA(PAR, RGS, SCA)
Cuphea tuberosa	ARG(COS, MIS) / BRA(PAR, RGS, SCA) / PRY(CAA, GUA, MIE) / URY(MON, RIV, TAC, TYT)
Cuphea urbaniana var. uleana	BRA(PAR, RGS, SCA)
Cuphea urbaniana var. urbaniana	BRA(PAR, RGS, SCA)
Cuphea varia	BRA(PAR, RGS, SCA) / URY(RIV, TAC)
Cupressus arizonica	ARG(COR)
Cupressus macrocarpa	ARG(COR)
Curatella americana	BRA(Fuera del área del proyecto) / PRY(AMA, CON)
Curitiba prismatica	BRA(PAR, SCA)
Curtia conferta	BRA(PAR, RGS, SCA)
Curtia tenuifolia	ARG(COS) / BRA(PAR, RGS, SCA) / PRY(AMA, CAU, CAN) / URY(CAS)
Cuscuta alataloba	ARG(CAT, COR, SAL, TUC)
Cuscuta americana	ARG(JUJ) / BRA(Fuera del área del proyecto)
Cuscuta andina	ARG(MEN) / CHL(MAU)
Cuscuta argentinana var. parviflora	ARG(TUC)
Cuscuta argentinana var. argentinana	ARG(CAT, SAL, TUC)
Cuscuta boliviana var. boliviana	ARG(CAT, COR, JUJ, LRI, MEN, SAL, SJU, SLU)
Cuscuta boliviana var. paranensis	ARG(MIS) / BRA(PAR)
Cuscuta campestris	ARG(BAI, CHA, CHU, COR, DFE, ERI, JUJ, MEN, NEU, RNE, SAL, SCR) / CHL(TAR, LBO, MAU, BIO, ARA, RME) / URY(CAS)
Cuscuta chilensis	ARG(MEN, NEU) / CHL(TAR, ANT, ATA, COQ, VAL, LBO, MAU, BIO, ARA, LLA, RME)
Cuscuta cristata var. chacoensis	ARG(CHA, SFE)
Cuscuta cristata var. cristata	ARG(BAI, CAT, CHA, COR, COS, DFE, ERI, LRI, SDE) / URY(COL)
Cuscuta epilinum	ARG(BAI)
Cuscuta epithymum var. macranthera	ARG(BAI)
Cuscuta epithymum var. angustissima	ARG(BAI) / CHL(ARA, RME)
Cuscuta epithymum var. epithymum	ARG(BAI, COR, DFE)
Cuscuta flossdorfii var. flossdorfii	ARG(COR, LRI, TUC)
Cuscuta flossdorfii var. pampagrandensis	ARG(SAL)
Cuscuta flossdorfii var. tucumanensis	ARG(TUC)
Cuscuta flossdorfii var. microstyla	ARG(LRI)
Cuscuta friesii	ARG(JUJ)
Cuscuta globiflora	ARG(CAT, JUJ, SAL, TUC)
Cuscuta grandiflora	ARG(CAT, JUJ, SAL, TUC)
Cuscuta incurvata	PRY(AMA, CON)
Cuscuta indecora var. indecora	ARG(BAI, COR, ERI, LPA, NEU, RNE, SAL, SDE) / BRA(PAR) / PRY(APY)
Cuscuta indecora var. longisepala	ARG(BAI, CAT, COR, COS, DFE, ERI, FOR, JUJ, LPA, LRI, MEN, MIS, RNE, SAL, SDE, SFE, SJU, SLU, TUC) / PRY(GUA)
Cuscuta insquamata var. argentina	ARG(SAL)
Cuscuta longiloba	PRY(APY)
Cuscuta membranacea	ARG(CAT, CHA, COR, LRI, SAL, TUC)
Cuscuta micrantha var. holwayi	CHL(MAU)
Cuscuta micrantha var. latiflora	CHL(ATA)
Cuscuta micrantha var. micrantha	CHL(ATA, COQ, VAL, BIO, RME)
Cuscuta microstyla var. microstyla	CHL(BIO, RME)
Cuscuta microstyla var. bicolor	ARG(MEN) / CHL(RME)
Cuscuta obtusiflora	ARG(BAI, COR, COS, ERI, MEN, MIS, SFE, TUC) / BRA(SCA) / PRY(CEN)
Cuscuta odorata	CHL(ANT, ATA, COQ)
Cuscuta parodiana var. parodiana	ARG(JUJ, SAL, TUC)
Cuscuta parodiana var. tucumana	ARG(TUC)
Cuscuta partita	BRA(PAR)
Cuscuta pauciflora	ARG(RNE, SJU, SCR) / CHL(MAU, LLA)
Cuscuta platyloba var. pampeana	ARG(BAI, COR)
Cuscuta platyloba var. platyloba	ARG(BAI, COS, ERI, FOR, MIS, SFE) / BRA(SCA) / URY(CAS, CLA, COL, MON, RIV, ROC, SJO)
Cuscuta purpurata	CHL(ANT, ATA, COQ)
Cuscuta pusilla	CHL(LLA)
Cuscuta racemosa var. nuda	BRA(PAR, SCA)
Cuscuta racemosa	BRA(SCA)
Cuscuta rojasii	PRY(APY)
Cuscuta rotundiflora	ARG(JUJ, SAL)
Cuscuta rustica	CHL(COQ)
Cuscuta suaveolens	ARG(BAI, MEN, SJU) / CHL(TAR, ATA, COQ, VAL, LBO, MAU, BIO, ARA, LLA, RME) / URY(DUR, SAO, SJO)
Cuscuta werdermannii	CHL(COQ)
Cuscuta xanthochortos var. lanceolata	ARG(BAI, MIS) / PRY(APA)
Cuscuta xanthochortos var. carinata	BRA(SCA) / PRY(CEN, COA) / URY(Desconocida)
Cuscuta xanthochortos var. longibracteata	ARG(FOR)
Cuscuta xanthochortos var. xanthochortos	ARG(COS, ERI, MIS) / BRA(RGS) / PRY(GUA)
Cuscuta yunckeriana	ARG(RNE)
Cuspidaria convoluta	ARG(COS, FOR, MIS) / BRA(PAR, RGS, SCA) / PRY(APA, AMA, CAU, CAA, CAN, CEN, GUA, ITA, MIE, PAI, SPE)
Cuspidaria lateriflora	BRA(Fuera del área del proyecto) / PRY(AMA)
Cuspidaria pulchella	BRA(PAR) / PRY(APA, CAN)
Cuspidaria sceptrum	BRA(PAR)
Cyanaeorchis arundinae	ARG(BAI, CHA, COS, ERI) / BRA(PAR, RGS, SCA) / PRY(CAU, CAN, MIE)
Cyanaeorchis minor	BRA(PAR, RGS)
Cyanocephalus apertiflorus	BRA(PAR)
Cyanocephalus poliodes	PRY(COA)
Cyanocephalus tripartitus	PRY(CAU)
Cyathea atrovirens	ARG(COS, MIS) / BRA(PAR, RGS, SCA) / PRY(APA, AMA, CAU, CAA, CAN, CEN, COA, GUA, ITA, PAI, SPE) / URY(RIV, TAC)
Cyathea axillaris	BRA(PAR, SCA)
Cyathea corcovadensis	BRA(PAR, SCA)
Cyathea delgadii	ARG(COS) / BRA(PAR, RGS, SCA) / PRY(COA, ITA, PAI, SPE)
Cyathea dichromatolepis	BRA(PAR, SCA)
Cyathea feeana	BRA(PAR, SCA)
Cyathea hirsuta	BRA(PAR)
Cyathea phalerata	BRA(PAR, RGS, SCA)
Cyathea poeppigii	BRA(RGS, SCA) / PRY(COA)
Cyathea villosa	BRA(PAR, SCA)
Cybianthus brasiliensis	BRA(PAR, SCA)
Cybistax antisyphilitica	ARG(JUJ) / BRA(PAR, RGS, SCA) / PRY(APY, CEN, CON, COA, PAI)
Cyclanthera hystrix	ARG(BAI, CAT, COR, COS, ERI, JUJ, MIS, SAL, TUC) / BRA(PAR, RGS, SCA) / PRY(GUA, PAI) / URY(CAS, COL, RNO, TAC)
Cyclanthera oligoechinata	ARG(MIS) / BRA(PAR) / PRY(APY, SPE)
Cyclanthera pedata	ARG(JUJ, SAL)
Cyclanthera quinquelobata	ARG(JUJ, MIS, SAL) / BRA(PAR)
Cyclanthera tamnifolia	ARG(CAT, JUJ, SAL, TUC)
Cyclanthera tenuifolia	BRA(PAR, SCA)
Cyclanthera tenuisepala	ARG(MIS) / BRA(PAR, RGS)
Cyclodium meniscioides	ARG(COS) / PRY(AMA, CAN, ITA)
Cyclolepis genistoides	ARG(BAI, CAT, CHA, CHU, COR, ERI, FOR, JUJ, LPA, LRI, MEN, NEU, RNE, SAL, SJU, SLU, SFE, SDE, TUC) / PRY(APY, PHA)
Cyclolobium brasiliense	ARG(MIS) / BRA(PAR) / PRY(AMA, CON, COA, GUA, PAI)
Cycloloma atriplicifolium	ARG(BAI)
Cyclopogon alexandrae	BRA(PAR)
Cyclopogon aphyllus	BRA(PAR)
Cyclopogon apricus	ARG(COS, JUJ, SAL, TUC) / BRA(PAR, RGS, SCA) / URY(ART, CAS, CLA, DUR, FLA, LAV, MAL, MON, RIV, ROC, TAC, TYT)
Cyclopogon argyrifolius	BRA(RGS)
Cyclopogon bicolor	ARG(BAI, CHA, MIS) / BRA(PAR, RGS, SCA) / PRY(GUA) / URY(FLA)
Cyclopogon calophyllus	ARG(JUJ, MIS) / BRA(Desconocida)
Cyclopogon congestus	ARG(JUJ, MIS, SAL, TUC) / BRA(PAR, RGS, SCA) / PRY(COA) / URY(LAV, MAL, ROC)
Cyclopogon deminkiorum	PRY(ITA)
Cyclopogon dusenii	BRA(PAR, RGS)
Cyclopogon dutraei	BRA(PAR, RGS) / URY(COL, LAV, MAL, SJO)
Cyclopogon elatus	ARG(BAI, CHA, COR, COS, ERI, FOR, JUJ, MIS, SAL, SFE, SDE, TUC) / BRA(PAR, RGS, SCA) / PRY(APA, GUA, SPE) / URY(ART, CLA, COL, LAV, MAL, RNO, RIV, ROC, SAO, SJO, SOR, TAC, TYT)
Cyclopogon elegans	ARG(JUJ, MIS, SAL) / BRA(PAR, RGS)
Cyclopogon graciliscapus	BRA(PAR)
Cyclopogon hatschbachii	BRA(PAR)
Cyclopogon iguapensis	BRA(PAR, SCA)
Cyclopogon itatiaiensis	BRA(PAR, SCA)
Cyclopogon longibracteatus	ARG(BAI, COS, MIS) / BRA(PAR, RGS, SCA)
Cyclopogon multiflorus	BRA(PAR, RGS, SCA)
Cyclopogon oliganthus	ARG(COS, MIS, SAL) / BRA(Fuera del área del proyecto) / URY(CAS, LAV, MAL, MON, RIV, ROC)
Cyclopogon polyaden	ARG(COS, MIS, SAL) / BRA(PAR, RGS) / URY(ART, RIV, TAC)
Cyclopogon subalpestris	ARG(COS, MIS) / BRA(RGS)
Cyclopogon taquaremboensis	URY(LAV)
Cyclopogon trifasciatus	BRA(RGS, SCA)
Cyclopogon variegatus	ARG(MIS) / BRA(PAR)
Cyclopogon vittatus	BRA(RGS)
Cyclopogon warmingii	BRA(PAR, SCA)
Cyclospermum laciniatum	CHL(TAR, ANT, ATA, COQ, VAL, LBO, BIO, ARA, RME)
Cyclospermum leptophyllum var. multisectum	ARG(MIS) / BRA(PAR, SCA)
Cyclospermum leptophyllum var. latisectum	ARG(COS) / BRA(PAR, RGS, SCA)
Cyclospermum leptophyllum var. leptophyllum	ARG(BAI, CAT, CHA, CHU, COR, COS, ERI, FOR, JUJ, LPA, LRI, MIS, RNE, SAL, SJU, SLU, SFE, SDE, TUC) / BRA(PAR, RGS, SCA) / CHL(ATA, COQ, VAL, MAU, BIO, ARA, LLA, RME, JFE, IPA) / PRY(APA, APY, BOQ, ÑEE, SPE) / URY(ROC)
Cyclospermum uruguayense	URY(SJO)
Cylindropuntia imbricata	ARG(COR)
Cylindropuntia tunicata	ARG(LPA, MEN) / CHL(TAR, ANT, ATA, COQ)
Cymbalaria muralis	ARG(BAI, COR, DFE, ERI, MEN, SAL, SFE, TUC) / CHL(VAL, BIO, RME, JFE) / URY(CAS, MON, RNO)
Cymbocarpa refracta	BRA(PAR, SCA)
Cymbopogon citratus	ARG(MIS) / CHL(TAR)
Cymbopogon winterianus	BRA(RGS)
Cynanchum montevidense	ARG(BAI, CAT, CHA, COR, COS, ERI, FOR, JUJ, LRI, MIS, SAL, SDE, SFE, TUC) / BRA(PAR, RGS, SCA) / PRY(APA, APY, CEN, CON, COA, PHA, SPE) / URY(MON, SJO)
Cynanchum roulinioides	BRA(Fuera del área del proyecto) / PRY(AMA)
Cynara cardunculus	ARG(BAI, CAT, COR, DFE, ERI, LPA, MEN, SFE) / BRA(RGS) / CHL(COQ, VAL, LBO, MAU, BIO, RME, JFE) / URY(CAS, MON, PAY, RNO, SOR)
Cynodon affinis	ARG(BAI, COR, DFE, ERI, JUJ, LPA, MEN, MIS) / CHL(TAR, COQ, VAL, BIO, RME) / URY(SJO)
Cynodon dactylon var. pilosus	ARG(BAI, COR, ERI, FOR, LPA, LRI, MEN, SAL, SJU, SDE) / BRA(PAR, RGS)
Cynodon dactylon var. longiglumis	ARG(BAI, CHA, COS, ERI, LPA, MIS, SAL, SFE, SDE, TUC) / PRY(ITA) / URY(MAL, MON, SAO)
Cynodon dactylon var. biflorum	ARG(BAI, CHA, ERI, JUJ, SDE, TUC) / BRA(RGS)
Cynodon dactylon var. dactylon	ARG(BAI, CAT, CHA, COR, COS, DFE, ERI, FOR, JUJ, LPA, LRI, MEN, MIS, NEU, RNE, SAL, SDE, SFE, SJU, SLU, TUC) / BRA(PAR, RGS, SCA) / CHL(TAR, ANT, ATA, COQ, VAL, LBO, MAU, BIO, RME, IPA) / PRY(COA, GUA) / URY(MAL, MON, PAY, ROC, SAO, SJO, SOR)
Cynodon distichioides	URY(CAS, MAL, MON)
Cynodon hirsutissimus	ARG(BAI, CAT, DFE, ERI, LPA, MEN, MIS, SFE) / URY(MON)
Cynodon incompletus var. hirsutus	ARG(BAI, CAT, COR, DFE, ERI, JUJ, LPA, MEN, SLU, SFE, SDE, TUC)
Cynodon laeviglumis	ARG(LPA)
Cynodon maritimus var. maritimus	ARG(CHA, COS, DFE, ERI, JUJ, MIS, SFE, TUC) / BRA(RGS) / URY(Desconocida)
Cynodon maritimus var. grandispiculus	ARG(BAI, CAT, CHA, COR, COS, ERI, LRI, SAL, SLU, SFE, TUC) / BRA(PAR, RGS, SCA) / URY(MAL, MON, SJO)
Cynodon maritimus var. breviglumis	ARG(BAI)
Cynodon mucronatus	ARG(MIS) / BRA(RGS)
Cynodon nitidus	CHL(TAR)
Cynodon nlemfuensis	ARG(TUC) / BRA(RGS)
Cynodon pedicellatus	URY(MON)
Cynodon plectostachyus	ARG(BAI, CHA, COR, COS, DFE, ERI, MIS, SFE) / PRY(APY)
Cynoglossum amabile	ARG(CAT, COR, JUJ, SAL, TUC) / BRA(PAR)
Cynoglossum creticum	ARG(BAI, CHU, MEN, NEU, RNE, SLU) / CHL(COQ, VAL, LBO, MAU, BIO, ARA, LLA, RME, JFE)
Cynoglossum limense	CHL(BIO, ARA, LLA)
Cynoglossum paniculatum	CHL(VAL, LBO, MAU, BIO, ARA, LLA)
Cynoglossum zeylanicum	CHL(MAU, ARA, LLA)
Cynometra bauhiniifolia var. meridiana	ARG(CHA, COS, FOR, MIS)
Cynometra bauhiniifolia var. bauhiniifolia	ARG(COS, FOR) / BRA(Fuera del área del proyecto) / PRY(APY, CEN, PAI)
Cynophalla polyantha	ARG(SAL)
Cynophalla retusa	ARG(CHA, COR, COS, ERI, FOR, JUJ, MIS, SAL, SFE, SDE, TUC) / PRY(APY, AMA, BOQ, CEN, CHO, CON, COA, ÑEE, NAS, PAI, PHA)
Cynosurus cristatus	ARG(BAI, CHU, DFE, MEN, NEU, RNE, SLU, TDF) / CHL(VAL, BIO, MAG)
Cynosurus echinatus	ARG(BAI, LPA, NEU, RNE, TDF) / CHL(VAL, LBO, MAU, BIO, ARA, LLA, MAG, RME, JFE) / URY(COL, MAL, MON, SJO, SOR)
Cypella altouruguaya	BRA(RGS)
Cypella amplimaculata	BRA(RGS)
Cypella aquatilis	BRA(PAR, RGS)
Cypella armosa	ARG(CHA, COS, FOR, MIS, SFE) / BRA(RGS) / PRY(APA, CAU, CAA, COA, GUA, ÑEE, PAI, PHA, SPE)
Cypella brasiliensis	BRA(RGS)
Cypella charruana	BRA(RGS) / URY(ART, RIV)
Cypella coelestis	ARG(BAI, COS, ERI, MIS, SAL) / BRA(PAR, RGS, SCA) / PRY(APA, CAU, CAA, GUA, PAI, SPE) / URY(RIV, ROC)
Cypella curuzupensis	PRY(GUA)
Cypella discolor	BRA(RGS)
Cypella elegans	ARG(JUJ)
Cypella exilis	ARG(CHA, COS, FOR, MIS) / BRA(RGS, SCA) / PRY(CAN, CEN, CON, ÑEE)
Cypella fucata	ARG(COS) / BRA(RGS, SCA) / URY(CLA, MAL)
Cypella geniculata	BRA(PAR, SCA)
Cypella gloriana	BRA(RGS)
Cypella gracilis	PRY(CAN, COA, PAI)
Cypella hauthalii ssp. hauthalii	ARG(COS, MIS) / PRY(ITA, PAI)
Cypella hauthalii ssp. opalina	ARG(COS, MIS)
Cypella hauthalii ssp. minuticristata	BRA(RGS)
Cypella herbertii ssp. brevicristata	BRA(SCA) / URY(ART)
Cypella herbertii ssp. herbertii	ARG(BAI, COS, ERI, MIS, SFE) / BRA(PAR, RGS, SCA) / PRY(ÑEE, PHA) / URY(ART, SJO)
Cypella herbertii ssp. wolffhuegeli	ARG(BAI)
Cypella laeta	ARG(ERI, MIS) / URY(SAO)
Cypella lapidosa	ARG(COS)
Cypella laxa	ARG(COS, MIS) / BRA(PAR, SCA) / PRY(APA, AMA, CAU, CAN)
Cypella lilacea	PRY(CON)
Cypella linearis	PRY(APY)
Cypella luteogibbosa	BRA(RGS)
Cypella magnicristata	BRA(RGS)
Cypella oreophila	ARG(CAT, JUJ, SAL, TUC) / PRY(APY, CAA)
Cypella osteniana ssp. osteniana	URY(CAS, CLA, LAV)
Cypella osteniana ssp. aurantiaca	ARG(ERI) / URY(ART, SAO)
Cypella pabstiana	ARG(COS, MIS) / BRA(PAR)
Cypella pusilla	BRA(RGS)
Cypella rivularis	BRA(RGS)
Cypella suffusa	ARG(COS, MIS)
Cypella trimontina	ARG(COS)
Cypella uliginosa	ARG(COS, ERI)
Cypella unguiculata	BRA(RGS) / URY(CLA)
Cypella yatayphila	ARG(ERI)
Cyperus aggregatus	ARG(BAI, CAT, CHA, COR, COS, DFE, ERI, FOR, JUJ, LPA, LRI, MIS, SAL, SJU, SLU, SFE, SDE, TUC) / BRA(PAR, RGS, SCA) / CHL(BIO) / PRY(APA, APY, AMA, BOQ, CAN, CEN, COA, GUA, ITA, MIE, ÑEE, PAI, PHA, SPE) / URY(ART, CAS, CLA, CLA, FLO, FLA, MON, PAY, RNO, RIV, SJO, SJO, TAC, TYT)
Cyperus andinus	ARG(CAT, COR, JUJ, TUC)
Cyperus andreanus var. capitinduensis	ARG(ERI, JUJ, MIS) / BRA(SCA) / PRY(APA, CAA)
Cyperus andreanus var. yguazuensis	ARG(MIS)
Cyperus andreanus var. andreanus	BRA(RGS, SCA)
Cyperus andreanus var. foliosissimus	ARG(MIS)
Cyperus anisitsii	PRY(GUA)
Cyperus barrosianus	ARG(BAI, COS, ERI, SFE) / BRA(PAR, RGS, SCA) / PRY(COA) / URY(CLA, COL, MON, TYT)
Cyperus berroi	ARG(BAI, ERI) / URY(CAS, DUR, MAL, RNO, ROC, SAO, TAC)
Cyperus brasiliensis	ARG(CHA, COS, ERI, MIS, SFE) / BRA(PAR, RGS, SCA) / PRY(AMA, CAA, CEN, COA, GUA, MIE, PAI) / URY(COL, RIV)
Cyperus brevifolius	ARG(BAI, CHA, COS, ERI, MIS, SAL, SFE, TUC) / BRA(PAR, RGS, SCA) / PRY(APA, AMA, CAA, CEN, GUA, ÑEE, SPE) / URY(COL)
Cyperus burkartii	ARG(MIS) / BRA(RGS)
Cyperus celluloso-reticulatus	BRA(RGS, SCA)
Cyperus cephalanthus	ARG(COS) / PRY(CAU, CEN, COA)
Cyperus chalaranthus	ARG(COS, JUJ, MIS, SAL) / BRA(PAR, RGS, SCA) / PRY(APA, CEN, COA, GUA)
Cyperus compressus	ARG(COS) / BRA(RGS, SCA)
Cyperus consors var. riedelianus	BRA(SCA)
Cyperus cornelii-ostenii var. pilcomayensis	ARG(CHA, ERI, FOR, JUJ, SAL, SFE) / PRY(APY)
Cyperus cornelii-ostenii var. cornelii-ostenii	ARG(CHA, COS, ERI, JUJ, MIS, SAL) / PRY(APY, CAU, CAN, CEN, COA, PAI)
Cyperus corymbosus var. subnodosus	ARG(BAI, CAT, CHA, COR, COS, DFE, ERI, FOR, JUJ, LPA, MEN, SAL, SJU, SLU, SFE, SDE, TUC) / BRA(RGS) / PRY(APY, CEN, PHA) / URY(ART, CLA, COL, MON, RNO, ROC, SAO, SJO, SOR, TAC)
Cyperus densicaespitosus	ARG(COS, ERI, FOR, JUJ, MIS, SAL, TUC) / BRA(PAR, RGS, SCA) / PRY(APA, COA) / URY(CLA)
Cyperus difformis	CHL(LBO, MAU, BIO) / URY(ROC)
Cyperus digitatus	ARG(BAI, CHA, COR, COS, DFE, ERI, FOR, JUJ, LPA, MIS, SAL, SJU, SLU, SFE, SDE, TUC) / BRA(PAR) / PRY(APY, CEN, CHO, COA, ÑEE, PAI, PHA)
Cyperus distans	ARG(JUJ) / BRA(PAR, RGS, SCA)
Cyperus drummondii	ARG(FOR) / BRA(RGS)
Cyperus entrerianus var. parvicapitulatus	ARG(CHA, ERI, FOR, MIS, SAL)
Cyperus entrerianus var. entrerianus	ARG(BAI, CAT, CHA, COR, COS, DFE, ERI, FOR, JUJ, MIS, SAL, SDE, SFE, TUC) / BRA(PAR, RGS, SCA) / PRY(APY, BOQ, CAU, CAA, CEN, CON, COA, GUA, MIE, ÑEE, PHA, SPE) / URY(ART, PAY, RNO, RIV, SAO, SOR, TAC)
Cyperus eragrostis var. compactus	ARG(BAI, COR, MEN, NEU, RNE, SLU) / CHL(VAL, BIO, LLA, RME)
Cyperus eragrostis var. eragrostis	ARG(BAI, CAT, COR, COS, DFE, ERI, FOR, LPA, LRI, MEN, MIS, RNE, SAL, SJU, SLU, SFE, TUC) / BRA(PAR, RGS, SCA) / CHL(ATA, COQ, VAL, LBO, MAU, BIO, ARA, LLA, RME, JFE) / URY(ART, CAS, CLA, COL, FLO, FLA, MAL, MON, PAY, RNO, RIV, ROC, SAO, SJO, SOR)
Cyperus esculentus var. leptostachyus	ARG(BAI, CAT, CHA, COR, COS, DFE, ERI, FOR, JUJ, MIS, SAL, SDE, SFE, SJU, TUC) / BRA(PAR, RGS, SCA) / PRY(APA, APY, CEN, CHO) / URY(ART, CAS, CLA, DUR, MAL, MON, RNO, ROC, SOR, TAC, TYT)
Cyperus esculentus var. macrostachyus	ARG(BAI, DFE, TUC) / BRA(PAR, RGS, SCA) / URY(PAY)
Cyperus esculentus var. esculentus	BRA(PAR, RGS, SCA)
Cyperus felipponei	ARG(COS, ERI) / BRA(RGS) / URY(CAS, FLO, SOR)
Cyperus flavescens var. piceus	ARG(COS) / BRA(SCA) / PRY(COA) / URY(MON, RIV)
Cyperus flavicomus	ARG(COS, ERI, SAL) / BRA(Fuera del área del proyecto) / PRY(ÑEE, SPE)
Cyperus fraternus	ARG(BAI, CHA, COR, COS, FOR, RNE, SFE, TUC) / BRA(PAR, RGS, SCA) / CHL(MAU, LLA) / PRY(AMA, CAN) / URY(ART, CAS, CLA, FLO, PAY, RNO, RIV, SAO)
Cyperus friburgensis	ARG(JUJ, MIS, SAL) / BRA(PAR, SCA) / PRY(APA, AMA, CAA, CAN, GUA)
Cyperus gardneri	ARG(CHA, COS) / BRA(Fuera del área del proyecto)
Cyperus giganteus	ARG(BAI, CHA, COS, DFE, ERI, FOR, MIS, SFE, TUC) / BRA(PAR, RGS, SCA) / PRY(APY, CEN, CON, ITA, MIE, ÑEE, PHA) / URY(ART, CLA, COL, RNO, RIV, ROC, SOR, TAC, TYT)
Cyperus grammicus	CHL(MAU, BIO, ARA, LLA)
Cyperus haspan var. haspan	ARG(BAI, CHA, COS, ERI, FOR, JUJ, MIS, SFE) / BRA(PAR, RGS, SCA) / PRY(CAU, CAA, CAN, CEN, COA, GUA, ITA, MIE, ÑEE, PAI) / URY(ART, CLA, COL, FLA, LAV, MAL, MON, PAY, RNO, RIV, SAO, SJO, TAC)
Cyperus haspan var. amplissimus	ARG(CHA, ERI, MIS) / BRA(SCA) / PRY(APA, COA)
Cyperus haspan var. coarctatus	ARG(CHA) / BRA(RGS) / URY(MON)
Cyperus hermaphroditus	ARG(CAT, CHA, COR, COS, JUJ, LRI, MIS, SAL, SFE, SDE, TUC) / BRA(PAR, RGS, SCA) / PRY(CAA, GUA, ITA)
Cyperus hieronymi	ARG(CAT, JUJ, MIS, SAL, TUC)
Cyperus imbricatus	ARG(BAI, CHA, COS, DFE, ERI, FOR, MIS, SFE) / BRA(PAR, RGS) / PRY(APY, APA, ITA, SPE) / URY(ART, CLA, DUR, FLO, FLA, PAY, RNO, RIV, SAO, SOR, TAC)
Cyperus incomtus var. incomtus	ARG(BAI, CAT, CHA, COR, COS, ERI, FOR, JUJ, MIS, SAL, SDE, SFE, TUC) / BRA(PAR, RGS, SCA) / PRY(APA, CAA, CEN, COA, GUA, PAI, SPE) / URY(ART, COL, DUR, MAL, MON, PAY, RNO, SAO, SOR, TAC, TYT)
Cyperus incomtus var. venturii	ARG(CAT, JUJ, MIS, TUC)
Cyperus infucatus	ARG(TUC) / BRA(Fuera del área del proyecto)
Cyperus inops	BRA(PAR, SCA)
Cyperus intricatus	ARG(CHA, COR, COS, DFE, ERI, FOR, MIS, SFE) / BRA(PAR, RGS, SCA)
Cyperus involucratus	ARG(BAI, COR, MEN, SAL, SFE, TUC) / BRA(RGS, SCA) / CHL(ANT, MAU, LLA, RME)
Cyperus iria	ARG(BAI, CHA, COS, JUJ, MIS, SAL, SFE, TUC) / BRA(PAR, RGS, SCA) / URY(ART)
Cyperus laevigatus	ARG(BAI, CAT, COR, COS, JUJ, LPA, SAL, SJU, SFE, SDE, TUC) / CHL(TAR, ANT, COQ)
Cyperus lanceolatus	ARG(BAI, COS, ERI, MIS, TUC) / BRA(PAR, RGS, SCA) / CHL(MAU) / PRY(CAN, CEN, COA, GUA, ITA, ÑEE, PAI) / URY(ART, CLA, COL, MON, RNO, RIV, SAO, TAC)
Cyperus laxus	ARG(CHA, COS, JUJ, MIS, SAL) / BRA(PAR, RGS, SCA) / PRY(APA, APY, AMA, BOQ, CEN, CON, COA, GUA, MIE, ÑEE, PAI, SPE)
Cyperus ligularis	BRA(PAR, SCA) / PRY(CON, PAI, SPE)
Cyperus luzulae	ARG(CHA, FOR, SAL, SFE, TUC) / BRA(PAR, RGS, SCA) / PRY(APY, CAA, CON, GUA, SPE)
Cyperus manimae	ARG(CAT, SAL, TUC)
Cyperus megapotamicus var. megapotamicus	ARG(BAI, CHA, COS, ERI, MIS) / BRA(PAR, RGS, SCA) / PRY(CAU, CAA, CEN, COA, MIE, PAI, SPE) / URY(CAS, CLA, LAV, MAL, MON, RNO, RIV, ROC, SJO, TAC, TYT)
Cyperus megapotamicus var. jaeggii	ARG(BAI, CHA, COS, ERI, MIS) / BRA(RGS) / CHL(BIO) / PRY(CEN) / URY(CAS, CLA, FLA, MAL, MON, ROC, SJO, SJO, TAC)
Cyperus meridionalis	ARG(BAI, ERI) / BRA(RGS) / URY(ART, CAS, CLA, COL, FLA, MAL, MON, PAY, RNO, SJO, SOR)
Cyperus meyenianus	ARG(BAI, CAT, COS, ERI, FOR, JUJ, MIS, SAL, SDE) / BRA(PAR, RGS, SCA) / PRY(APY, COA, PHA) / URY(ART, CLA, RNO)
Cyperus mundulus	BRA(RGS, SCA)
Cyperus niederleinianus	ARG(COS, MIS) / BRA(SCA) / PRY(COA)
Cyperus niger	ARG(BAI, CAT, COR, JUJ, LRI, MEN, SAL, SJU, SLU, TUC) / BRA(PAR, RGS, SCA)
Cyperus obtusatus	ARG(BAI, CHA, COS, ERI, JUJ, MIS, SFE, TUC) / BRA(PAR, RGS, SCA) / PRY(APA, APY, CAU, COA, ÑEE, PAI, SPE) / URY(CAS, CLA, COL, CLA, MAL, MON, PAY, RNO, RIV, ROC, SAO, SJO, SJO, TAC)
Cyperus ochraceus	ARG(CHA, JUJ, SAL) / BRA(Fuera del área del proyecto) / PRY(APY, PAI)
Cyperus odoratus	ARG(BAI, CAT, CHA, COR, COS, DFE, ERI, FOR, JUJ, LPA, LRI, MEN, MIS, SAL, SDE, SFE, SJU, TUC) / BRA(PAR, RGS, SCA) / CHL(LBO, MAU) / PRY(APA, APY, AMA, BOQ, CAU, CAA, CEN, CON, COA, GUA, ITA, ÑEE, PAI, PHA, SPE) / URY(ART, CAS, CLA, COL, MAL, MON, RNO, ROC, SAO, SJO, SOR)
Cyperus oxylepis	ARG(CHA, COS, ERI, FOR, SFE, SDE, TUC) / PRY(APY, CON, PHA)
Cyperus phaeocephalus	ARG(CAT, COR, JUJ, LRI, SAL, TUC)
Cyperus poeppigii	CHL(LBO, BIO, RME)
Cyperus pohlii	ARG(BAI, COS, DFE, ERI, JUJ, MIS, NEU, SFE) / BRA(PAR, RGS, SCA) / PRY(APY, CEN, COA, PHA, SPE) / URY(RNO, RIV, ROC, TAC)
Cyperus polystachyos	ARG(BAI, CHA, COS, ERI, FOR, LPA, MIS, SFE) / BRA(PAR, RGS, SCA) / PRY(APY, COA) / URY(CAS, CLA, FLA, MAL, MON, ROC, SJO)
Cyperus prolixus	ARG(BAI, CHA, COR, COS, DFE, ERI, FOR, MIS, SAL, SFE, TUC) / BRA(PAR, RGS, SCA) / PRY(AMA, CAA, CEN, COA, GUA, MIE, ÑEE, PAI) / URY(CAS, CLA, COL, FLO, MAL, MON, RNO, RIV, ROC, SAO, SJO, SOR, TYT)
Cyperus redolens	ARG(BAI, CHA, COR, COS, ERI, JUJ, SFE) / PRY(APY) / URY(MAL, PAY, RIV, SOR)
Cyperus reflexus	ARG(BAI, CHA, COR, COS, ERI, FOR, LPA, MIS, RNE, SFE, SLU, TUC) / BRA(PAR, RGS, SCA) / CHL(VAL, MAU, BIO, ARA, LLA, JFE) / PRY(CAA, CAN, CEN, ÑEE, PHA) / URY(ART, CAS, CLA, DUR, FLA, MAL, MON, PAY, RNO, RIV, ROC, SAO, SJO, SOR, TAC, TYT)
Cyperus rigens ssp. arechavaletae	BRA(RGS) / URY(MON)
Cyperus rigens var. impolitus	ARG(BAI, CHA, COR, COS, ERI, FOR, MIS) / BRA(PAR, RGS, SCA) / PRY(APA, AMA, CAU, CAA, CEN, CON, COA, GUA, MIE, ÑEE, PAI, PHA, SPE) / URY(CAS, CLA, FLO, MAL, MON, RIV, SAO, SJO)
Cyperus rigens var. rigens	ARG(BAI, CAT, CHA, COR, COS, DFE, ERI, FOR, JUJ, MIS, SAL, SFE, TUC) / BRA(PAR, RGS, SCA) / CHL(ANT, MAU, BIO, ARA, LLA, RME) / PRY(APY, AMA, BOQ, CAU, CEN, COA, GUA, MIE, PAI, SPE) / URY(CAS, CLA, COL, FLO, MAL, MON, RNO, RIV, SAO, SJO, SJO, TAC)
Cyperus rivularis	ARG(CAT, COR, JUJ, MEN, SAL, SLU, TUC)
Cyperus rotundus	ARG(BAI, CHA, COR, COS, DFE, ERI, FOR, JUJ, LPA, MEN, MIS, SAL, SJU, SFE, SDE, TUC) / BRA(PAR, RGS, SCA) / CHL(COQ, VAL, MAU, BIO, RME) / PRY(COA) / URY(CAS, MON, PAY, RNO, SOR)
Cyperus schomburgkianus	BRA(SCA)
Cyperus sellowianus	ARG(CHA, COS, ERI, MIS) / BRA(PAR, RGS, SCA) / PRY(AMA, CAU, CAA, CAN, COA, MIE, PAI, SPE) / URY(CLA, CLA, MON, RNO, RIV, ROC, TAC)
Cyperus sesquiflorus	ARG(BAI, CAT, CHA, COR, COS, ERI, FOR, JUJ, MIS, SAL, SCR, SFE, TUC) / BRA(PAR, RGS, SCA) / PRY(APA, APY, AMA, CAU, CEN, CHO, CON, COA, GUA, MIE, ÑEE, PAI, SPE) / URY(ART, CLA, FLO, FLA, LAV, MAL, MON, PAY, RNO, ROC, SAO, SJO, TYT)
Cyperus spectabilis var. jujuyensis	ARG(JUJ, SAL, TUC)
Cyperus sphacelatus	BRA(PAR, SCA)
Cyperus squarrosus	ARG(CAT, ERI, JUJ, LPA, MEN, NEU, RNE, SJU, TUC) / BRA(Fuera del área del proyecto) / CHL(COQ, LBO, MAU, BIO, LLA, RME) / PRY(APY, CON, COA) / URY(CLA, DUR, ROC, SAO, SOR, TAC)
Cyperus subsquarrosus	ARG(COS) / BRA(PAR, RGS) / PRY(COA) / URY(CLA)
Cyperus surinamensis var. surinamensis	ARG(BAI, CHA, COR, COS, ERI, FOR, MIS, SAL, SDE, SFE, TUC) / BRA(PAR, RGS, SCA) / PRY(APY, AMA, BOQ, CAN, CEN, COA, GUA, ÑEE, PHA) / URY(ART, CLA, COL, DUR, FLA, PAY, RNO, SAO, TAC)
Cyperus surinamensis var. lutescens	ARG(COS) / PRY(APY, COA)
Cyperus tenuis	BRA(SCA) / PRY(CAU, PAI)
Cyperus tweediei	ARG(TUC) / CHL(VAL)
Cyperus uncinulatus	ARG(CHA, COS, MIS, SAL, SFE) / BRA(Fuera del área del proyecto) / PRY(APY, COA, PAI, SPE) / URY(RNO)
Cyperus unicolor	ARG(BAI, COS, ERI, MIS, SAL) / BRA(SCA) / PRY(APA) / URY(PAY, RNO, RIV, SAO, SOR, TAC)
Cyperus unioloides	ARG(COS, MIS) / BRA(RGS, SCA) / PRY(AMA, CEN, COA, PAI) / URY(PAY, RNO, RIV)
Cyperus virens var. montanus	ARG(MIS, SFE) / CHL(BIO)
Cyperus virens var. virens	ARG(BAI, CHA, COS, DFE, ERI, FOR, JUJ, MIS, SAL, SFE, TUC) / BRA(PAR, RGS, SCA) / CHL(MAU, ARA) / PRY(APY, CEN, CON, COA, PHA, SPE) / URY(ART, CLA, COL, FLA, MAL, MON, PAY, RNO, RIV, ROC, SAO, SJO, SOR)
Cyperus virens var. minarum	ARG(CHA)
Cyperus volckmannii	CHL(COQ, MAU)
Cyperus xanthostachyus	CHL(VAL, BIO, ARA, LLA, AIS)
Cyphocarpus innocuus	CHL(COQ)
Cyphocarpus psammophilus	CHL(ATA, COQ)
Cyphocarpus rigescens	CHL(ATA, COQ)
Cypselea humifusa	ARG(COS)
Cyrtocymura cincta	ARG(CAT, FOR, JUJ, SAL, TUC) / PRY(APA, APY, AMA, CEN, CON, COA, GUA, ITA, PAI, SPE)
Cyrtocymura scorpioides	ARG(BAI, CHA, COS, ERI, FOR, MIS, SFE) / BRA(PAR, RGS, SCA) / PRY(APA, AMA, CAU, CAN, CEN, CON, COA, GUA, ITA, MIE, ÑEE, PAI, PHA) / URY(COL)
Cyrtomium falcatum	ARG(BAI, ERI)
Cyrtopodium andersonii	BRA(PAR, SCA)
Cyrtopodium brandonianum ssp. brandonianum	ARG(COS) / BRA(PAR) / URY(RIV)
Cyrtopodium brandonianum ssp. lageanum	BRA(SCA)
Cyrtopodium dusenii	BRA(PAR)
Cyrtopodium eugenii	BRA(PAR)
Cyrtopodium flavum	BRA(PAR, RGS, SCA)
Cyrtopodium galeandroides	BRA(SCA) / PRY(AMA)
Cyrtopodium gigas	BRA(PAR, RGS, SCA)
Cyrtopodium hatschbachii	ARG(COS, MIS) / BRA(Fuera del área del proyecto) / PRY(CAU)
Cyrtopodium kleinii	BRA(PAR, SCA)
Cyrtopodium pallidum	BRA(PAR) / PRY(AMA)
Cyrtopodium palmifrons	ARG(COS, MIS) / BRA(PAR, SCA) / PRY(APA, CEN, GUA)
Cyrtopodium paludicolum	BRA(PAR)
Cyrtopodium paniculatum	ARG(SAL, TUC)
Cyrtopodium parviflorum	BRA(PAR)
Cyrtopodium pflanzii	ARG(TUC) / PRY(BOQ)
Cyrtopodium punctatum	ARG(CAT, CHA, FOR, JUJ, SAL, TUC) / BRA(PAR) / PRY(APY, APA, CEN, CON, PHA)
Cyrtopodium purpureum	BRA(PAR) / PRY(CAN)
Cyrtopodium saintlegerianum	
Cyrtopodium virescens	BRA(Fuera del área del proyecto) / PRY(AMA, COA, GUA, PAI)
Cystopteris apiiformis	ARG(CHU, MEN, NEU, RNE, SJU, SCR, TDF) / CHL(VAL, MAU, BIO, AIS, MAG, RME)
Cystopteris diaphana	ARG(BAI, CAT, COR, FOR, JUJ, LRI, SAL, SLU, TUC) / BRA(RGS, SCA) / URY(CLA, RIV)
Cytisus scoparius	ARG(BAI, CHU, NEU, RNE) / CHL(MAU, BIO, ARA, LLA, MAG)
Cytisus striatus	CHL(MAU, BIO)
