Mabea fistulifera ssp. robusta	BRA(Fuera del área del proyecto) / PRY(AMA)
Macairea adenostemon	PRY(AMA, PAI)
Machaerina austrobrasiliensis	BRA(PAR, RGS, SCA)
Machaerina ensifolia	BRA(PAR, SCA)
Machaerina ficticia	BRA(PAR, SCA)
Machaerina scirpoidea	CHL(JFE)
Machaerium acutifolium	ARG(MIS) / BRA(PAR) / PRY(AMA, CAN, CEN, CON, COA, PAI, SPE)
Machaerium brasiliense	ARG(MIS) / BRA(PAR)
Machaerium dimorphandrum	BRA(PAR, SCA)
Machaerium eriocarpum	PRY(APY, AMA, CEN, CON)
Machaerium glabrum	BRA(RGS)
Machaerium hatschbachii	BRA(PAR)
Machaerium hirtum	ARG(MIS) / BRA(PAR, SCA) / PRY(APY, AMA, CAN, CON, GUA, PAI, PHA, SPE)
Machaerium nyctitans	ARG(COS, MIS) / BRA(PAR)
Machaerium paraguariense	ARG(COS, MIS) / BRA(PAR, RGS, SCA) / PRY(APA, AMA, CAU, CEN, COA, PAI)
Machaerium ruddianum	BRA(PAR)
Machaerium scleroxylon	BRA(PAR) / PRY(AMA)
Machaerium stipitatum	ARG(MIS) / BRA(PAR, RGS, SCA) / PRY(APA, CAN, COA, PAI)
Machaerium uncinatum	BRA(PAR, SCA)
Machaerium vestitum	BRA(PAR, SCA)
Machaerium villosum	PRY(AMA)
Machaonia acuminata	PRY(APY, AMA, CEN, PHA)
Machaonia brasiliensis	ARG(CHA, COS, FOR, MIS, SFE) / BRA(PAR, RGS, SCA) / PRY(APY, AMA, BOQ, CEN, ITA, ÑEE, PHA)
Machaonia spinosa	ARG(COS, MIS) / BRA(PAR, RGS, SCA) / PRY(APY, AMA, BOQ, CEN, CON, PAI, PHA)
Maclura tinctoria ssp. mora	ARG(CHA, COS, FOR, JUJ, SAL) / BRA(Fuera del área del proyecto) / PRY(APY, ÑEE, PHA)
Maclura tinctoria ssp. tinctoria	ARG(FOR, MIS) / BRA(PAR, RGS, SCA) / PRY(APY, APA, CAA, CAN, CEN, CON, COA, GUA, PAI)
Macrachaenium gracile var. gracile	ARG(CHU, NEU, RNE, SCR, TDF) / CHL(BIO, ARA, LLA, AIS, MAG)
Macrachaenium gracile var. radiatum	ARG(CHU, NEU, RNE)
Macradenia paraensis	PRY(APA)
Macrocarpaea rubra	BRA(PAR, SCA)
Macroditassa adnata	BRA(PAR)
Macropharynx meyeri	ARG(JUJ, SAL)
Macropodina blumenavii	ARG(MIS) / BRA(PAR, RGS, SCA) / PRY(APA, CAU, CAA)
Macroptilium arenarium	ARG(COS, ERI, SFE)
Macroptilium atropurpureum	BRA(PAR, RGS)
Macroptilium bracteatum	ARG(CAT, CHA, COR, COS, ERI, FOR, JUJ, SAL, SFE, TUC) / BRA(PAR) / PRY(APY, APA, AMA, CEN, CON, COA, PAI, PHA, SPE)
Macroptilium chacoensis	PRY(CON)
Macroptilium erythroloma	ARG(BAI, CAT, CHA, COR, COS, ERI, FOR, JUJ, MIS, SAL, SFE, TUC) / BRA(PAR, RGS, SCA) / PRY(APA, AMA, CAU, CAN, CEN, COA, GUA, MIE, PAI, PHA, SPE) / URY(RNO)
Macroptilium fraternum	ARG(CAT, CHA, COR, JUJ, SAL, TUC)
Macroptilium lathyroides	ARG(CHA, COS, FOR, JUJ, MIS, SAL, SFE) / BRA(PAR, RGS) / PRY(APY, AMA, CAA, CEN, ITA, ÑEE, PHA) / URY(ART)
Macroptilium longepedunculatum	ARG(CHA, COS, FOR, SFE) / PRY(APY, CEN, PHA, SPE)
Macroptilium martii	BRA(Fuera del área del proyecto) / PRY(APY, AMA, CON)
Macroptilium monophyllum	BRA(RGS) / PRY(AMA, CAU, CAN, GUA)
Macroptilium panduratum	ARG(CAT, CHA, COR, JUJ, MIS, SAL, SDE, TUC) / BRA(Fuera del área del proyecto) / PRY(APY, CEN)
Macroptilium prostratum	ARG(BAI, CHA, COR, COS, ERI, JUJ, MIS, SAL, SDE, SFE, TUC) / BRA(PAR, RGS, SCA) / PRY(AMA, COA, MIE, PAI, PHA) / URY(ART, CLA, DUR, FLO, LAV, MAL, MON, PAY, RNO, RIV, SAO, SOR, TAC, TYT)
Macroptilium psammodes	ARG(COS, MIS, SFE) / BRA(RGS) / PRY(CAU, CAA, CEN, COA, GUA, ITA, MIE, PAI) / URY(ART, CAS, MAL, MON, RIV, ROC)
Macroptilium sabaraense	BRA(Fuera del área del proyecto) / PRY(CON)
Macroscepis aurea	ARG(JUJ, MIS, SAL, TUC) / BRA(PAR, RGS) / PRY(APA)
Macroscepis dutrae	BRA(RGS)
Macroscepis hatschbachii	BRA(PAR)
Macroscepis magnifica	BRA(PAR) / PRY(APA)
Macrosiphonia undulata	ARG(MIS) / PRY(CAU, CAA, CEN, COA, GUA, PAI)
Macrosiphonia velame	BRA(RGS)
Macrosiphonia virescens	ARG(MIS) / BRA(PAR) / PRY(AMA)
Macrothelypteris torresiana	ARG(BAI, COS, ERI, JUJ, MIS, SAL) / BRA(PAR, RGS, SCA) / PRY(APA, CAN, COA, GUA, PAI) / URY(ART, RIV)
Madia chilensis	CHL(COQ, VAL, LBO, MAU, BIO, ARA, LLA, MAG, RME)
Madia sativa	ARG(CHU, MEN, NEU, RNE, SJU, TDF) / CHL(ATA, COQ, VAL, LBO, MAU, BIO, ARA, LLA, AIS, MAG, RME, JFE)
Magonia pubescens	BRA(Fuera del área del proyecto) / PRY(APY, AMA, CON)
Maihuenia patagonica	ARG(CHU, MEN, NEU, RNE, SCR) / CHL(LLA, AIS, MAG)
Maihuenia poeppigii	ARG(NEU) / CHL(MAU, BIO, ARA)
Maihueniopsis archiconoidea	CHL(ATA)
Maihueniopsis atacamensis	CHL(ANT)
Maihueniopsis boliviana ssp. boliviana	ARG(CAT, JUJ, LRI, MEN, SAL, SJU)
Maihueniopsis boliviana ssp. ignescens	CHL(TAR, ANT)
Maihueniopsis boliviana ssp. echinacea	CHL(TAR)
Maihueniopsis camachoi	CHL(ANT)
Maihueniopsis colorea	CHL(ATA)
Maihueniopsis crassispina	CHL(ATA)
Maihueniopsis darwinii var. hickenii	ARG(BAI, CHU, LPA, MEN, NEU, RNE, SCR)
Maihueniopsis darwinii var. darwinii	ARG(BAI, CHU, RNE, SCR) / CHL(AIS)
Maihueniopsis domeykoensis	CHL(ATA)
Maihueniopsis glomerata	ARG(CAT, JUJ, LRI, MEN, SAL, SJU) / CHL(ANT, ATA, COQ)
Maihueniopsis grandiflora	CHL(COQ)
Maihueniopsis minuta	ARG(JUJ, SAL)
Maihueniopsis nigrispina	ARG(JUJ, SAL) / CHL(TAR)
Maihueniopsis ovata	ARG(MEN, SJU) / CHL(VAL, RME)
Maihueniopsis rahmeri	CHL(TAR)
Maihueniopsis recurvata	ARG(SJU)
Maihueniopsis wagenknechtii	CHL(COQ)
Maireana brevifolia	CHL(ATA, IDE)
Malachra radiata	ARG(FOR) / BRA(Fuera del área del proyecto) / PRY(APY, PHA)
Malacothrix clevelandii	CHL(ANT, ATA, COQ)
Malacothrix coulteri	ARG(CHU, NEU, RNE) / CHL(COQ)
Malanea forsteronioides	BRA(PAR, SCA)
Malaxis cogniauxiana	BRA(PAR)
Malaxis excavata	ARG(JUJ, SAL, TUC) / BRA(PAR, RGS, SCA)
Malaxis hieronymi	ARG(CAT, JUJ, SAL, TUC) / BRA(PAR)
Malaxis histionantha	BRA(RGS)
Malaxis irmae	ARG(COS, MIS) / URY(FLA)
Malaxis jaraguae	BRA(SCA)
Malaxis pabstii	BRA(RGS, SCA)
Malaxis padillana	ARG(COR, JUJ, SAL, TUC)
Malaxis parthoni	ARG(COS, JUJ, MIS, TUC) / BRA(PAR, RGS, SCA) / URY(CLA)
Malaxis pubescens	BRA(RGS, SCA)
Malaxis spicata	URY(FLA)
Malaxis warmingii	BRA(RGS)
Malcolmia maritima	ARG(SCR)
Malesherbia auristipulata	CHL(TAR)
Malesherbia campanulata	CHL(COQ)
Malesherbia corallina	CHL(TAR)
Malesherbia densiflora	CHL(ATA)
Malesherbia deserticola	CHL(ANT, ATA)
Malesherbia fasciculata var. fasciculata	CHL(COQ, VAL, LBO, RME)
Malesherbia fasciculata var. glandulosa	CHL(COQ)
Malesherbia humilis var. gabrielae	CHL(COQ)
Malesherbia humilis var. parviflora	CHL(TAR, ANT, ATA, COQ)
Malesherbia humilis var. taltalina	CHL(ANT)
Malesherbia humilis var. humilis	ARG(NEU) / CHL(ANT, ATA, COQ, VAL, MAU, RME)
Malesherbia humilis var. propinqua	CHL(COQ)
Malesherbia lactea	ARG(LRI, SJU) / CHL(ANT, ATA)
Malesherbia lanceolata	CHL(COQ)
Malesherbia linearifolia	CHL(COQ, VAL, LBO, RME)
Malesherbia lirana var. bracteata	CHL(ATA, COQ)
Malesherbia lirana var. lirana	ARG(LRI, SJU) / CHL(COQ, VAL, RME)
Malesherbia lirana var. subglabrifolia	ARG(MEN) / CHL(RME)
Malesherbia obtusa var. johnstonii	CHL(ATA)
Malesherbia obtusa var. obtusa	CHL(ATA)
Malesherbia paniculata	CHL(ATA, COQ, VAL, LBO, RME)
Malesherbia rugosa var. pseudopulverulenta	CHL(ATA)
Malesherbia rugosa var. rugosa	CHL(ATA)
Malesherbia tenuifolia	CHL(TAR)
Malesherbia tocopillana	CHL(ANT)
Malmeanthus subintegerrimus	ARG(COS, MIS) / BRA(RGS, SCA) / PRY(APA, ITA) / URY(ART, RIV, TAC)
Malus domestica	ARG(LPA, NEU, RNE)
Malus sylvestris	ARG(NEU)
Malva assurgentiflora	CHL(TAR, ANT, ATA, COQ, VAL, IDE)
Malva dendromorpha	ARG(BAI, CHU, SFE) / CHL(TAR, ANT, VAL, LBO, MAU, LLA)
Malva moschata	ARG(CHU, NEU) / CHL(LLA, AIS)
Malva neglecta	ARG(BAI, CHU, MEN, NEU, RNE, SCR) / BRA(RGS) / CHL(VAL, RME)
Malva nicaeensis	ARG(BAI, ERI, LPA, NEU, RNE) / CHL(ANT, COQ, VAL, LBO, MAU, BIO, ARA, LLA, RME, JFE) / URY(MON)
Malva parviflora	ARG(BAI, CHU, COR, COS, ERI, JUJ, LPA, LRI, MEN, RNE, SAL, SFE, SJU) / BRA(RGS) / CHL(ANT, ATA, COQ, VAL, LBO, MAU, BIO, ARA, RME, IDE, JFE) / PRY(CEN) / URY(MON, SOR)
Malva sylvestris	ARG(BAI, CHU, COS, ERI, JUJ, NEU, RNE) / BRA(PAR, RGS) / CHL(ANT, RME) / URY(MON, SJO)
Malvastrum amblyphyllum	ARG(FOR, JUJ, SAL, SDE, TUC) / PRY(APY, BOQ, CEN, CON, PHA)
Malvastrum americanum	ARG(CHA, COS, FOR, MIS) / BRA(PAR) / PRY(APY, CEN, COA, PHA)
Malvastrum coromandelianum ssp. capitatospicatum	ARG(CAT, CHA, COR, FOR, JUJ, LRI, MEN, SAL, SJU, SLU, SDE, TUC)
Malvastrum coromandelianum ssp. coromandelianum	ARG(BAI, CAT, CHA, COR, COS, ERI, FOR, JUJ, LRI, MEN, MIS, SAL, SDE, SFE, SJU, SLU, TUC) / BRA(PAR, RGS, SCA) / CHL(TAR, RME, IPA) / PRY(APY, CAU, CEN, CON, COA, PAI, PHA, SPE) / URY(ART)
Malvastrum coromandelianum var. congestum	ARG(JUJ, SAL)
Malvastrum cristobalianum	PRY(APY)
Malvastrum interruptum	ARG(CAT, COR, JUJ, SAL, SLU, TUC)
Malvastrum ionthacarpum	ARG(FOR, SAL) / PRY(APY)
Malvastrum multicuspidatum	ARG(LRI)
Malvastrum spiciflorum	ARG(CAT, COR, SAL, TUC)
Malvastrum tomentosum	BRA(Fuera del área del proyecto) / PRY(AMA)
Malvastrum uniapiculatum	ARG(MIS)
Malvella leprosa	ARG(BAI, CHA, CHU, ERI, JUJ, LPA, LRI, MEN, NEU, RNE, SCR, SFE, SJU, TUC) / CHL(ANT, ATA, COQ, VAL, RME) / URY(CAS, MON, PAY)
Mancoa foliosa	ARG(JUJ, TUC)
Mancoa hispida	ARG(CAT, JUJ, SAL, TUC) / CHL(TAR, ANT)
Mancoa venturii	ARG(JUJ)
Mandevilla angustifolia	ARG(CHA, COS, FOR, JUJ, SAL, TUC) / PRY(APY, CON, PAI, PHA)
Mandevilla atroviolacea	BRA(PAR, RGS, SCA)
Mandevilla brachyloba	ARG(JUJ, SAL)
Mandevilla coccinea	ARG(MIS) / BRA(PAR, RGS, SCA) / PRY(APA, AMA, CAU, CAN, COA) / URY(RIV, ROC, TAC)
Mandevilla emarginata	ARG(COS, MIS) / BRA(PAR, RGS, SCA) / PRY(APA, AMA, CAU, CAN, COA, GUA) / URY(CLA, RIV)
Mandevilla funiformis	BRA(PAR, RGS, SCA)
Mandevilla grata	ARG(TUC)
Mandevilla hirsuta	BRA(Fuera del área del proyecto) / PRY(CAN)
Mandevilla illustris	BRA(PAR) / PRY(AMA)
Mandevilla immaculata	BRA(PAR, SCA)
Mandevilla laxa	ARG(CAT, COR, JUJ, SAL, TUC)
Mandevilla longiflora	ARG(COS, MIS, SAL) / BRA(PAR, RGS, SCA) / PRY(APA, AMA, CAU, CAA, CAN, CON, COA, GUA, ITA, MIE, PAI, SPE) / URY(RIV, TAC)
Mandevilla pentlandiana	ARG(CAT, COR, COS, JUJ, LRI, SAL, SFE, SLU, TUC) / BRA(RGS)
Mandevilla petraea	ARG(BAI, CHA, COR, COS, ERI, FOR, LPA, MIS, SAL, SDE, SFE, SLU) / BRA(PAR, RGS, SCA) / PRY(CAA, CAN, GUA, ITA) / URY(ART, CLA, COL, CLA, LAV, MAL, MON, PAY, RNO, RIV, ROC, SAO, TAC, TYT)
Mandevilla pinifolia	BRA(PAR, RGS) / PRY(AMA, CAU, CAA, CAN, CEN, CON, COA, PHA, SPE) / URY(ART, CLA, COL, FLA, LAV, MAL, PAY, RNO, ROC, SAO, SOR, TYT)
Mandevilla pohliana	ARG(FOR, JUJ) / BRA(PAR, SCA) / PRY(AMA, CAU, CAN, CON, COA, PAI)
Mandevilla scabra	BRA(RGS)
Mandevilla sellowii	BRA(SCA)
Mandevilla spigeliiflora	BRA(Fuera del área del proyecto) / PRY(AMA, CON)
Mandevilla urophylla	BRA(PAR, SCA)
Mandevilla widgrenii	BRA(PAR) / PRY(APA, AMA, CAN)
Manettia chrysoderma	BRA(PAR, SCA)
Manettia congestoides	BRA(PAR)
Manettia cordifolia	ARG(COS, ERI, JUJ, MIS, SAL, TUC) / BRA(PAR, RGS, SCA) / PRY(AMA, CAA, COA, GUA, PAI, SPE) / URY(ART, PAY, SAO)
Manettia glaziovii	BRA(PAR, RGS, SCA)
Manettia gracilis	BRA(PAR, RGS, SCA)
Manettia jorgensenii	ARG(JUJ, SAL, TUC)
Manettia luteo-rubra	ARG(COS, MIS) / BRA(PAR, RGS, SCA) / PRY(APA, CAU, CAA, CAN)
Manettia paranensis	BRA(PAR, SCA)
Manettia pubescens	BRA(PAR, RGS, SCA)
Manettia rojasiana	PRY(AMA, CAA, CON, GUA, SPE)
Manettia tweedieana	ARG(MIS) / BRA(PAR, RGS, SCA) / PRY(APA)
Manettia verticillata	BRA(PAR, SCA)
Mangifera indica	BRA(RGS, SCA) / PRY(COA)
Mangonia tweediana	BRA(RGS) / URY(ART)
Mangonia uruguaya	URY(CLA)
Manihot anisophylla	ARG(CAT, COR, LRI, SAL, SJU, SLU, SDE, TUC) / PRY(APY, AMA, BOQ, PHA)
Manihot anomala ssp. pavoniana	ARG(CAT, JUJ, SAL, TUC)
Manihot anomala ssp. glabrata	PRY(APY, AMA, BOQ, CEN, CON, PAI, SPE)
Manihot caerulescens ssp. macrantha	PRY(APA, AMA, CAN)
Manihot esculenta	PRY(GUA, PAI, PHA)
Manihot flabellifolia	BRA(RGS) / PRY(AMA)
Manihot gracilis	BRA(Fuera del área del proyecto) / PRY(AMA)
Manihot grahamii	ARG(BAI, CAT, COR, COS, ERI, FOR, JUJ, MIS, SAL, SDE, SFE, TUC) / BRA(PAR, SCA) / PRY(APA, AMA, CAU, CAA, CAN, GUA, ITA, MIE, PAI) / URY(CAS, CLA, MON, RIV, SAO, TAC, TYT)
Manihot guaranitica	ARG(CAT, CHA, FOR, JUJ, SAL, SFE, SDE, TUC) / BRA(Fuera del área del proyecto) / PRY(APY, COA, PHA)
Manihot hassleriana	PRY(SPE)
Manihot hunzikeriana	ARG(MIS) / BRA(RGS) / PRY(APA, CAU, CAA, CAN)
Manihot inflata	BRA(PAR)
Manihot mirabilis	PRY(AMA)
Manihot pentaphylla ssp. graminifolia	PRY(AMA, CAN)
Manihot populifolia	PRY(AMA)
Manihot procumbens	BRA(Fuera del área del proyecto) / PRY(CAU, CAN, SPE)
Manihot tenella	PRY(AMA)
Manihot tripartita	BRA(Fuera del área del proyecto) / PRY(AMA)
Manihot variifolia	PRY(AMA)
Manilkara subsericea	BRA(PAR, SCA)
Mansoa difficilis	ARG(COS, MIS) / BRA(PAR, RGS, SCA) / PRY(APA, AMA, CAU, CAA, CAN, CEN, CON, COA, GUA, ITA, MIE, PAI, SPE)
Maprounea brasiliensis	BRA(PAR, SCA)
Maprounea guianensis	BRA(PAR)
Maranta arundinacea	BRA(RGS)
Maranta divaricata	ARG(COS, MIS) / BRA(PAR, RGS, SCA) / PRY(APA, AMA, PAI, SPE)
Maranta sobolifera	ARG(CHA, COS, FOR, MIS, SFE) / BRA(PAR, RGS, SCA) / PRY(AMA, CAU, CAA, CAN, CEN, COA, GUA, ÑEE, PAI)
Marathrum azarensis	ARG(MIS) / BRA(SCA) / PRY(ITA)
Marattia cicutifolia	BRA(PAR, RGS, SCA)
Marcetia taxifolia	BRA(PAR)
Marcgravia polyantha	BRA(PAR, RGS, SCA)
Margaritaria nobilis	ARG(COS, MIS) / BRA(PAR, RGS, SCA) / PRY(CON, GUA, PAI, SPE)
Margaritopsis cephalantha	BRA(Fuera del área del proyecto) / PRY(AMA)
Margaritopsis chaenotricha	BRA(PAR, SCA) / PRY(APA, AMA, CAA, CAN, COA, GUA, PAI, SPE)
Margaritopsis cymuligera	BRA(PAR)
Margaritopsis hassleriana	PRY(CON, SPE)
Margyracaena skottsbergii	CHL(JFE)
Margyricarpus digynus	CHL(JFE)
Margyricarpus pinnatus	ARG(BAI, CHU, COR, ERI, LPA, MEN, NEU, RNE, SAL, SLU, SCR, TUC) / BRA(PAR, RGS, SCA) / CHL(VAL, MAU) / URY(MAL, ROC)
Marlierea krapovickae	BRA(SCA)
Marlierea obscura	BRA(PAR, SCA)
Marlierea parviflora var. parviflora	BRA(PAR, RGS, SCA)
Marlierea suaveolens	BRA(PAR, SCA)
Marlierea tomentosa	BRA(PAR, SCA)
Marrubium vulgare	ARG(BAI, CAT, CHU, COR, COS, DFE, ERI, LPA, MEN, NEU, RNE, SAL, SLU, SCR, SFE, SDE, TUC) / BRA(Fuera del área del proyecto) / CHL(ANT, COQ, VAL, LBO, MAU, BIO, ARA, LLA, AIS, RME, JFE, IPA) / URY(CAS, CLA, DUR, MON, PAY, RNO, SOR)
Marsdenia altissima ssp. altissima	ARG(JUJ, SAL) / BRA(Fuera del área del proyecto) / PRY(AMA)
Marsdenia altissima ssp. faucinuda	PRY(AMA)
Marsdenia brasiliensis	BRA(Fuera del área del proyecto) / PRY(Desconocida)
Marsdenia castillonii	ARG(CAT, FOR, LRI, SAL, TUC) / PRY(APY)
Marsdenia guaranitica	PRY(SPE)
Marsdenia hatschbachii	BRA(PAR)
Marsdenia macrophylla	ARG(MIS) / BRA(PAR) / PRY(APY, CAN, CEN, CON, COA, GUA, SPE)
Marsdenia malmeana	BRA(PAR)
Marsdenia montana	ARG(MIS) / BRA(RGS, SCA) / URY(TAC)
Marsdenia paraguaiensis	PRY(APY)
Marsdenia tressensiae	ARG(COS)
Marsdenia ulei	ARG(JUJ, SAL) / BRA(Fuera del área del proyecto)
Marsilea ancylopoda	ARG(BAI, CHA, CHU, COR, COS, ERI, FOR, JUJ, LPA, MEN, MIS, RNE, SAL, SFE, SLU) / BRA(RGS) / PRY(APY, CEN, CHO, CON, ITA, ÑEE) / URY(ART, CAS, CLA, COL, MAL, MON, PAY, ROC, SJO, SOR, TAC)
Marsilea deflexa	ARG(COS) / BRA(Fuera del área del proyecto) / PRY(APY, CON, ITA, PHA)
Marsilea mollis	ARG(JUJ, TUC) / CHL(COQ)
Marsippospermum grandiflorum	ARG(CHU, SCR, TDF) / CHL(BIO, ARA, LLA, AIS, MAG)
Marsippospermum philippii	ARG(NEU, RNE) / CHL(BIO, ARA, LLA, AIS, MAG)
Marsippospermum reichei	ARG(CHU, NEU, RNE, SCR, TDF) / CHL(LLA, AIS, MAG)
Marsypianthes chamaedrys	ARG(COS, MIS) / BRA(PAR, RGS, SCA)
Marsypianthes hassleri	ARG(MIS) / BRA(PAR, RGS, SCA) / PRY(AMA, CAU, CAN, ITA, MIE, SPE)
Marticorenia foliosa	CHL(ATA, RME)
Mascagnia australis	ARG(CHA, COS) / PRY(CEN, COA, PAI)
Mascagnia brevifolia	ARG(CHA, FOR, JUJ, SAL) / PRY(APY, CON, PHA)
Mascagnia divaricata	ARG(CHA, COS, FOR, JUJ, MIS) / BRA(PAR) / PRY(APA, AMA, CAU, CAA, CAN, CEN, CON, COA, GUA, MIE, PAI, SPE)
Masdevallia infracta	BRA(PAR)
Mastigostyla brachiandra	ARG(SAL)
Mastigostyla cabrerae	ARG(JUJ, SAL)
Mastigostyla coronata	ARG(JUJ)
Mastigostyla cyrtophylla	CHL(TAR, ANT)
Mastigostyla implicata	ARG(JUJ)
Mastigostyla johnstoni	ARG(TUC)
Mastigostyla mirabilis	ARG(TUC)
Mastigostyla spathacea	ARG(CAT, JUJ, LRI, SAL, TUC)
Matayba cristae	BRA(PAR, SCA)
Matayba elaeagnoides	ARG(COS, MIS) / BRA(PAR, RGS, SCA) / PRY(APA, AMA, CAU, CAA, CAN, CEN, COA, GUA, ITA, MIE, PAI, SPE) / URY(ART, RIV)
Matayba guianensis	BRA(PAR, RGS, SCA)
Matayba juglandifolia	BRA(PAR, SCA)
Matayba marginata	BRA(PAR)
Matayba obovata	BRA(PAR)
Matelea australis	ARG(CAT, CHA, COR, FOR, JUJ, SAL, SLU, TUC) / BRA(RGS) / PRY(CAU) / URY(LAV, RNO, TAC)
Matelea balansae	PRY(CAU)
Matelea calchaquina	ARG(SAL)
Matelea denticulata	BRA(PAR, RGS, SCA)
Matelea dusenii	BRA(PAR)
Matelea fiebrigii	ARG(CAT, JUJ, SAL, TUC)
Matelea foetida	ARG(CAT, COR, LRI)
Matelea friesii	ARG(SAL, TUC) / PRY(PHA)
Matelea glaziovii	ARG(MIS) / BRA(PAR)
Matelea hatschbachii	BRA(PAR)
Matelea hirta	ARG(SAL, SDE, TUC)
Matelea hispida	ARG(CAT, COR, ERI, SFE, SLU, TUC)
Matelea pyrrhotricha	BRA(PAR)
Matelea reitzii	BRA(SCA)
Mathewsia auriculata	CHL(TAR, ATA, COQ)
Mathewsia foliosa	CHL(ATA, COQ, VAL, RME)
Mathewsia incana	CHL(ANT, ATA)
Mathewsia linearifolia	CHL(ATA, COQ)
Mathewsia nivea	CHL(ANT, ATA)
Matricaria chamomilla	ARG(BAI, CHU, COR, COS, DFE, ERI, JUJ, LPA, MEN, MIS, NEU, RNE, SCR, SFE, TUC) / BRA(RGS, SCA) / CHL(ANT, COQ, VAL, MAU, BIO, ARA, LLA, RME, JFE) / PRY(CAA) / URY(CAS, CLA, MON, SJO)
Matricaria discoidea	ARG(BAI, CHU, MEN, NEU, RNE, SCR, TDF) / CHL(VAL, LBO, MAU, BIO, ARA, LLA, AIS, MAG, RME)
Matthiola incana	CHL(ANT, JFE)
Maurandya antirrhiniflora	ARG(CAT, COR, LRI, MEN, SDE, SJU, SLU)
Maurandya barclaiana	ARG(COR, JUJ, SAL, TUC)
Maurandya erubescens	BRA(SCA)
Mauria thaumatophylla	ARG(JUJ, SAL)
Maxillaria acicularis	BRA(PAR)
Maxillaria bradei	BRA(PAR, SCA)
Maxillaria brasiliensis	BRA(PAR, RGS, SCA)
Maxillaria cerifera	BRA(PAR, SCA)
Maxillaria chlorantha	BRA(PAR)
Maxillaria chrysantha	ARG(MIS) / BRA(PAR, SCA)
Maxillaria cleistogama	BRA(PAR, RGS, SCA)
Maxillaria consanguinea var. pallida	BRA(PAR)
Maxillaria crassifolia	BRA(PAR)
Maxillaria desvauxiana	BRA(PAR, SCA)
Maxillaria discolor	BRA(PAR)
Maxillaria echinophyta	BRA(PAR)
Maxillaria ferdinandiana	BRA(PAR, RGS, SCA)
Maxillaria gracilis	BRA(PAR, RGS, SCA)
Maxillaria guareimensis	BRA(PAR)
Maxillaria imbricata	BRA(PAR, SCA)
Maxillaria johannis	BRA(PAR, SCA)
Maxillaria juergensii	BRA(PAR, RGS, SCA)
Maxillaria kautskyi	BRA(PAR)
Maxillaria leucaimata var. longifolia	BRA(PAR, SCA)
Maxillaria leucaimata var. leucaimata	BRA(PAR, SCA)
Maxillaria lindleyana	BRA(PAR, RGS, SCA)
Maxillaria madida	BRA(PAR, RGS, SCA)
Maxillaria marginata	BRA(PAR, RGS, SCA)
Maxillaria minuta	BRA(PAR)
Maxillaria neuwiedii	BRA(PAR, SCA)
Maxillaria notylioglossa	BRA(PAR)
Maxillaria ochroleuca	BRA(PAR, SCA)
Maxillaria pachyphylla	BRA(PAR, SCA)
Maxillaria parahybunensis	BRA(PAR)
Maxillaria paranaensis	BRA(PAR)
Maxillaria parviflora	BRA(PAR)
Maxillaria paulistana	BRA(PAR)
Maxillaria phoenicanthera	BRA(PAR)
Maxillaria plebeja	BRA(PAR, RGS, SCA)
Maxillaria porphyrostele	BRA(PAR, RGS, SCA)
Maxillaria porrecta	BRA(PAR)
Maxillaria pumila	BRA(PAR)
Maxillaria rigida	BRA(PAR)
Maxillaria serotina	BRA(PAR)
Maxillaria spegazziniana	ARG(MIS) / BRA(PAR)
Maxillaria ubatubana var. ubatubana	BRA(SCA)
Maxillaria ubatubana var. mantiqueirana	BRA(PAR, SCA)
Maxillaria valenzuelana	BRA(PAR, SCA)
Maxillaria vernicosa	BRA(PAR, RGS, SCA)
Maxillaria vitelliniflora	ARG(MIS) / BRA(PAR, RGS, SCA)
Mayaca fluviatilis f. fluviatilis	ARG(COS, FOR) / BRA(PAR, SCA) / PRY(CAU, CAN, CON, GUA, MIE, ÑEE, PAI)
Mayaca fluviatilis f. kunthii	BRA(Fuera del área del proyecto) / URY(RIV)
Mayaca sellowiana	ARG(CHA, COS, FOR, MIS) / BRA(PAR, RGS, SCA) / PRY(APA, AMA, CAU, CAA, CAN, COA, GUA, MIE, PAI, SPE) / URY(RIV, TAC)
Maytenus boaria	ARG(CHU, COR, MEN, MIS, NEU, RNE, SJU, SLU, SCR, TDF, TUC) / BRA(PAR, RGS, SCA) / CHL(ATA, COQ, VAL, LBO, MAU, BIO, ARA, LLA, AIS, MAG, RME)
Maytenus cassineformis	BRA(RGS) / URY(TYT)
Maytenus chubutensis	ARG(CHU, NEU, RNE) / CHL(MAU, BIO, ARA, LLA, AIS)
Maytenus dasyclados	BRA(RGS) / URY(CLA, ROC, TAC, TYT)
Maytenus disticha	ARG(CHU, NEU, RNE, SCR, TDF) / CHL(MAU, BIO, ARA, LLA, AIS, MAG)
Maytenus evonymoides	ARG(MIS) / BRA(PAR, RGS, SCA) / PRY(AMA)
Maytenus ilicifolia	ARG(BAI, CHA, COS, ERI, FOR, MIS, SAL, SFE) / BRA(PAR, RGS, SCA) / PRY(APY, CAN, CEN, COA, GUA, MIE, ÑEE, PAI, PHA, SPE) / URY(CAS, COL, DUR, FLA, MAL, PAY, RIV, ROC, SAO, SJO, SOR, TAC, TYT)
Maytenus littoralis	BRA(PAR)
Maytenus magellanica	ARG(CHU, NEU, RNE, SCR, TDF) / CHL(MAU, BIO, ARA, LLA, AIS, MAG)
Maytenus robusta	BRA(PAR, SCA)
Maytenus spinosa	ARG(BAI, CHA, COR, COS, ERI, FOR, JUJ, LPA, LRI, SAL, SLU, SFE, SDE, TUC) / PRY(APY, BOQ, PHA)
Maytenus verticillata	ARG(JUJ, SAL)
Maytenus viscifolia	ARG(CAT, COR, JUJ, LRI, SAL, SDE, SJU, TUC)
Maytenus vitis-idaea	ARG(BAI, CAT, CHA, COR, COS, ERI, FOR, JUJ, LPA, LRI, RNE, SAL, SJU, SLU, SFE, SDE, TUC) / PRY(APY, PHA) / URY(RNO, SOR)
Mazus japonicus	ARG(BAI, TUC) / BRA(PAR, SCA)
Mecardonia berroi	URY(ART, PAY)
Mecardonia grandiflora	ARG(MIS) / BRA(PAR, RGS, SCA)
Mecardonia kamogawae	ARG(COS)
Mecardonia procumbens var. caespitosa	BRA(PAR, RGS, SCA)
Mecardonia procumbens var. procumbens	ARG(CAT, COR, FOR, JUJ, LRI, SAL, SDE, TUC) / BRA(PAR, RGS, SCA) / CHL(MAU)
Mecardonia procumbens var. herniarioides	ARG(COS, ERI, MIS) / BRA(PAR, RGS, SCA) / PRY(ITA, ÑEE) / URY(COL)
Mecardonia procumbens var. tenella	ARG(BAI, COS, ERI, MIS, SFE) / BRA(PAR, RGS, SCA) / PRY(APY, APA, COA, GUA, ITA, MIE, ÑEE, PAI) / URY(ART, CAS, CLA, DUR, FLA, LAV, MAL, PAY, RIV, ROC, SOR, TAC, TYT)
Mecardonia procumbens var. flagellaris	ARG(BAI, CHA, CHU, COR, COS, ERI, FOR, LPA, MIS, NEU, RNE, SFE, SLU) / BRA(PAR, RGS, SCA) / CHL(LBO, MAU) / PRY(APY, BOQ, CEN, CON, COA, GUA, ÑEE, PAI, PHA, SPE) / URY(ART, CAS, CLA, COL, DUR, FLA, LAV, ROC, SJO, SOR, TAC, TYT)
Mecardonia pubescens	BRA(RGS)
Mecardonia serpylloides	ARG(COS, ERI, MIS, SFE) / BRA(PAR, RGS, SCA)
Medicago arabica	ARG(BAI, ERI, LPA, RNE, TDF) / BRA(RGS) / CHL(VAL) / URY(CAS, COL, FLA, MAL, MON, RNO)
Medicago arborea	CHL(MAU, RME) / URY(MON)
Medicago falcata	ARG(SCR)
Medicago intertexta	URY(FLA, MON)
Medicago lupulina	ARG(BAI, CAT, CHA, CHU, COR, COS, DFE, ERI, FOR, JUJ, LPA, LRI, MEN, MIS, NEU, RNE, SAL, SCR, SDE, SFE, SJU, SLU, TDF, TUC) / BRA(PAR, RGS) / CHL(ANT, COQ, VAL, LBO, MAU, BIO, ARA, LLA, RME, JFE, IPA) / URY(CAS, CLA, COL, LAV, MAL, MON, PAY, SJO)
Medicago minima var. minima	ARG(BAI, COR, ERI, LPA, RNE) / CHL(COQ, VAL, LBO, ARA, RME) / URY(CAS, CLA, COL, DUR, FLO, FLA, LAV, MAL, MON, PAY, RIV, ROC, SAO, SJO, SOR, TYT)
Medicago minima var. brevispina	ARG(BAI, ERI, LPA) / URY(RNO)
Medicago polymorpha var. brevispina	ARG(BAI, COR, LPA, RNE, SFE) / URY(MON)
Medicago polymorpha var. vulgaris	ARG(BAI, CHU, COS, ERI, LPA, RNE, SCR, SFE) / BRA(RGS) / CHL(VAL) / URY(MON)
Medicago polymorpha var. polymorpha	ARG(BAI, LRI) / BRA(RGS, SCA) / CHL(TAR, ANT, ATA, COQ, VAL, LBO, MAU, BIO, ARA, LLA, RME, JFE, IPA) / URY(CAS, CLA, COL, FLO, MAL, MON, PAY, RNO, SAO, SJO, SOR)
Medicago polymorpha var. confinis	ARG(BAI, ERI, RNE, SCR) / URY(COL, FLA, LAV, MON, RNO, SOR)
Medicago sativa	ARG(BAI, CHU, COR, COS, ERI, JUJ, LPA, LRI, MEN, NEU, RNE, SCR, SFE, SJU, TDF) / BRA(RGS, SCA) / CHL(TAR, ANT, ATA, COQ, VAL, LBO, MAU, BIO, ARA, LLA, AIS, MAG, RME, JFE) / URY(CAS, COL, MON, SJO)
Medicago scutellata	ARG(BAI) / URY(FLA, MON, SOR)
Medicago truncatula	ARG(BAI, RNE) / URY(MAL, MON, RNO)
Megalachne berteroana	CHL(JFE)
Megalachne masafuerana	CHL(JFE)
Megalastrum abundans	BRA(PAR, RGS, SCA)
Megalastrum adenopteris	ARG(JUJ, SAL, TUC) / BRA(RGS, SCA)
Megalastrum albidum	BRA(PAR) / PRY(CAA)
Megalastrum brevipubens	BRA(Fuera del área del proyecto) / PRY(AMA, GUA)
Megalastrum ciliatum	ARG(JUJ)
Megalastrum connexum	ARG(COS, MIS) / BRA(PAR, RGS, SCA) / PRY(APA, AMA, CAA, CAN, CEN, COA, PAI) / URY(CLA, RIV, TAC)
Megalastrum crenulans	ARG(MIS) / BRA(PAR, RGS, SCA) / PRY(AMA, CEN)
Megalastrum fugaceum	ARG(JUJ, SAL, TUC)
Megalastrum glabrius	CHL(JFE)
Megalastrum inaequale	BRA(PAR, RGS, SCA)
Megalastrum inaequalifolium	CHL(JFE)
Megalastrum masafuerae	CHL(JFE)
Megalastrum oreocharis	BRA(PAR, RGS, SCA) / URY(CLA, TAC)
Megalastrum spectabile	ARG(CHU, NEU, RNE) / CHL(COQ, VAL, LBO, BIO, ARA, LLA, AIS)
Megalastrum substrigosum	ARG(MIS)
Megalastrum umbrinum	BRA(PAR, RGS, SCA) / PRY(AMA)
Megalastrum wacketii	BRA(PAR)
Megathyrsus maximus var. maximus	ARG(BAI, CHA, COS, DFE, ERI, FOR, JUJ, MIS, SAL, SLU, SFE, SDE, TUC) / BRA(PAR, RGS, SCA) / PRY(APA, CAA, CEN, COA, GUA, PAI)
Megathyrsus maximus var. pubiglumis	ARG(BAI, CHA, FOR, MIS) / BRA(RGS)
Melananthus multiflorus	ARG(COS) / BRA(RGS)
Melancium campestre	ARG(COS, MIS) / BRA(PAR, SCA) / PRY(APA, AMA, CAU)
Melanthera latifolia	ARG(CHA, COS, ERI, FOR, MIS, SAL, SFE) / BRA(PAR, RGS, SCA) / PRY(APY, APA, AMA, CAA, CEN) / URY(ART, PAY, RNO, SAO)
Melasma melampyroides	ARG(COS, MIS) / BRA(PAR, RGS, SCA) / PRY(AMA, MIE, PAI)
Melasma rhinanthoides	ARG(COS, ERI, FOR, MIS) / BRA(PAR, RGS, SCA) / PRY(AMA, CAU, COA, GUA) / URY(RNO, ROC, TAC, TYT)
Melasma stricta	ARG(COS) / BRA(Fuera del área del proyecto) / PRY(AMA, CAU, SPE)
Melia azedarach	ARG(BAI, CHA, COR, COS, ERI, JUJ, LPA, MIS, SAL, SDE, SFE) / BRA(PAR, RGS) / PRY(PAI) / URY(PAY, RNO)
Melica animarum	URY(MAL)
Melica argentata	CHL(COQ, VAL, LBO, MAU, RME)
Melica argyrea	ARG(BAI, CHA, COR, COS, ERI, LPA, SJU, SLU, SFE, SDE) / BRA(RGS) / URY(CLA, COL, MON, PAY, RNO, SOR)
Melica arzivencoi	BRA(RGS)
Melica bonariensis	ARG(BAI, LPA, RNE, SLU)
Melica brasiliana	ARG(BAI, COR, COS, ERI, LPA, MIS, SLU, SFE) / BRA(PAR, RGS, SCA) / URY(ART, CAS, CLA, COL, FLA, LAV, MON, PAY, RNO, SAO, SJO, SOR, TYT)
Melica brevicoronata	BRA(RGS) / URY(FLO, FLA, LAV, MAL, SJO, TYT)
Melica cepacea	ARG(NEU) / CHL(LBO, MAU, RME)
Melica chilensis	ARG(CAT, JUJ, LPA, LRI, MEN, SAL, SJU, SLU, TUC)
Melica commersonii	CHL(ARA)
Melica decipiens	ARG(COR, SLU)
Melica eremophila	ARG(BAI, COR, ERI, SLU, SFE) / BRA(RGS, SCA) / URY(ART, COL, LAV, MAL, MON, RIV, TAC, TYT)
Melica glabrescens	ARG(BAI, CHU, RNE)
Melica hyalina	ARG(BAI, ERI) / BRA(PAR, RGS, SCA) / URY(CAS, CLA, FLO, FLA, MAL, MON, PAY, SJO, SOR, TAC)
Melica lilloi	ARG(CAT, TUC)
Melica longiflora	CHL(COQ, VAL, LBO, MAU, BIO, RME)
Melica macra	ARG(BAI, CAT, CHA, COR, COS, DFE, ERI, FOR, LPA, SLU, SFE, SDE, TUC) / BRA(PAR, RGS, SCA) / URY(ART, CAS, COL, FLA, LAV, MON, PAY, RNO, RIV, SAO, SJO, SOR, TAC)
Melica mollis	CHL(ATA)
Melica parodiana	ARG(BAI) / URY(CAS, LAV, MAL, RIV)
Melica patagonica	ARG(CHU, NEU, RNE)
Melica paulsenii	CHL(COQ, VAL, MAU, RME)
Melica poecilantha	CHL(COQ)
Melica rigida	ARG(BAI, ERI, LPA, RNE, SFE) / BRA(RGS, SCA) / URY(ART, CAS, CLA, COL, FLO, FLA, LAV, MAL, MON, PAY, RNO, RIV, SAO, SJO, SOR, TAC, TYT)
Melica riograndensis	BRA(RGS)
Melica sarmentosa var. pilosula	ARG(COS, ERI, MIS, SFE) / BRA(RGS, SCA) / PRY(APA, GUA, ITA)
Melica sarmentosa var. monticola	ARG(CAT, JUJ, SAL, TUC)
Melica sarmentosa var. sarmentosa	ARG(BAI, CAT, CHA, COS, ERI, MIS, SFE, TUC) / BRA(PAR, RGS, SCA) / PRY(APA, CAA, PAI) / URY(ART, CAS, COL, FLA, LAV, MAL, MON, PAY, RNO, ROC, SAO, SJO, SOR, TAC, TYT)
Melica serrana	URY(MAL)
Melica spartinoides	BRA(RGS, SCA)
Melica stuckertii	ARG(BAI, CAT, COR, LRI, MEN, SJU, SLU, SDE)
Melica tenuis	ARG(ERI, MIS) / BRA(PAR, RGS, SCA) / PRY(GUA, ITA) / URY(LAV, MAL, MON, PAY, SJO)
Melica violacea	CHL(VAL, LBO, MAU, BIO, ARA, LLA, RME)
Melicoccus lepidopetalus	ARG(FOR, MIS) / BRA(Fuera del área del proyecto) / PRY(APY, AMA, CEN, CON, COA, GUA, PAI, PHA, SPE)
Melilotus albus	ARG(BAI, CHA, CHU, COR, COS, ERI, JUJ, LPA, MEN, MIS, NEU, RNE, SAL, SJU, SLU, SCR, SFE, SDE, TUC) / BRA(RGS) / CHL(TAR, COQ, VAL, LBO, MAU, BIO, AIS, MAG, RME) / PRY(APY) / URY(CAS, MAL, MON, PAY, RNO)
Melilotus indicus	ARG(BAI, CAT, CHA, COR, COS, ERI, JUJ, LPA, MEN, NEU, RNE, SAL, SCR, SDE, SFE, SJU, TDF, TUC) / BRA(RGS) / CHL(TAR, ANT, ATA, COQ, VAL, LBO, MAU, BIO, ARA, LLA, AIS, RME, JFE, IPA) / URY(CAS, CLA, COL, LAV, MAL, MON, PAY, RNO, SJO, SOR)
Melilotus messanensis	ARG(BAI) / URY(MON, SJO)
Melilotus officinalis	ARG(BAI, CHU, ERI, LPA, MEN, NEU, RNE, SCR, SFE) / CHL(VAL, LBO, MAG, RME) / URY(MON)
Melinis minutiflora	ARG(COS, MIS) / BRA(PAR, RGS, SCA) / PRY(PAI)
Melinis repens	ARG(COR, COS, ERI, JUJ, MIS, SAL, SLU, SFE, TUC) / BRA(PAR, RGS, SCA) / PRY(APA, APY, AMA, BOQ, CAN, CEN, CON, COA, GUA, MIE, PAI, PHA, SPE) / URY(SAO)
Meliosma sellowii	BRA(PAR, RGS, SCA)
Melissa officinalis	ARG(BAI, CAT, CHU, COR, COS, ERI, JUJ, MEN, NEU, SAL) / CHL(COQ, VAL, LBO, MAU, BIO, ARA, LLA, RME, JFE) / URY(CLA, MON)
Melochia anomala	ARG(CAT, CHA, COR, COS, FOR, JUJ, SAL, SDE, SFE, TUC)
Melochia arenosa	BRA(Fuera del área del proyecto) / PRY(APY, CON, COA, ÑEE)
Melochia argentina	ARG(COR, JUJ, MIS, SAL, TUC) / PRY(PAI)
Melochia canescens	ARG(CHA, FOR, SAL) / PRY(APY, BOQ, ÑEE)
Melochia chamaedrys var. chamaedrys	ARG(COS, MIS) / BRA(PAR, RGS, SCA) / PRY(CAA, COA, ITA) / URY(ART, RIV, SAO, SJO, TAC)
Melochia chamaedrys var. decumbens	ARG(COS, MIS) / BRA(RGS) / PRY(CON) / URY(RIV, SAO, TAC)
Melochia goldbergii	ARG(JUJ, MIS, SAL) / PRY(APY)
Melochia graminifolia	BRA(Fuera del área del proyecto) / PRY(AMA, CON)
Melochia hassleriana	ARG(COS, MIS) / BRA(PAR, RGS) / PRY(AMA, CAU, CAN, CEN, CON, COA, GUA, MIE, PAI, SPE)
Melochia hermannioides	ARG(CHA, COS, ERI, FOR, MIS, SFE) / PRY(CAU, CAN, CEN, CON, COA, GUA, MIE, ÑEE, PAI, PHA, SPE)
Melochia ministella	ARG(CHA, FOR) / PRY(APY, CON, PHA)
Melochia morongii	ARG(MIS) / BRA(Fuera del área del proyecto) / PRY(AMA, CAN, CEN, CON, COA, GUA, PAI)
Melochia parvifolia var. parvifolia	BRA(Fuera del área del proyecto) / PRY(APY, CAN, PHA)
Melochia parvifolia var. fasciculata	BRA(Fuera del área del proyecto) / PRY(APY, CEN, CON, PHA)
Melochia pilosa	ARG(CHA, COS, ERI, FOR, MIS, SAL, TUC) / BRA(PAR, RGS, SCA) / PRY(APY, APA, AMA, CAU, CAA, CAN, CON, COA, GUA, ITA, MIE, ÑEE, PAI, SPE) / URY(RIV)
Melochia pyramidata var. hieronymi	ARG(CAT, CHA, COS, FOR, JUJ, MIS, SAL, SDE, SFE, TUC) / BRA(RGS) / PRY(APY, CAU, CAA, CAN, CEN, CON, COA, GUA, MIE, ÑEE, PAI, PHA, SPE)
Melochia pyramidata var. pyramidata	ARG(CHA, COS, ERI, FOR, MIS, SAL, SDE, SFE) / BRA(PAR, RGS) / PRY(APY, AMA, CEN, CON, ITA, MIE, PAI, PHA, SPE) / URY(CLA, SOR)
Melochia simplex	ARG(COS, MIS) / BRA(PAR, RGS) / PRY(AMA, CAU, CAA, CON, COA, ITA, SPE)
Melochia thymifolia	ARG(JUJ, TUC)
Melochia villosa var. tomentosa	ARG(COS, FOR, MIS) / BRA(RGS, SCA) / PRY(APA, AMA, CAU, CAA, CAN, CEN, CON, COA, GUA, MIE, PAI, SPE)
Melochia villosa var. villosa	ARG(MIS) / PRY(APA)
Melochia werdermannii	BRA(Fuera del área del proyecto) / PRY(APY, PHA)
Melosperma andicola	ARG(CHU, MEN, NEU, RNE, SJU) / CHL(COQ, VAL, LBO, MAU, BIO, RME)
Melosperma angustifolia	ARG(MEN, NEU, RNE) / CHL(ARA)
Melothria candolleana	ARG(CHA, COS, ERI, FOR, SFE) / BRA(RGS) / PRY(CEN, CON, COA, GUA, PHA)
Melothria cucumis	ARG(CHA, COS, ERI, FOR, MIS, SFE) / BRA(PAR, RGS, SCA) / PRY(CAA, CAN) / URY(CAS, MON)
Melothria pendula	ARG(COS, FOR, JUJ, MIS, SAL) / BRA(PAR, RGS) / PRY(APA, AMA, CAN, CEN, COA, ITA, ÑEE, PAI, PHA)
Melothria schulziana	ARG(CHA, COS, FOR, SFE) / PRY(CEN)
Melothria uliginosa	BRA(PAR, SCA) / PRY(APA, COA, PAI, PHA)
Melothria warmingii	ARG(CHA, COS, JUJ, MIS) / BRA(Fuera del área del proyecto) / PRY(APA, AMA, CAA, CEN, COA, GUA, ITA, MIE, ÑEE, PAI, SPE)
Melpomene albicans	BRA(PAR)
Melpomene melanosticta	BRA(PAR)
Melpomene peruviana	ARG(BAI, CAT, COR, JUJ, SAL, SLU, TUC) / BRA(SCA)
Melpomene xiphopteroides var. acrodonta	BRA(PAR, RGS, SCA)
Mendoncia puberula	BRA(PAR, RGS, SCA)
Mendoncia velloziana	BRA(PAR, RGS, SCA) / PRY(AMA, PHA)
Menodora decemfida	ARG(CAT, LRI, MEN, SJU)
Menodora integrifolia var. integrifolia	ARG(COR, COS, ERI, MIS, SFE) / BRA(RGS) / PRY(AMA) / URY(FLA, TAC)
Menodora integrifolia var. pinnatisecta	ARG(CHA, COS, ERI, FOR, SFE) / PRY(PAI)
Menodora linoides	CHL(COQ, VAL)
Menodora pulchella	ARG(JUJ)
Menodora robusta	ARG(CHU, LPA, MEN, NEU, RNE, SCR)
Menodora trifida	ARG(BAI, CAT, CHA, CHU, COR, COS, ERI, JUJ, LPA, LRI, MEN, NEU, RNE, SAL, SJU, SLU, SFE, SDE, TUC) / PRY(AMA, CEN, GUA, PAI) / URY(TAC)
Menonvillea chilensis	CHL(ANT, ATA, COQ, VAL)
Menonvillea cicatricosa	ARG(MEN) / CHL(LBO, MAU)
Menonvillea comberi	ARG(NEU, RNE) / CHL(ARA)
Menonvillea constitutionis	CHL(VAL, MAU, RME)
Menonvillea cuneata	ARG(CAT, LRI, MEN, NEU, SJU) / CHL(ATA, COQ, VAL, LBO, RME)
Menonvillea famatinensis	ARG(LRI, SJU)
Menonvillea filifolia ssp. filifolia	CHL(COQ, VAL, LBO, RME)
Menonvillea flexuosa	CHL(ATA, COQ, VAL, RME)
Menonvillea frigida	CHL(ANT)
Menonvillea linearis	CHL(COQ, VAL, LBO, MAU, BIO, RME)
Menonvillea litoralis	CHL(ATA, COQ)
Menonvillea macrocarpa	CHL(ATA)
Menonvillea marticorenae	CHL(ANT, ATA, COQ, VAL)
Menonvillea minima	CHL(ATA)
Menonvillea nordenskjoeldii	ARG(CHU, RNE, SCR) / CHL(AIS, MAG)
Menonvillea orbiculata	CHL(ANT, ATA, COQ)
Menonvillea patagonica	ARG(CHU, NEU, RNE)
Menonvillea pinnatifida	CHL(ANT, ATA, COQ, RME)
Menonvillea purpurea	CHL(COQ, VAL, LBO, MAU, RME)
Menonvillea rigida	ARG(NEU, RNE)
Menonvillea scapigera ssp. longipes	ARG(LRI, MEN, NEU, SJU) / CHL(ATA, COQ, LBO, MAU, BIO, RME)
Menonvillea scapigera ssp. scapigera	ARG(MEN, NEU, SCR, SJU)
Menonvillea spathulata	ARG(MEN) / CHL(VAL, RME)
Menonvillea virens	ARG(CAT, JUJ, LRI, SAL, SJU, TUC) / CHL(TAR, ANT, ATA)
Menonvillea zuloagaensis	ARG(SJU)
Mentha aquatica	ARG(BAI, COR, MEN, TUC) / BRA(PAR) / CHL(ANT, COQ, VAL, LBO, MAU, BIO, ARA, RME, JFE) / URY(CAS, MON)
Mentha pulegium	ARG(BAI, CHU, COR, ERI, JUJ, MEN, MIS, NEU, RNE, SAL) / CHL(COQ, VAL, LBO, MAU, BIO, ARA, LLA, RME, JFE) / URY(MON, TAC)
Mentha spicata	ARG(BAI, CHU, COR, COS, ERI, LRI, MEN, NEU, RNE, SAL, TUC) / BRA(RGS)
Mentha suaveolens	CHL(ANT, ATA, VAL, LBO, BIO, ARA, LLA, RME) / PRY(CEN)
Mentzelia albescens	ARG(BAI, CAT, COR, LPA, LRI, MEN, NEU, RNE, SJU, SLU, TUC) / CHL(ATA, COQ, VAL, RME) / URY(SOR)
Mentzelia aspera	ARG(JUJ, MEN, SAL, TUC) / PRY(APY)
Mentzelia bartonioides	ARG(MEN, NEU, SJU) / CHL(ATA, COQ)
Mentzelia parvifolia	ARG(CAT, CHA, COR, FOR, JUJ, LPA, LRI, MEN, SAL, SDE, SFE, SJU, SLU, TUC)
Mentzelia scabra ssp. chilensis	CHL(COQ)
Mentzelia scabra ssp. atacamensis	CHL(ANT, COQ)
Mentzelia scabra ssp. cordobensis	ARG(COR, JUJ, SAL, TUC)
Mercurialis annua	ARG(BAI, MEN, TDF) / CHL(VAL)
Merostachys caucaiana	BRA(RGS)
Merostachys ciliata	BRA(SCA)
Merostachys claussenii	ARG(MIS) / BRA(PAR, RGS, SCA) / PRY(APA, AMA, CAA, GUA)
Merostachys fischeriana	BRA(PAR)
Merostachys glauca	BRA(SCA)
Merostachys kleinii	BRA(SCA)
Merostachys kunthii	BRA(PAR)
Merostachys multiramea	ARG(MIS) / BRA(PAR, RGS, SCA)
Merostachys petiolata	BRA(PAR, RGS, SCA)
Merostachys pilifera	BRA(RGS)
Merostachys pluriflora	BRA(SCA)
Merostachys skvortzovii	BRA(PAR, RGS, SCA)
Merostachys speciosa	BRA(PAR, RGS, SCA)
Merostachys ternata	BRA(PAR, RGS, SCA)
Merostachys vestita	BRA(SCA)
Merremia aegyptia	ARG(FOR, JUJ, MIS, SAL) / BRA(Fuera del área del proyecto) / PRY(APY, AMA)
Merremia cissoides	ARG(COS, MIS, SAL) / BRA(PAR, RGS) / PRY(APA, APY, CAN, CON, COA, PAI, PHA)
Merremia contorquens	BRA(PAR)
Merremia digitata var. digitata	BRA(PAR)
Merremia digitata var. elongata	BRA(PAR)
Merremia dissecta var. dissecta	ARG(CHA, COS, JUJ, MIS, SAL, SDE, TUC) / PRY(COA, ITA, PAI, SPE) / URY(ART, PAY)
Merremia dissecta var. edentata	ARG(CAT, CHA, COS, ERI, JUJ, MIS, SAL, SFE, TUC) / BRA(PAR, RGS, SCA) / PRY(APA, CAA, CEN, COA, GUA, PAI)
Merremia hassleriana	ARG(MIS) / BRA(PAR) / PRY(APA, AMA, CAU, CON)
Merremia macrocalyx	ARG(MIS) / BRA(PAR, SCA) / PRY(APY, AMA, CAN, COA, GUA)
Merremia tomentosa	BRA(PAR)
Merremia umbellata	ARG(FOR, MIS, SAL) / BRA(PAR) / PRY(APY, CEN, CON)
Mesadenella cuspidata	ARG(COS, MIS) / BRA(PAR, RGS, SCA) / PRY(CAN, COA) / URY(Desconocida)
Mesechites mansoana	BRA(Fuera del área del proyecto) / PRY(AMA, CEN)
Mesechites trifidus	ARG(CHA, COS, FOR, JUJ, SAL, SFE) / BRA(Fuera del área del proyecto) / PRY(APY, AMA, CAN, CEN, CON, COA, PAI, PHA, SPE)
Mesembryanthemum crystallinum	ARG(CHU, RNE) / CHL(ANT, ATA, COQ, VAL, IDE)
Mesembryanthemum nodiflorum	ARG(CHU, NEU, RNE, SCR) / CHL(ATA, COQ)
Mesosetum chaseae	BRA(Fuera del área del proyecto) / PRY(AMA)
Mesosetum comatum	ARG(MIS)
Mesosetum ferrugineum	BRA(PAR)
Mesosphaerum pectinatum	BRA(PAR, SCA)
Metalepis cubensis	ARG(MIS) / BRA(RGS, SCA)
Metastelma microgynostegia	ARG(JUJ)
Metastelma oranensis	ARG(JUJ, SAL)
Metastelma parviflorum	ARG(CAT, COR, LRI, SAL, SLU, SDE, TUC) / PRY(APY)
Metharme lanata	CHL(TAR)
Metrodorea nigra	BRA(PAR)
Miconia albicans	BRA(PAR) / PRY(AMA, CAN, PAI)
Miconia amambayensis	PRY(AMA)
Miconia brasiliensis	BRA(SCA)
Miconia budlejoides	BRA(PAR, SCA)
Miconia cabucu	BRA(PAR, SCA)
Miconia calvescens	ARG(JUJ, MIS, SAL) / BRA(PAR, SCA) / PRY(AMA, CON, COA, PAI)
Miconia chamissois	ARG(COS) / BRA(PAR) / PRY(CAN, CEN, COA, GUA, ITA, PAI)
Miconia chartacea	BRA(PAR, SCA)
Miconia cinerascens	ARG(MIS) / BRA(PAR, RGS, SCA) / PRY(CAU, CAA, CAN, GUA, PAI)
Miconia cinnamomifolia	BRA(PAR, SCA)
Miconia collatata	ARG(MIS) / BRA(PAR) / PRY(AMA, COA, GUA)
Miconia cubatanensis	BRA(PAR, RGS, SCA)
Miconia discolor	ARG(MIS) / BRA(PAR, SCA) / PRY(APA, APY, CAA, CAN)
Miconia dodecandra	BRA(PAR)
Miconia eichleri	BRA(PAR, SCA)
Miconia fasciculata	BRA(PAR, SCA)
Miconia flammea	BRA(SCA)
Miconia hyemalis	BRA(PAR, RGS, SCA) / URY(ART, RIV)
Miconia ibaguensis	BRA(PAR) / PRY(SPE)
Miconia inaequidens	BRA(SCA)
Miconia inconspicua	BRA(PAR, SCA)
Miconia ioneura	ARG(JUJ, SAL, TUC)
Miconia jucunda	BRA(PAR, SCA)
Miconia lagunensis	BRA(SCA)
Miconia latecrenata	BRA(RGS, SCA)
Miconia ligustroides	BRA(PAR, RGS, SCA)
Miconia lymanii	BRA(PAR, SCA)
Miconia molybdaea	ARG(JUJ, SAL)
Miconia paniculata	BRA(PAR, SCA)
Miconia paraguayensis	PRY(AMA, CON)
Miconia paucidens	BRA(PAR) / PRY(APA, AMA, CAU, SPE)
Miconia petropolitana	ARG(MIS) / BRA(PAR, SCA) / PRY(CAN)
Miconia prasina	BRA(PAR) / PRY(AMA, CON)
Miconia pusilliflora	ARG(COS, MIS) / BRA(PAR, RGS, SCA) / PRY(APA, CAA, CAN, GUA)
Miconia racemifera	BRA(SCA)
Miconia ramboi	BRA(PAR, RGS, SCA)
Miconia sellowiana	BRA(PAR, RGS, SCA)
Miconia splendens	BRA(PAR)
Miconia staminea	ARG(COS) / BRA(Fuera del área del proyecto) / PRY(APY, CAN, CEN, GUA, PAI, SPE)
Miconia stenostachya	BRA(PAR) / PRY(AMA, CAN)
Miconia theizans	BRA(PAR, SCA) / PRY(AMA, CAN, PAI)
Miconia tristis	BRA(PAR, SCA)
Miconia valtheri	BRA(PAR)
Miconia willdenowii	BRA(PAR)
Micranthemum tweediei	ARG(BAI, COS, ERI, FOR, MIS) / URY(COL, RNO)
Micranthemum umbrosum	ARG(BAI, COR, COS, ERI, MIS, SFE, TUC) / BRA(PAR, RGS, SCA) / PRY(APY) / URY(LAV, MAL, MON, RIV, ROC, SJO, SOR, TYT)
Microchilus arietinus	ARG(MIS) / BRA(PAR, RGS, SCA)
Microchilus austrobrasiliensis	BRA(PAR, SCA)
Microchilus pedrojuanensis	BRA(Fuera del área del proyecto) / PRY(AMA)
Microchloa indica var. indica	ARG(BAI, CAT, COR, COS, ERI, JUJ, LRI, MIS, SAL, SJU, SLU, SFE, TUC) / BRA(RGS, SCA) / CHL(TAR) / PRY(PAI) / URY(ART, LAV, PAY, RNO)
Microchloa kunthii	ARG(JUJ, MIS) / BRA(PAR) / CHL(TAR)
Microgramma geminata	BRA(PAR)
Microgramma lindbergii	ARG(MIS) / BRA(PAR) / PRY(APA, AMA, CAN, COA, GUA, PAI, SPE)
Microgramma mortoniana	ARG(BAI, COS, JUJ, MIS, SAL, TUC) / BRA(RGS) / PRY(PAI) / URY(COL)
Microgramma percussa	BRA(PAR, SCA)
Microgramma persicariifolia	BRA(Fuera del área del proyecto) / PRY(APA, CAN, CON, SPE)
Microgramma squamulosa	ARG(CAT, CHA, COS, JUJ, MIS, SAL, TUC) / BRA(PAR, RGS, SCA) / PRY(APA, CAA, CAN) / URY(ART, CLA, LAV, MAL, RNO, RIV, ROC, SAO, SJO, TAC, TYT)
Microgramma tecta	BRA(PAR, SCA)
Microgramma vacciniifolia	ARG(BAI, CHA, COR, COS, ERI, FOR, MIS, SFE) / BRA(PAR, RGS, SCA) / PRY(APY, CAA, CAN, CON, ÑEE, PAI, PHA) / URY(ART, CLA, MAL, RIV, ROC, SAO, TAC)
Microgyne marchesiana	URY(TAC)
Microgyne trifurcata	ARG(BAI, CAT, COR, COS, ERI, LPA, SDE, SFE, SLU) / URY(CAS, CLA, COL, DUR, FLA, MAL, MON, PAY, RNO, SAO, SJO, SOR, TAC)
Microlaelia lundii	ARG(MIS, SAL) / BRA(Fuera del área del proyecto) / PRY(APA, GUA)
Microlepia speluncae	BRA(SCA) / PRY(APA, CEN, GUA, PAI)
Microlepis oleifolia	BRA(PAR)
Microliabum candidum	ARG(CAT, COR, LRI, SLU, TUC)
Microliabum eremophilum	ARG(LRI, SAL, TUC)
Microliabum glanduliferum	ARG(COR, SLU)
Microliabum humile	ARG(JUJ, SAL)
Microliabum mulgediifolium	ARG(JUJ, SAL)
Microliabum polymnioides	ARG(CAT, JUJ, SAL, TUC)
Microlicia myrtoidea	BRA(PAR)
Microlobius foetidus ssp. paraguensis	ARG(CHA, FOR) / BRA(Fuera del área del proyecto) / PRY(APY, BOQ, CEN, CON, ÑEE, PAI, PHA)
Microphyes litoralis	CHL(TAR, ANT)
Microphyes minima	CHL(COQ, VAL, BIO, RME)
Microphyes robusta var. robusta	CHL(COQ)
Microphyes robusta var. pallida	CHL(ATA)
Micropolypodium achilleifolium	ARG(MIS) / BRA(PAR, RGS, SCA)
Micropolypodium gradatum	BRA(PAR, SCA)
Micropolypodium setosum	BRA(PAR, SCA)
Micropsis australis	ARG(BAI, COS, LPA, RNE)
Micropsis dasycarpa	ARG(BAI, CHA, COS, ERI, FOR, MIS, SFE) / BRA(RGS) / PRY(CAU, CEN, COA, MIE, PAI) / URY(ART, CLA, COL, FLA)
Micropsis nana	CHL(COQ, VAL, LBO, MAU, BIO, ARA, RME, JFE)
Micropsis ostenii	ARG(BAI, ERI) / BRA(RGS) / URY(CAS, FLA, PAY, SAO, SJO, SOR, TAC)
Micropsis spathulata	ARG(BAI, COS, ERI, SFE) / BRA(RGS) / URY(ART, CAS, CLA, COL, FLO, FLA, MAL, MON, RNO, ROC, SJO, SOR)
Microseris pygmaea	CHL(ANT, ATA, COQ, VAL, LBO, MAU, BIO, ARA, RME)
Microstachys corniculata	ARG(FOR) / BRA(SCA) / PRY(CAN, ITA)
Microstachys dasycarpa	PRY(APY)
Microstachys hispida	ARG(COR, COS, FOR, MIS, SAL) / BRA(PAR, RGS, SCA) / PRY(APY, AMA, BOQ, CAA, CAN, CON, COA, ITA, PHA, SPE)
Microstachys nana	BRA(PAR)
Microstachys stipulacea	BRA(RGS)
Microsteris gracilis	ARG(CAT, CHU, JUJ, LRI, MEN, NEU, RNE, SAL, SCR, TDF) / CHL(TAR, COQ, VAL, LBO, MAU, BIO, ARA, LLA, AIS, MAG, RME, JFE)
Microtea debilis	BRA(Fuera del área del proyecto) / PRY(PHA)
Microtea maypurensis	BRA(PAR, RGS) / PRY(CON, SPE)
Microtea paniculata var. linifolia	BRA(Fuera del área del proyecto) / PRY(COA)
Microtea paniculata var. paniculata	BRA(Fuera del área del proyecto) / PRY(APY, AMA, CAN, CEN, CON, COA, SPE)
Microtea scabrida	ARG(CHA, COS, ERI, MIS) / BRA(PAR, RGS, SCA) / PRY(APA, CAU, CAA, CEN, CON, COA, GUA, PAI) / URY(ART, PAY, RNO)
Microtea sulcicaulis	BRA(Fuera del área del proyecto) / PRY(AMA, CEN)
Miersia chilensis var. chilensis	CHL(COQ, VAL, LBO, ARA)
Miersia chilensis var. bicolor	CHL(RME)
Miersia cornuta	CHL(COQ, VAL)
Miersia leporina	CHL(COQ)
Miersia tenuiseta f. tenuiseta	CHL(RME)
Miersia tenuiseta f. castanea	CHL(COQ, VAL, RME)
Miersiella umbellata	BRA(PAR, SCA)
Mikania anethifolia	BRA(RGS) / URY(PAY, RNO, RIV, SAO, SOR, TAC)
Mikania anisodora	BRA(PAR) / PRY(APA, AMA, CAA)
Mikania argyreiae	BRA(PAR) / PRY(CAU, PAI)
Mikania buchtienii	ARG(JUJ, SAL)
Mikania buddleiaefolia	BRA(PAR, SCA)
Mikania burchellii	ARG(MIS) / BRA(PAR, RGS, SCA) / PRY(AMA, GUA)
Mikania cabrerae	BRA(Fuera del área del proyecto) / PRY(Desconocida)
Mikania calcarulata	PRY(AMA)
Mikania campanulata	ARG(MIS) / BRA(PAR, RGS, SCA)
Mikania capricorni	ARG(MIS) / BRA(PAR, RGS, SCA)
Mikania chlorolepis	ARG(MIS) / BRA(PAR, RGS, SCA) / PRY(CAU)
Mikania clematidifolia	BRA(PAR, RGS, SCA)
Mikania cordifolia	ARG(BAI, CAT, CHA, COR, COS, ERI, FOR, JUJ, LRI, MIS, SAL, SFE, SDE, TUC) / BRA(PAR, RGS, SCA) / PRY(APY, APA, AMA, CAU, GUA, PAI, PHA) / URY(ART, CLA, COL, PAY, RNO, RIV, SAO, SOR, TAC, TYT)
Mikania cynanchifolia	ARG(BAI, CHA, COS, ERI, FOR, SFE) / BRA(PAR, RGS) / PRY(APY, CON, PHA)
Mikania daspitti	ARG(MIS) / PRY(GUA)
Mikania decumbens	BRA(PAR, RGS, SCA)
Mikania diversifolia	BRA(PAR, SCA)
Mikania dusenii	ARG(BAI, CHA, COS, ERI, SFE) / BRA(PAR, RGS, SCA) / PRY(PHA)
Mikania euryanthela	ARG(CHA, COS, FOR, MIS) / BRA(PAR) / PRY(APA, CAA, CEN, COA, GUA, PAI, PHA, SPE)
Mikania fulva	ARG(COS, MIS) / BRA(PAR, RGS, SCA) / PRY(APA, AMA, CAU, CON, COA, PAI) / URY(ART, LAV, MAL, MON, ROC)
Mikania glomerata	ARG(MIS) / BRA(PAR, RGS, SCA) / PRY(APA, CON, COA, ITA, PAI)
Mikania guaco	BRA(Fuera del área del proyecto) / PRY(CAN)
Mikania guaranitica	ARG(CHA, FOR, SAL, SDE) / PRY(COA, PAI)
Mikania haenkeana	ARG(JUJ, SAL)
Mikania hastato-cordata	BRA(PAR, RGS, SCA)
Mikania hemisphaerica	ARG(COS, MIS) / BRA(PAR, RGS, SCA) / PRY(APA, CAU)
Mikania hirsutissima var. ursina	BRA(PAR)
Mikania hirsutissima var. hirsutissima	ARG(COS, MIS) / BRA(PAR, RGS, SCA) / PRY(APA, CAU, GUA, PAI)
Mikania hoehnei	BRA(SCA)
Mikania hoffmanniana var. polycephala	BRA(PAR)
Mikania hoffmanniana var. hoffmanniana	BRA(PAR, SCA)
Mikania hoffmanniana var. microphylla	BRA(PAR, SCA)
Mikania involucrata	BRA(PAR, RGS, SCA) / URY(LAV, MAL, ROC, TYT)
Mikania jujuyensis	ARG(JUJ)
Mikania laevigata	BRA(PAR, RGS, SCA)
Mikania lanuginosa	BRA(PAR, SCA)
Mikania lasiandrae	BRA(PAR, SCA)
Mikania ligustrifolia	BRA(PAR, SCA)
Mikania lindbergii var. lindbergii	BRA(SCA)
Mikania lindbergii var. collina	BRA(SCA)
Mikania lindleyana	ARG(MIS) / BRA(PAR, RGS, SCA) / PRY(APA, SPE)
Mikania lundiana	ARG(MIS) / BRA(PAR, RGS, SCA)
Mikania mendocina	ARG(MEN, NEU, RNE) / CHL(LBO, MAU, BIO, ARA)
Mikania micrantha	ARG(BAI, CHA, COS, DFE, ERI, FOR, JUJ, MIS, SAL, SFE, TUC) / BRA(PAR, RGS, SCA) / PRY(APY, APA, AMA, CAU, CAA, CEN, COA, GUA, PAI, PHA, SPE) / URY(CAS, FLA, MON, RNO, SAO, SJO, SOR)
Mikania microcephala	BRA(PAR)
Mikania microlepis	BRA(PAR, RGS, SCA)
Mikania microptera	BRA(RGS)
Mikania minima	ARG(TUC)
Mikania nana	BRA(PAR)
Mikania nigricans	BRA(PAR, SCA)
Mikania nummularia	BRA(PAR)
Mikania oblongifolia	ARG(MIS) / BRA(PAR, RGS, SCA)
Mikania obsoleta	BRA(PAR, SCA)
Mikania officinalis	BRA(PAR, SCA)
Mikania oreophila	BRA(PAR, RGS, SCA)
Mikania orleansensis	BRA(PAR, RGS, SCA)
Mikania paniculata	BRA(PAR, SCA) / PRY(APA)
Mikania paranensis	BRA(PAR, RGS, SCA)
Mikania parodii	ARG(BAI, CHA, COS, DFE, ERI, JUJ, SFE) / BRA(RGS, SCA) / URY(ROC, SAO, SOR, TYT)
Mikania periplocifolia	ARG(BAI, CAT, CHA, COR, COS, DFE, ERI, FOR, JUJ, LRI, MEN, MIS, SAL, SJU, SLU, SFE, SDE, TUC) / BRA(RGS) / PRY(APY, BOQ, CAN, CEN, CHO, COA, ÑEE, PAI, PHA) / URY(CLA, PAY, RIV, ROC, SJO, TAC, TYT)
Mikania pilcomayensis	PRY(PHA)
Mikania pinnatiloba	ARG(CHA, COS, ERI, FOR, MIS) / BRA(PAR, RGS, SCA) / PRY(PHA)
Mikania pseudohoffmanniana var. microphylla	BRA(PAR)
Mikania pseudohoffmanniana var. pseudohoffmanniana	BRA(PAR, SCA)
Mikania pseudorimachii	PRY(CEN, PAI, PHA)
Mikania psilostachya	BRA(PAR)
Mikania rufescens	BRA(PAR, RGS, SCA)
Mikania saltensis	ARG(JUJ, SAL, SDE, TUC)
Mikania salviifolia	BRA(PAR, RGS, SCA) / PRY(COA, PAI)
Mikania sericea	BRA(PAR, SCA)
Mikania sessilifolia	BRA(PAR, SCA)
Mikania siambonensis	ARG(TUC)
Mikania smaragdina	BRA(PAR, RGS, SCA)
Mikania sulcata	BRA(RGS) / PRY(CON, COA, PAI) / URY(ART, FLA, PAY, SAO, SOR)
Mikania summinima	ARG(MIS)
Mikania ternata	ARG(MIS) / BRA(PAR, RGS, SCA) / PRY(APA, AMA, CAN, GUA)
Mikania thapsoides	ARG(CHA, COS, ERI, FOR, MIS, SFE) / BRA(PAR, RGS, SCA) / PRY(APA, GUA, MIE)
Mikania thyrsoidea	BRA(PAR)
Mikania trachypleura	ARG(CHA, COS, MIS) / BRA(PAR, SCA) / PRY(APY, AMA, CAN, CEN, COA, GUA) / URY(ART, PAY, SAO, SOR)
Mikania triangularis	BRA(SCA)
Mikania trinervis	BRA(PAR, RGS, SCA)
Mikania ulei	BRA(PAR, RGS, SCA)
Mikania urticifolia	ARG(BAI, CAT, CHA, COR, COS, ERI, FOR, JUJ, LRI, MIS, SAL, SJU, SLU, SFE, SDE, TUC) / PRY(COA)
Mikania variifolia	ARG(CHA, COS, ERI, FOR, MIS) / BRA(PAR, RGS, SCA) / PRY(GUA, PAI) / URY(PAY)
Mikania viminea	BRA(PAR, RGS)
Mikania virgata	BRA(PAR)
Mikania vitifolia	ARG(MIS) / BRA(PAR, RGS, SCA)
Miltonia flavescens	ARG(MIS) / BRA(PAR, RGS, SCA) / PRY(AMA, CAU, CAA, CAN, COA, GUA, SPE)
Miltonia phymatochila	BRA(PAR)
Miltonia regnellii var. citrina	BRA(SCA)
Miltonia regnellii var. regnellii	BRA(PAR, RGS, SCA)
Miltonia russelliana	BRA(PAR, RGS, SCA)
Mimosa adpressa	ARG(COS, ERI, MIS) / BRA(RGS) / URY(ART, CAS, FLO, FLA, MAL, MON, PAY, RNO, RIV, ROC, SAO, SOR, TAC)
Mimosa alleniana	BRA(Fuera del área del proyecto) / PRY(AMA, CAN, COA, PAI, SPE)
Mimosa altoparanensis	PRY(APA, CAU, CAA, CAN)
Mimosa amphigena var. eglandulosa	URY(ART, CLA, LAV, MAL, PAY, RNO, RIV, ROC, SAO, SOR, TAC)
Mimosa amphigena var. trachycarpoides	URY(FLA, LAV, MAL, PAY, ROC, SAO)
Mimosa amphigena var. amphigena	ARG(COS, ERI, MIS) / BRA(RGS) / URY(ART, CLA, DUR, FLO, FLA, LAV, MAL, MON, RIV, ROC, SAO, TAC)
Mimosa amphigena var. inermis	URY(PAY, RIV, SAO, TAC)
Mimosa amphigena var. glabrescens	BRA(RGS) / URY(LAV)
Mimosa asperoides	URY(LAV, RIV, TYT)
Mimosa atlantica	BRA(PAR)
Mimosa aureliana	PRY(AMA)
Mimosa australis	URY(ART, LAV, MAL, RIV)
Mimosa axillarioides	URY(MAL, ROC, SAO, TAC)
Mimosa axillaris	BRA(RGS, SCA)
Mimosa balansae	ARG(COS, ERI, FOR, MIS, SFE) / BRA(RGS) / PRY(APY, AMA, CEN, CON, COA, GUA, PAI, PHA, SPE) / URY(ART, PAY, SAO)
Mimosa balduinii	BRA(PAR, RGS)
Mimosa barnebiana	ARG(COS) / BRA(PAR, RGS) / PRY(ITA)
Mimosa bathyrrhena	BRA(PAR)
Mimosa berroi	BRA(RGS) / URY(LAV, RNO, RIV, SJO, TAC)
Mimosa bifurca var. reducta	PRY(AMA)
Mimosa bifurca var. desmanthoides	ARG(MIS) / BRA(Fuera del área del proyecto)
Mimosa bifurca var. bifurca	ARG(COS, MIS) / BRA(RGS, SCA) / PRY(GUA, PAI, SPE) / URY(TYT)
Mimosa bifurca var. hassleriana	PRY(COA, PAI) / URY(TAC)
Mimosa bimucronata var. adenocarpa	PRY(APY, AMA)
Mimosa bimucronata var. bimucronata	ARG(COS, MIS) / BRA(PAR, RGS, SCA) / PRY(APY, APA, AMA, CEN, GUA, ITA, PAI) / URY(ART, RIV, SAO)
Mimosa bonplandii	ARG(BAI, COS, ERI) / URY(TAC)
Mimosa bracteolaris	BRA(RGS)
Mimosa brevipes	BRA(Fuera del área del proyecto) / PRY(AMA, CAA, CAN, COA)
Mimosa brevipetiolata var. brevipetiolata	ARG(MIS)
Mimosa brevipetiolata var. hirtula	ARG(COS, MIS) / PRY(PAI)
Mimosa burkartii	URY(MAL, MON)
Mimosa caaguazüensis	ARG(MIS) / PRY(CAU, CAN, COA, MIE, ÑEE)
Mimosa caingüensis	ARG(MIS) / PRY(ITA, MIE)
Mimosa callidryas	BRA(PAR)
Mimosa candelabrum	PRY(CAU, CAN)
Mimosa castanoclada	PRY(APY)
Mimosa catharinensis	BRA(SCA)
Mimosa centurionis	PRY(CON)
Mimosa ceratonia var. pseudo-obovata	BRA(SCA)
Mimosa chacoënsis	PRY(APY, PHA)
Mimosa chaetosphaera	BRA(SCA)
Mimosa chartostegia	BRA(PAR)
Mimosa chelata	URY(LAV, MAL, PAY, RIV, ROC, TAC)
Mimosa chodatii	PRY(AMA)
Mimosa congestifolia	BRA(PAR)
Mimosa coniflora	BRA(PAR, SCA)
Mimosa cordobensis	ARG(COR)
Mimosa cruenta var. cruenta	ARG(COS, ERI, MIS, SFE) / BRA(RGS, SCA) / URY(ART, CLA, DUR, FLO, LAV, MAL, PAY, RIV, TAC, TYT)
Mimosa cruenta var. glabra	BRA(RGS) / URY(ART, CLA, RIV, TAC)
Mimosa cubatanensis	BRA(PAR)
Mimosa custodis	PRY(AMA)
Mimosa daleoides	ARG(COS, MIS) / BRA(PAR, RGS, SCA) / PRY(APA, AMA, CAU, CAA, CAN, CEN, COA, GUA, MIE, PAI) / URY(DUR, LAV, RIV, TAC)
Mimosa dalyi	PRY(AMA)
Mimosa debilis var. debilis	ARG(COS, FOR, JUJ, MIS, SAL, SDE, TUC) / BRA(PAR) / PRY(APY, AMA, CAU, CAA, CAN, CEN, CON, COA, GUA, ITA, MIE, NAS, PAI, PHA, SPE)
Mimosa debilis var. angusta	BRA(Fuera del área del proyecto) / PRY(CON)
Mimosa deceptrix	BRA(PAR)
Mimosa detinens	ARG(CAT, CHA, COR, FOR, SAL, SDE, TUC) / PRY(APY, PHA)
Mimosa diffusa	BRA(RGS)
Mimosa diplotricha	ARG(CHA, COS, FOR, MIS) / BRA(PAR, RGS, SCA) / PRY(APY, APA, CEN, GUA, PAI)
Mimosa distans var. distans	BRA(PAR)
Mimosa distans var. paraguariensis	BRA(PAR) / PRY(AMA, CAU)
Mimosa diversipila var. subglabriseta	ARG(COS, MIS) / PRY(APA, CAU, CAA, CAN, GUA, ITA, MIE, PAI)
Mimosa diversipila var. diversipila	ARG(COS, MIS) / BRA(Fuera del área del proyecto) / PRY(APA, APY, AMA, CAU, CAA, CAN, CEN, CON, COA, GUA, MIE, PAI, SPE)
Mimosa dolens var. pangloea	BRA(PAR)
Mimosa dolens var. rudis	BRA(PAR) / PRY(AMA)
Mimosa dolens var. anisitsii	BRA(Fuera del área del proyecto) / PRY(AMA, CAN, COA) / URY(RIV)
Mimosa dolens ssp. acerba	BRA(PAR, RGS) / PRY(AMA, CAA, SPE)
Mimosa dolens var. dolens	BRA(PAR)
Mimosa dolens var. pubescens	ARG(COS, MIS) / BRA(RGS) / URY(RIV)
Mimosa dolens ssp. eriophylla	BRA(PAR)
Mimosa dolens var. latifolia	ARG(COS, ERI, MIS) / BRA(PAR, RGS) / PRY(APA, AMA, CAU, CAA, CAN) / URY(RIV, TAC)
Mimosa dolens var. pseudorigida	PRY(CAN)
Mimosa dolens var. deterior	PRY(AMA)
Mimosa dolens ssp. callosa	ARG(COS, MIS) / BRA(PAR) / PRY(APA, COA, SPE)
Mimosa dolens var. rigescens	BRA(PAR, RGS, SCA) / PRY(CAU, ITA)
Mimosa dolens ssp. rigida	ARG(COS, MIS) / BRA(RGS) / URY(RIV, TAC)
Mimosa dolens var. uncta	BRA(PAR)
Mimosa dolens var. foliolosa	ARG(COS, MIS) / BRA(PAR) / PRY(CAN, COA, PAI)
Mimosa dryandroides var. extratropica	BRA(PAR)
Mimosa dutrae var. dutrae	BRA(RGS, SCA) / URY(MAL, ROC, SJO)
Mimosa dutrae var. major	BRA(RGS) / URY(LAV, MAL, ROC)
Mimosa ephedroides	ARG(CAT, LRI, MEN, SJU, SLU)
Mimosa equisetum	PRY(CAU)
Mimosa eriocarpa	BRA(RGS)
Mimosa excedentis	URY(ART, LAV, RIV, ROC)
Mimosa fachinalensis	BRA(RGS, SCA)
Mimosa farinosa	ARG(CAT, COR, JUJ, LRI, SAL, SDE, TUC)
Mimosa fernandez-casasii	BRA(Fuera del área del proyecto) / PRY(CAN)
Mimosa fiebrigii	PRY(AMA, CON)
Mimosa filipetiola	BRA(PAR, SCA)
Mimosa flagellaris	ARG(COS, ERI) / BRA(RGS) / PRY(AMA, CAU, CON, COA, GUA, PAI) / URY(ART, CLA, RIV, SAO, TAC)
Mimosa flocculosa	BRA(PAR) / PRY(APY, APA, AMA, CAU, CAN, COA)
Mimosa furfuracea	BRA(PAR, SCA)
Mimosa glabra	BRA(RGS)
Mimosa glanduliseta	ARG(MIS) / PRY(APA)
Mimosa glutinosa	BRA(Fuera del área del proyecto) / PRY(APY, AMA, CON)
Mimosa glycyrrhizoides	BRA(PAR, RGS)
Mimosa gracilis var. leiocarpa	ARG(COS, MIS) / BRA(RGS, SCA) / PRY(CAA, CEN, COA, GUA, ITA, MIE, PAI)
Mimosa gracilis ssp. capillipes	ARG(COS, MIS) / BRA(PAR, RGS) / PRY(CAA, SPE)
Mimosa gracilis ssp. gracilis	BRA(Fuera del área del proyecto) / PRY(CAU, COA, SPE)
Mimosa guaranitica	ARG(COS, MIS) / PRY(AMA, CEN, COA, ÑEE, PAI, SPE)
Mimosa gymnas	BRA(PAR)
Mimosa hatschbachii	BRA(PAR)
Mimosa hexandra	ARG(FOR, MIS) / BRA(Fuera del área del proyecto) / PRY(APY, CEN, CON, ÑEE, PAI, PHA)
Mimosa hilariana	BRA(PAR)
Mimosa hirsutissima	ARG(COS, MIS) / BRA(Fuera del área del proyecto) / PRY(APA, SPE)
Mimosa implexa	BRA(RGS)
Mimosa incana	BRA(RGS) / URY(CLA, DUR, RIV, TAC)
Mimosa insignis	BRA(Fuera del área del proyecto) / PRY(CON)
Mimosa intricata	BRA(RGS)
Mimosa invisa var. invisa	BRA(Fuera del área del proyecto) / PRY(CAU, CAN, CEN, PAI, PHA)
Mimosa invisa var. macrostachya	BRA(Fuera del área del proyecto) / PRY(CAN)
Mimosa involucrata	BRA(PAR, RGS, SCA)
Mimosa iperoënsis var. paradenia	PRY(CAN)
Mimosa iperoënsis var. iperoënsis	BRA(PAR) / PRY(AMA, CAU)
Mimosa kermesina	BRA(RGS)
Mimosa kuhniesteroides	BRA(PAR)
Mimosa lanata	BRA(PAR, SCA)
Mimosa lasiocephala	BRA(RGS)
Mimosa leimonias	BRA(Fuera del área del proyecto) / PRY(AMA)
Mimosa lepidorepens	BRA(SCA)
Mimosa longiracemosa	ARG(MIS)
Mimosa luciana	URY(CAS, FLA, MAL, ROC)
Mimosa lupinoides	BRA(Fuera del área del proyecto) / PRY(APA, AMA, CAU, CAN)
Mimosa macrocalyx var. macrocalyx	ARG(COS, MIS) / PRY(APA, GUA, PAI)
Mimosa macrocalyx var. pectinata	BRA(SCA)
Mimosa magentea	URY(LAV, MAL)
Mimosa maracayuënsis	BRA(PAR, RGS, SCA) / PRY(AMA, CAN)
Mimosa micropteris var. pungens	BRA(PAR, SCA)
Mimosa micropteris var. micropteris	BRA(PAR)
Mimosa monadelpha var. glabrata	PRY(AMA, CON, SPE)
Mimosa monadelpha var. monadelpha	PRY(AMA, CAU, CAN)
Mimosa morongii	PRY(CEN)
Mimosa murex	BRA(SCA)
Mimosa myriophylla	ARG(COS, MIS) / BRA(RGS, SCA) / PRY(MIE, PAI)
Mimosa niederleinii	ARG(MIS) / BRA(PAR, RGS, SCA)
Mimosa nitidula	PRY(COA)
Mimosa nuda var. glaberrima	PRY(BOQ)
Mimosa oblonga var. oblonga	BRA(PAR, SCA)
Mimosa oblonga var. pinetorum	BRA(PAR)
Mimosa obstrigosa	ARG(COS, MIS) / BRA(RGS) / URY(PAY)
Mimosa oligophylla	ARG(COS, ERI, MIS) / BRA(PAR, RGS) / PRY(CAA, COA, GUA, PAI)
Mimosa orthacantha	BRA(PAR)
Mimosa ostenii	ARG(ERI) / URY(PAY, SAO)
Mimosa paraguariae var. paraguariae	ARG(COS, MIS) / BRA(PAR, RGS, SCA) / PRY(APA, CAU, CAN, PHA, SPE)
Mimosa paraguariae var. multiglandulosa	PRY(CAU)
Mimosa paraguariae var. tomentosa	PRY(CAN)
Mimosa paranapiacabae	BRA(PAR)
Mimosa parvipinna	ARG(MIS) / BRA(RGS) / PRY(CAU) / URY(FLA, RIV, TAC)
Mimosa paupera var. paupera	ARG(COS, ERI, MIS) / BRA(PAR, RGS) / PRY(APY, AMA, GUA, ITA) / URY(ART, MAL, PAY, SAO)
Mimosa paupera var. dives	BRA(Fuera del área del proyecto) / PRY(CON)
Mimosa pauperoides	ARG(COS, ERI, MIS) / BRA(RGS) / URY(SAO)
Mimosa pedersenii	ARG(COS, MIS) / BRA(PAR, RGS) / PRY(CAN) / URY(ART, MON, TAC, TYT)
Mimosa pedunculosa	PRY(CAU, CAA, SPE)
Mimosa per-dusenii	BRA(PAR, SCA)
Mimosa petraea	BRA(Fuera del área del proyecto) / PRY(APY, AMA, CAA, COA, GUA, PAI)
Mimosa pigra var. pigra	ARG(BAI, CHA, COS, ERI, FOR, MIS, SFE) / BRA(PAR, RGS, SCA) / PRY(APY, APA, AMA, CAU, CAN, CEN, CON, COA, GUA, ITA, PAI, PHA, SPE) / URY(COL, SJO, SOR)
Mimosa pigra var. dehiscens	BRA(Fuera del área del proyecto) / PRY(APY, CON, COA, PHA)
Mimosa pilulifera var. pilulifera	ARG(BAI, ERI) / BRA(PAR, RGS, SCA) / URY(ART, CLA, COL, DUR, LAV, MON, PAY, RNO, RIV, SJO, SOR, TAC)
Mimosa pilulifera var. pseudincana	BRA(PAR, RGS, SCA) / URY(ART, CLA, MON, PAY, RNO, SJO, TAC)
Mimosa plumosa	PRY(COA)
Mimosa polycarpa var. spegazzini	ARG(COS, MIS) / BRA(Fuera del área del proyecto) / PRY(APY, CEN, COA, GUA, PAI, SPE)
Mimosa polycarpa var. subandina	ARG(JUJ, SAL, TUC)
Mimosa prionopus	BRA(PAR)
Mimosa pseudocallosa	BRA(SCA)
Mimosa pseudolepidota	BRA(SCA)
Mimosa pseudopetiolaris	PRY(PAI)
Mimosa pseudotrachycarpa	BRA(PAR, RGS)
Mimosa pudica var. hispida	BRA(PAR, SCA)
Mimosa quadrivalvis var. leptocarpa	ARG(COS, MIS) / BRA(PAR, SCA) / PRY(APY, CEN, GUA)
Mimosa ramboi	BRA(RGS) / URY(ART, CAS, PAY)
Mimosa ramentacea	BRA(SCA)
Mimosa ramosissima	BRA(PAR, RGS, SCA)
Mimosa ramulosa	BRA(RGS) / URY(ART, CLA, FLA, LAV, MAL, MON, RIV, ROC, TYT)
Mimosa reduviosa	BRA(PAR)
Mimosa regnellii var. exuta	ARG(MIS) / BRA(PAR, SCA)
Mimosa regnellii var. supersetosa	BRA(PAR, SCA)
Mimosa regnellii var. grossiseta	BRA(PAR)
Mimosa reptans	BRA(RGS) / URY(DUR, LAV, MAL, RNO, RIV, TAC)
Mimosa riverensis	URY(RIV)
Mimosa rocae	ARG(BAI) / BRA(RGS) / URY(CLA, LAV, MAL, PAY)
Mimosa rojasii	PRY(AMA)
Mimosa rupestris	BRA(RGS) / URY(LAV, RIV)
Mimosa scabrella	ARG(BAI) / BRA(PAR, RGS, SCA)
Mimosa sceptrum	BRA(Fuera del área del proyecto) / PRY(AMA)
Mimosa schleidenii	BRA(RGS) / URY(CLA, LAV, MAL, RIV, TAC, TYT)
Mimosa selloi	ARG(COS) / BRA(PAR, RGS, SCA)
Mimosa sensibilis var. aquidabani	BRA(Fuera del área del proyecto) / PRY(AMA, CON)
Mimosa sensibilis var. sensibilis	ARG(JUJ, SAL) / BRA(Fuera del área del proyecto) / PRY(APY)
Mimosa sensitiva	BRA(Fuera del área del proyecto) / PRY(AMA, CON)
Mimosa serra	BRA(PAR, SCA) / PRY(APA)
Mimosa setosa ssp. paludosa	BRA(Fuera del área del proyecto) / PRY(AMA)
Mimosa somnians ssp. viscida	BRA(PAR) / PRY(CON)
Mimosa somnians ssp. lasiocarpa	BRA(Fuera del área del proyecto) / PRY(AMA)
Mimosa somnians ssp. somnians	ARG(COS, MIS) / BRA(Fuera del área del proyecto) / PRY(APY, CAU, CAA, CAN, CEN, COA, GUA, ITA)
Mimosa sparsa	BRA(PAR, RGS, SCA)
Mimosa sparsiformis	BRA(RGS, SCA)
Mimosa sprengelii	BRA(RGS) / URY(ART, COL, DUR, LAV, MAL, RIV, ROC, SAO, TAC)
Mimosa strigillosa	ARG(CHA, COS, ERI, FOR, SFE, TUC) / BRA(Fuera del área del proyecto) / PRY(APY, CEN, CON, ÑEE) / URY(CLA, FLO, RNO, SOR, TAC)
Mimosa strobiliflora	BRA(PAR)
Mimosa subsericea	ARG(COS, FOR, MIS) / BRA(PAR, SCA) / PRY(APY, APA, AMA, CAU, CAA, CAN, CON, COA, GUA, MIE, PAI, SPE)
Mimosa taimbensis	BRA(RGS, SCA)
Mimosa tandilensis	ARG(BAI) / BRA(RGS) / URY(LAV, MAL)
Mimosa tenuipendula	PRY(APY)
Mimosa tobatiensis	PRY(CEN, COA)
Mimosa trachycarpa	BRA(RGS) / URY(CLA, LAV, TYT)
Mimosa troncosoae	PRY(APY)
Mimosa tucumensis	BRA(PAR)
Mimosa tweedieana	ARG(BAI, CHA, COS, DFE, ERI, FOR, SFE) / BRA(Fuera del área del proyecto) / PRY(APY, CEN, SPE) / URY(SJO)
Mimosa uliginosa	ARG(COS, MIS) / BRA(RGS) / PRY(AMA, CAN, COA)
Mimosa uninervis	BRA(Fuera del área del proyecto) / PRY(CAN, SPE)
Mimosa uraguensis	ARG(COS, ERI, MIS) / BRA(RGS) / URY(ART, FLA, MON, PAY, RNO, SAO)
Mimosa urticaria	BRA(PAR)
Mimosa velloziana	ARG(COS, JUJ, MIS, SAL) / BRA(PAR) / PRY(ITA)
Mimosa weddelliana	BRA(Fuera del área del proyecto) / PRY(AMA)
Mimosa xanthocentra var. xanthocentra	ARG(FOR, JUJ, SAL) / BRA(SCA) / PRY(APY, CEN, CON, PHA)
Mimosa xanthocentra var. mansii	BRA(Fuera del área del proyecto) / PRY(APY, GUA, PAI)
Mimozyganthus carinatus	ARG(CAT, CHA, COR, FOR, JUJ, LRI, SAL, SDE, SJU, SLU, TUC) / PRY(APY, PHA)
Mimulus crinitus	CHL(BIO, ARA, LLA)
Mimulus glabratus	ARG(BAI, CAT, CHU, COR, JUJ, LPA, LRI, MEN, NEU, RNE, SAL, SCR, SFE, SJU, SLU, TUC) / CHL(TAR, ANT, ATA, COQ, VAL, LBO, MAU, BIO, ARA, LLA, AIS, MAG, RME)
Mimulus luteus var. younganus	CHL(ARA)
Minaria acerosa	ARG(MIS) / BRA(PAR)
Minthostachys verticillata	ARG(CAT, COR, JUJ, LRI, SAL, SLU, TUC)
Mionandra camareoides	ARG(CAT, COR, JUJ, LPA, SAL, SDE, SLU, TUC)
Mionandra paraguariensis	PRY(COA)
Mirabilis acuta	CHL(TAR, ANT, ATA, COQ)
Mirabilis bracteosa var. micrantha	ARG(CAT, JUJ, LRI, TUC)
Mirabilis bracteosa var. bracteosa	ARG(CAT, JUJ, LRI, SAL, TUC)
Mirabilis cordifolia	CHL(COQ, VAL, MAU, RME)
Mirabilis elegans	CHL(TAR, ANT, ATA, COQ, VAL, RME)
Mirabilis expansa	CHL(TAR, VAL)
Mirabilis jalapa	ARG(BAI, CAT, CHA, COR, COS, ERI, JUJ, MIS, SAL, SDE, SFE, SJU, SLU, TUC) / BRA(PAR, RGS, SCA) / CHL(JFE, IPA) / PRY(PAI) / URY(Desconocida)
Mirabilis ovata	ARG(BAI, CAT, COR, COS, JUJ, LPA, LRI, MEN, RNE, SAL, SJU, SLU, TUC) / CHL(ATA, COQ, VAL, LBO, RME)
Mirabilis prostrata	CHL(ANT, ATA, COQ, VAL, LBO, MAU, RME)
Mirabilis trollii	CHL(TAR)
Miscanthus sinensis	CHL(MAU) / URY(MON)
Misodendrum angulatum	ARG(NEU, RNE, SCR) / CHL(BIO, LLA, MAG)
Misodendrum brachystachium	ARG(CHU, NEU, RNE, SCR, TDF) / CHL(MAU, BIO, ARA, LLA, AIS, MAG)
Misodendrum gayanum	ARG(CHU, NEU, RNE) / CHL(BIO, ARA, LLA, AIS)
Misodendrum linearifolium var. linearifolium	ARG(CHU, NEU, RNE, SCR, TDF) / CHL(VAL, LBO, MAU, BIO, ARA, LLA, AIS, MAG, RME)
Misodendrum macrolepis	CHL(LLA)
Misodendrum oblongifolium	ARG(CHU, NEU, RNE) / CHL(MAU, BIO, ARA, LLA, AIS, MAG)
Misodendrum punctulatum	ARG(CHU, NEU, RNE, SCR, TDF) / CHL(MAU, BIO, ARA, LLA, AIS, MAG)
Misodendrum quadriflorum	ARG(CHU, NEU, RNE, SCR, TDF) / CHL(MAU, BIO, ARA, AIS, MAG)
Misopates orontium	ARG(DFE, ERI, SFE, TUC) / URY(SJO)
Mitracarpus bacigalupoae	PRY(CAU, SPE)
Mitracarpus brasiliensis	ARG(MIS) / BRA(RGS)
Mitracarpus brevis	ARG(COR, JUJ, SAL, SLU)
Mitracarpus frigidus	BRA(RGS, SCA) / PRY(CAU, CAN)
Mitracarpus hasslerianus	PRY(APA, CAU, COA, PAI)
Mitracarpus megapotamicus	ARG(BAI, CAT, CHA, COR, COS, DFE, ERI, FOR, JUJ, LPA, LRI, MIS, SAL, SLU, SFE, SDE, TUC) / BRA(PAR, RGS) / PRY(APY, AMA, CAU, CEN, CON, GUA, MIE, PAI, PHA) / URY(ART, CAS, COL, FLA, MAL, PAY, RNO, SAO, SJO, SOR, TYT)
Mitracarpus schininianus	PRY(AMA, CAN, SPE)
Mitracarpus villosus	ARG(BAI, CAT, CHA, COR, COS, ERI, FOR, JUJ, LRI, MIS, SAL, TUC) / BRA(PAR, RGS, SCA) / PRY(CAA, CAN, CEN, PAI) / URY(PAY, RNO)
Mitraria coccinea	ARG(CHU, NEU, RNE) / CHL(COQ, VAL, MAU, BIO, ARA, LLA, AIS, MAG)
Mnesithea aurita	ARG(COS, MIS) / BRA(PAR) / PRY(PAI)
Mnesithea balansae	ARG(CHA, COS, ERI, FOR, MIS) / PRY(AMA, COA, GUA, ITA, MIE, PAI, SPE)
Mnesithea parodiana	ARG(CHA, FOR, LRI, SLU, SDE) / PRY(APY)
Mnesithea selloana	ARG(BAI, CHA, COR, COS, ERI, MIS, SFE) / BRA(RGS, SCA) / PRY(GUA, ÑEE) / URY(FLA, MAL)
Mniodes burkartii	ARG(JUJ, SAL)
Mniodes catamarcensis	ARG(CAT)
Mniodes coarctata	CHL(TAR)
Mniodes kunthiana	ARG(JUJ)
Mniodes lopezmirandae	ARG(JUJ, SAL)
Mniodes pickeringii	ARG(SAL)
Mniodes piptolepis	ARG(CAT, JUJ, SAL) / CHL(TAR)
Mniodes santanica	ARG(CAT, COR, JUJ, SAL, TUC)
Mniodes schultzii	ARG(CAT, JUJ, LRI, SAL, SJU) / CHL(TAR, ANT)
Mniodes subspicata	ARG(CAT, JUJ, LRI, SAL, SJU, TUC)
Modiola caroliniana	ARG(BAI, CHA, COR, COS, ERI, FOR, MEN, MIS, SFE, SLU) / BRA(PAR, RGS) / CHL(ATA, COQ, VAL, LBO, MAU, BIO, ARA, LLA, JFE) / PRY(APA, CEN, SPE) / URY(CLA, MON, RIV, ROC, TAC)
Modiolastrum australe	ARG(BAI, SFE)
Modiolastrum gilliesii	ARG(BAI, COR, COS, ERI, LPA, MEN, SDE, SFE) / PRY(ITA) / URY(FLO)
Modiolastrum lateritium	ARG(BAI, COS, DFE, ERI, MIS) / BRA(RGS) / PRY(CAA, ITA) / URY(PAY, RIV)
Modiolastrum malvifolium	ARG(BAI, CAT, CHA, COR, COS, ERI, FOR, JUJ, LRI, MIS, SAL, SDE, SFE, SLU, TUC) / BRA(PAR, RGS, SCA) / PRY(APY, BOQ, CEN, ITA, ÑEE, PAI, PHA) / URY(ART)
Modiolastrum palustre	BRA(PAR)
Molineria capitulata	ARG(DFE)
Mollinedia argyrogyna	BRA(PAR)
Mollinedia blumenaviana	BRA(PAR, SCA)
Mollinedia calodonta	BRA(RGS, SCA)
Mollinedia chrysolaena	BRA(PAR, SCA)
Mollinedia clavigera	BRA(PAR, SCA)
Mollinedia elegans	BRA(PAR, RGS, SCA)
Mollinedia eugeniifolia	BRA(SCA)
Mollinedia floribunda	BRA(RGS, SCA)
Mollinedia fruticulosa	BRA(SCA)
Mollinedia hatschbachii	BRA(PAR, SCA)
Mollinedia howeana	BRA(SCA)
Mollinedia luizae	BRA(PAR)
Mollinedia pfitzeriana	BRA(SCA)
Mollinedia schottiana	BRA(PAR, RGS, SCA)
Mollinedia triflora	BRA(PAR, SCA)
Mollinedia uleana	BRA(PAR, SCA)
Mollinedia widgrenii	BRA(PAR, SCA)
Mollugo verticillata	ARG(BAI, CAT, CHA, COR, COS, ERI, FOR, LPA, LRI, MIS, RNE, SAL, SJU, SLU, SFE, SDE, TUC) / BRA(RGS, SCA) / PRY(APY, CAA, CEN, COA, PAI, PHA) / URY(MON, PAY)
Molucella laevis	ARG(BAI) / CHL(VAL)
Momordica charantia	ARG(BAI, COR, COS, JUJ, LRI, SAL) / BRA(PAR, RGS) / PRY(APY, BOQ, ÑEE)
Monnina cardiocarpa	ARG(FOR) / BRA(PAR, RGS, SCA)
Monnina cuneata	ARG(COS, ERI) / BRA(RGS) / URY(MAL, MON, TAC)
Monnina dictyocarpa	ARG(BAI, CAT, CHU, COR, ERI, LPA, LRI, MEN, NEU, RNE, SAL, SCR, SJU, SLU, TUC) / BRA(PAR)
Monnina intermedia	URY(RIV)
Monnina itapoanensis	BRA(RGS)
Monnina linearifolia	ARG(NEU) / CHL(COQ, VAL, LBO, MAU, BIO, ARA, RME)
Monnina lorentziana	ARG(CAT, LRI, MEN, SAL, SJU, SLU, TUC)
Monnina mucronata	URY(Desconocida)
Monnina oblongifolia	ARG(COS, MIS) / BRA(PAR, RGS, SCA) / PRY(APA) / URY(RIV)
Monnina philippiana	ARG(MEN) / CHL(COQ, VAL, LBO, RME)
Monnina pumila	ARG(JUJ)
Monnina ramosissima	URY(TAC)
Monnina resedoides	ARG(BAI, COS, ERI, MIS, SFE) / BRA(RGS) / PRY(ITA) / URY(RNO)
Monnina richardiana	BRA(PAR, RGS)
Monnina rusbyi	ARG(JUJ, SAL)
Monnina tristaniana	ARG(CHA, COS, ERI, FOR, MIS, SFE) / BRA(PAR, RGS, SCA) / PRY(APA, CAU, CAN, ITA, PAI, SPE) / URY(CLA)
Monnina virescens	URY(Desconocida)
Monnina wrightii	ARG(CAT, JUJ, LRI, SAL, SLU, TUC) / URY(TAC)
Monopera perennis	BRA(Fuera del área del proyecto) / PRY(CON)
Monstera adansonii var. klotschiana	BRA(PAR, SCA)
Montanoa bipinnatifida	ARG(MIS)
Monteiroa bullata	BRA(PAR, RGS, SCA)
Monteiroa catharinensis	BRA(SCA)
Monteiroa dusenii	BRA(PAR, SCA)
Monteiroa glomerata	ARG(BAI, ERI) / BRA(PAR, RGS, SCA) / URY(CAS, MAL, SJO)
Monteiroa hatschbachii	BRA(PAR)
Monteiroa ptarmicaefolia	BRA(RGS, SCA)
Monteiroa reitzii	BRA(RGS, SCA)
Monteiroa smithii	BRA(PAR, SCA)
Monteiroa triangularifolia	BRA(RGS)
Montia fontana	ARG(CHU, JUJ, NEU, RNE, SJU, SCR, TDF) / CHL(COQ, VAL, LBO, MAU, BIO, ARA, LLA, MAG, RME) / URY(SJO)
Montiopsis andicola	ARG(MEN, NEU, RNE, SJU) / CHL(COQ, VAL, LBO, MAU, BIO, RME)
Montiopsis berteroana	ARG(CHU, MEN, NEU, RNE) / CHL(VAL, LBO, MAU, BIO, ARA, RME)
Montiopsis capitata	ARG(CHU, LPA, MEN, NEU, RNE, SJU, SCR) / CHL(ATA, COQ, VAL, LBO, MAU, BIO, RME)
Montiopsis cistiflora	ARG(MEN, NEU) / CHL(LBO, MAU, BIO, ARA, RME)
Montiopsis copiapina	ARG(CAT, LRI, SJU) / CHL(ANT, ATA, COQ)
Montiopsis cumingii	ARG(CAT, JUJ, LRI, MEN, SAL, SJU) / CHL(TAR, ANT, COQ, VAL, RME)
Montiopsis demissa	CHL(TAR, ATA, COQ, VAL, RME)
Montiopsis gayana	ARG(CHU, MEN, NEU, RNE, SCR) / CHL(COQ, LBO, MAU, BIO, ARA, LLA, RME)
Montiopsis gilliesii	ARG(LRI, MEN, NEU, SJU) / CHL(COQ, VAL, MAU, RME)
Montiopsis glomerata	ARG(MEN, SAL, SJU) / CHL(ATA, COQ)
Montiopsis modesta	ARG(LRI, SAL, SJU) / CHL(ANT, ATA, COQ)
Montiopsis parviflora	CHL(ATA, COQ)
Montiopsis polycarpoides	ARG(MEN, NEU, SJU) / CHL(ANT, VAL)
Montiopsis potentilloides	ARG(MEN, SJU) / CHL(COQ, VAL, RME)
Montiopsis ramosissima	CHL(COQ, VAL, LBO, RME)
Montiopsis sericea	CHL(COQ, VAL, RME)
Montiopsis trifida	CHL(TAR, ANT, ATA, COQ, VAL, LBO, RME)
Montiopsis umbellata	ARG(CHU, MEN, NEU, RNE) / CHL(COQ, VAL, LBO, MAU, BIO, ARA, LLA, RME)
Monttea aphylla var. aphylla	ARG(BAI, CAT, CHU, LPA, LRI, MEN, NEU, RNE, SAL, SJU, SLU, TUC)
Monttea aphylla var. glandulifera	ARG(NEU, RNE)
Monttea chilensis var. taltalensis	CHL(ANT, COQ)
Monttea chilensis var. chilensis	CHL(COQ, VAL)
Monttea schickendantzii	ARG(CAT, COR, LRI, MEN, TUC)
Monvillea cavendischii	ARG(CHA, COS, ERI, FOR, JUJ, MIS, SAL, SFE) / PRY(APY, AMA, CEN, CON, COA, GUA, ÑEE, PAI, PHA, SPE)
Monvillea euchlora	ARG(COS, MIS) / BRA(PAR) / PRY(AMA, CEN, COA, ITA, PAI)
Monvillea krapovickiana	ARG(FOR)
Monvillea phatnosperma var. phatnosperma	ARG(FOR) / BRA(Fuera del área del proyecto) / PRY(APY, CON, PHA)
Monvillea phatnosperma var. arenasi	PRY(APY, NAS, PHA)
Monvillea spegazzinii	ARG(CHA, FOR, SFE) / PRY(APY, CON, PHA)
Moorochloa eruciformis	ARG(ERI)
Moquiniastrum argyreum	BRA(PAR)
Moquiniastrum barrosoae	BRA(PAR) / PRY(APY, AMA, CAN, CHO, CON)
Moquiniastrum cinereum	BRA(PAR, RGS, SCA)
Moquiniastrum cordatum var. mollisimum	BRA(RGS) / PRY(CAU)
Moquiniastrum haumanianum	BRA(Fuera del área del proyecto) / PRY(AMA, SPE)
Moquiniastrum mollisimum	BRA(RGS)
Moquiniastrum paniculatum	BRA(PAR)
Moquiniastrum polymorphum ssp. polymorphum	BRA(RGS) / PRY(APA, APY, AMA, CAU, CAN, CEN, CON, COA, GUA, PAI, SPE)
Moquiniastrum polymorphum ssp. floccosum	BRA(PAR, RGS, SCA)
Moquiniastrum pulchrum	BRA(Fuera del área del proyecto) / PRY(AMA)
Moquiniastrum ramboi	BRA(RGS, SCA)
Moquiniastrum sordidum	BRA(PAR, RGS, SCA)
Moquiniastrum velutinum	BRA(PAR)
Morella chevalieri	ARG(JUJ, SAL)
Morella pavonis	CHL(TAR)
Moritzia ciliata	BRA(PAR, SCA)
Moritzia dusenii	BRA(PAR)
Morrenia intermedia	ARG(SLU)
Morrenia stormiana	ARG(CHA, FOR, JUJ, SFE) / BRA(Fuera del área del proyecto) / PRY(APY, CON, PHA)
Morronea trichidiachnis	ARG(MIS) / BRA(PAR) / PRY(APA, AMA)
Morus alba	ARG(BAI, COS, ERI, LPA, MIS, SAL, SDE, SFE, TUC) / PRY(CEN, GUA) / URY(PAY, RNO)
Morus insignis	ARG(JUJ, SAL)
Moscharia pinnatifida	CHL(ATA, COQ, VAL, LBO, MAU, RME)
Moscharia solbrigii	CHL(COQ)
Moschopsis ameghinoi	ARG(SCR)
Moschopsis caleofuensis	ARG(CHU, NEU, RNE)
Moschopsis leyboldii	ARG(MEN, NEU) / CHL(RME)
Moschopsis monocephala	ARG(CAT, JUJ, LRI, MEN, SAL, TUC) / CHL(TAR, ANT, ATA)
Moschopsis rosulata	ARG(NEU, RNE, SCR, TDF) / CHL(MAG)
Moschopsis subandina	ARG(CHU, NEU) / CHL(ARA, LLA)
Moschopsis trilobata	ARG(SCR) / CHL(MAG)
Mostacillastrum ameghinoi	ARG(CHU, SCR)
Mostacillastrum andinum	ARG(CHU, MEN, NEU, SJU) / CHL(COQ, VAL, MAU, RME)
Mostacillastrum carolinense	ARG(SLU)
Mostacillastrum commune	ARG(CHU, MEN, NEU, RNE, SCR, SJU) / CHL(COQ, VAL, RME)
Mostacillastrum dianthoides	ARG(JUJ) / CHL(TAR, ANT)
Mostacillastrum ferreyrae	CHL(TAR)
Mostacillastrum gracile	CHL(TAR, ANT, COQ)
Mostacillastrum hunzikeri	ARG(CAT, LRI)
Mostacillastrum leptocarpum	ARG(MEN, SJU) / CHL(COQ, VAL, RME)
Mostacillastrum orbignyanum	ARG(CAT, COR, JUJ, LPA, LRI, MEN, SAL, SDE, SJU, SLU, TUC)
Mostacillastrum pectinifolium	CHL(TAR, ANT)
Mostacillastrum sagittatum	CHL(ANT, ATA, COQ, VAL, BIO, RME)
Mostacillastrum saltaensis	ARG(JUJ, SAL)
Mostacillastrum stenophyllum	ARG(CAT, COR, JUJ, LRI, SLU, SDE, TUC)
Mostacillastrum subscandens	ARG(CHU, LPA, NEU, RNE)
Mostacillastrum ventanense	ARG(BAI)
Mourera aspera	ARG(COS, MIS) / BRA(PAR)
Mourera weddelliana	BRA(SCA)
Mouriri chamissoana	BRA(PAR, SCA)
Mucuna sloanei	ARG(MIS) / BRA(PAR, SCA)
Muehlenbeckia fruticulosa	CHL(TAR)
Muehlenbeckia hastulata var. fascicularis	ARG(RNE) / CHL(VAL, LBO, MAU, BIO, ARA, LLA)
Muehlenbeckia hastulata var. hastulata	ARG(MEN, NEU, SJU) / CHL(ATA, COQ, VAL, LBO, MAU, BIO, ARA, LLA, RME)
Muehlenbeckia hastulata var. rotundata	ARG(CHU, MEN, NEU, RNE) / CHL(BIO, AIS, MAG)
Muehlenbeckia sagittifolia	ARG(BAI, CHA, COR, COS, ERI, FOR, JUJ, MEN, MIS, SAL, SDE, SFE, TUC) / BRA(RGS) / PRY(APY, CEN, COA, GUA, PHA, SPE) / URY(CAS, FLA, SJO)
Muehlenbeckia tamnifolia	ARG(CAT, JUJ, SAL, TUC)
Muhlenbergia alopecuroides	ARG(CAT, COR, JUJ, LRI, MEN, SAL, SJU, SLU, TUC)
Muhlenbergia angustata	ARG(COR, SAL, TUC)
Muhlenbergia angustata (J. Presl) Kunth x M. rigida	ARG(LRI, SAL, TUC)
Muhlenbergia arenicola	ARG(CAT, LPA)
Muhlenbergia asperifolia	ARG(BAI, CAT, CHU, COR, DFE, JUJ, LPA, LRI, MEN, NEU, RNE, SAL, SJU, SLU, SFE, TUC) / CHL(TAR, ANT, ATA, COQ, LLA, RME)
Muhlenbergia atacamensis	ARG(JUJ, SAL)
Muhlenbergia bryophilus	ARG(CAT, JUJ, SAL, TUC) / BRA(Fuera del área del proyecto)
Muhlenbergia ciliata	ARG(JUJ, SAL, TUC)
Muhlenbergia diversiglumis	ARG(JUJ)
Muhlenbergia fastigiata	ARG(JUJ, SAL) / CHL(TAR)
Muhlenbergia ligularis	ARG(CAT, COR, JUJ, SAL, TUC)
Muhlenbergia paniculata	ARG(BAI, COR, DFE, ERI, LPA, SLU, SFE)
Muhlenbergia peruviana	ARG(CAT, COR, JUJ, LRI, SAL, SLU, TUC) / CHL(TAR, ANT, MAU)
Muhlenbergia phalaroides	ARG(JUJ, LRI, SAL, TUC)
Muhlenbergia ramulosa	ARG(TUC)
Muhlenbergia rigida	ARG(CAT, JUJ, LRI, SAL, TUC)
Muhlenbergia schreberi	ARG(BAI, CAT, DFE, ERI, JUJ, MIS, SAL, TUC) / URY(MON)
Muhlenbergia tenuifolia	ARG(SAL)
Muhlenbergia torreyi	ARG(CAT, COR, LPA, MEN, SAL, SLU, TUC)
Mulguraea arequipensis	CHL(TAR)
Mulguraea asparagoides	ARG(CAT, JUJ, LRI, MEN, SAL, SJU, TUC) / CHL(ATA, COQ, VAL)
Mulguraea aspera var. aspera	ARG(CAT, LPA, LRI, MEN, NEU, RNE, SJU, SLU) / CHL(TAR)
Mulguraea aspera var. longidentata	ARG(CAT, JUJ, LRI, SAL, TUC)
Mulguraea cedroides	ARG(NEU, RNE)
Mulguraea cinerascens	CHL(COQ, VAL)
Mulguraea echegarayi	ARG(MEN, SJU)
Mulguraea hystrix	ARG(SJU) / CHL(ANT, ATA)
Mulguraea ligustrina var. ligustrina	ARG(CHU, MEN, NEU, SCR)
Mulguraea ligustrina var. lorentzii	ARG(BAI, CHU, LPA, MEN, NEU, RNE, SCR)
Mulguraea scoparia	ARG(CAT, LRI, MEN, NEU, RNE, SJU) / CHL(COQ, VAL, RME)
Mulguraea tetragonocalyx	ARG(CHU, RNE, SCR)
Mulguraea tridens	ARG(CHU, RNE, SCR) / CHL(MAG)
Mulinum famatinense	ARG(JUJ, LRI, SAL)
Mulinum manifolium	CHL(RME)
Munnozia hastifolia	ARG(JUJ, SAL)
Munroa andina	ARG(CAT, JUJ, LRI, SAL, TUC) / CHL(TAR, ANT)
Munroa argentina	ARG(CAT, COR, JUJ, LRI, MEN, SAL, SJU, TUC) / CHL(ANT)
Munroa decumbens	ARG(CAT, JUJ, LRI, SAL, SJU, TUC) / CHL(TAR, ANT)
Munroa mendocina	ARG(CAT, LRI, MEN, SJU)
Muntingia calabura	ARG(JUJ, SAL) / BRA(Fuera del área del proyecto)
Mutisia acerosa	ARG(MEN) / CHL(COQ, VAL, LBO, MAU, RME)
Mutisia acuminata var. hirsuta	CHL(TAR)
Mutisia acuminata var. paucijuga	ARG(JUJ, SAL, TUC)
Mutisia araucana	CHL(BIO, ARA)
Mutisia brachyantha	CHL(COQ, MAU, BIO, RME)
Mutisia burkartii	ARG(NEU)
Mutisia campanulata	ARG(MIS) / BRA(PAR, RGS, SCA) / PRY(APA, ITA)
Mutisia cana	CHL(ATA, COQ, VAL, RME)
Mutisia castellanosii var. castellanosii	ARG(SLU)
Mutisia castellanosii var. hieronymi	ARG(CAT, LRI, MEN, SJU)
Mutisia castellanosii var. comechingoniana	ARG(COR)
Mutisia coccinea var. dealbata	ARG(BAI, CHA, COS, ERI, FOR, MIS, SFE) / BRA(RGS, SCA) / PRY(APA, CAU, CAA, COA, GUA, ITA, PAI) / URY(CLA, FLO, MON, RNO, ROC)
Mutisia coccinea var. coccinea	BRA(PAR, RGS)
Mutisia decurrens var. patagonica	ARG(CHU, NEU, RNE) / CHL(BIO)
Mutisia decurrens var. decurrens	ARG(CHU, NEU, RNE) / CHL(LBO, MAU, BIO, ARA, AIS, RME)
Mutisia friesiana	ARG(JUJ, SAL)
Mutisia hamata	ARG(JUJ, SAL) / CHL(TAR, ANT)
Mutisia homoeantha	ARG(SAL)
Mutisia ilicifolia var. ilicifolia	CHL(COQ, VAL, LBO, MAU, BIO, RME)
Mutisia ilicifolia var. decandolleana	CHL(COQ, VAL, RME)
Mutisia involucrata	CHL(LBO, MAU, RME)
Mutisia kurtzii var. kurtzii	ARG(CAT, JUJ, LRI, SAL)
Mutisia kurtzii var. pinnata	ARG(JUJ)
Mutisia kurtzii var. anomala	ARG(CAT, JUJ, LRI, SAL, TUC)
Mutisia lanigera	CHL(TAR, ANT)
Mutisia latifolia f. bracteata	CHL(COQ)
Mutisia latifolia f. latifolia	CHL(VAL, RME)
Mutisia ledifolia	ARG(JUJ, SAL, TUC) / CHL(TAR, ANT)
Mutisia linearifolia	ARG(MEN, NEU) / CHL(LBO, MAU, BIO)
Mutisia linifolia	ARG(MEN, SJU)
Mutisia macrophylla	CHL(BIO)
Mutisia oligodon	ARG(CHU, NEU, RNE) / CHL(BIO, ARA)
Mutisia orbignyana	ARG(JUJ)
Mutisia retrorsa var. retrosa	ARG(CHU, MEN, NEU, SCR)
Mutisia rosea	CHL(COQ, VAL, LBO, MAU, BIO, RME)
Mutisia saltensis	ARG(JUJ, SAL)
Mutisia sinuata	ARG(MEN, SJU) / CHL(ATA, COQ, VAL, LBO, RME)
Mutisia speciosa	ARG(MIS) / BRA(PAR, RGS, SCA) / PRY(APA, AMA, CAU, CAA, CAN, COA, GUA)
Mutisia spectabilis	CHL(COQ, VAL)
Mutisia spinosa var. spinosa	ARG(CHU, NEU, RNE, SCR) / CHL(MAU, BIO, ARA, LLA)
Mutisia spinosa var. pulchella	ARG(CHU, NEU, RNE, SCR) / CHL(VAL, LBO, ARA, LLA, AIS)
Mutisia splendens	CHL(VAL, RME)
Mutisia subspinosa	ARG(LRI, MEN, SJU) / CHL(ATA, BIO)
Mutisia subulata f. rosmarinifolia	CHL(COQ, VAL, LBO, MAU, BIO, RME)
Mutisia subulata f. subulata	ARG(NEU) / CHL(COQ, VAL, LBO, MAU, BIO, RME)
Mutisia tridens	CHL(BIO)
Myoporum laetum	ARG(BAI) / CHL(VAL) / URY(ROC)
Myoschilos oblongum	ARG(CHU, NEU, RNE, SCR, TDF) / CHL(COQ, VAL, LBO, MAU, BIO, ARA, LLA, AIS, MAG, RME)
Myosotis albiflora	ARG(TDF) / CHL(AIS, MAG)
Myosotis antarctica	CHL(MAG)
Myosotis arvensis	ARG(BAI, LPA, NEU, TDF, TUC)
Myosotis azorica	ARG(BAI, CHU, MEN, NEU, RNE)
Myosotis discolor ssp. canariensis	CHL(AIS, MAG)
Myosotis discolor ssp. discolor	ARG(CHU, NEU, RNE, SCR, TDF) / CHL(MAG)
Myosotis latifolia	BRA(Fuera del área del proyecto) / CHL(ATA, BIO, LLA, RME) / URY(MON)
Myosotis laxa	ARG(BAI, CHU, DFE, NEU, RNE) / BRA(PAR) / CHL(LBO, MAU, BIO, ARA, LLA, AIS, JFE)
Myosotis ramosissima	CHL(MAG)
Myosotis scorpioides	ARG(CHU, NEU, RNE) / CHL(ARA, LLA, AIS, RME)
Myosotis stricta	ARG(CHU, NEU, RNE, SCR, TDF) / CHL(MAG)
Myosotis sylvatica	ARG(NEU, RNE) / CHL(JFE)
Myosotis verna	ARG(BAI, CHU, RNE, SCR, TDF)
Myosurus apetalus	ARG(CHU, NEU, RNE, SCR, SJU) / CHL(COQ, MAG, RME)
Myosurus patagonicus	ARG(CHU, LPA, NEU, SCR, TDF) / CHL(BIO, MAG, RME)
Myoxanthus exasperatus	BRA(PAR, SCA)
Myrceugenia acutiflora	BRA(PAR, SCA)
Myrceugenia alpigena var. fuligena	BRA(PAR, RGS, SCA)
Myrceugenia alpigena var. alpigena	BRA(PAR, SCA)
Myrceugenia bocaiuvensis	BRA(PAR)
Myrceugenia brevipes	BRA(RGS)
Myrceugenia camargoana	BRA(RGS)
Myrceugenia campestris	BRA(PAR, RGS, SCA)
Myrceugenia chrysocarpa	ARG(CHU, NEU, RNE) / CHL(MAU, BIO, ARA, LLA)
Myrceugenia colchaguensis	CHL(LBO, MAU, BIO, ARA, RME)
Myrceugenia correifolia	CHL(COQ, VAL, LBO, MAU)
Myrceugenia cucullata	BRA(PAR, RGS, SCA)
Myrceugenia euosma	ARG(MIS) / BRA(PAR, RGS, SCA) / PRY(CAU, GUA, PAI) / URY(CLA, RIV, TAC, TYT)
Myrceugenia exsucca	ARG(CHU, NEU, RNE) / CHL(COQ, VAL, LBO, MAU, BIO, ARA, LLA, AIS, RME)
Myrceugenia franciscensis	BRA(PAR)
Myrceugenia gertii	BRA(PAR)
Myrceugenia glaucescens var. latior	BRA(PAR, SCA)
Myrceugenia glaucescens var. glaucescens	ARG(BAI, COS, ERI, MIS) / BRA(PAR, RGS, SCA) / PRY(ITA) / URY(ART, CAS, CLA, COL, DUR, FLO, FLA, MAL, MON, PAY, RIV, ROC, SAO, SJO, SOR, TYT)
Myrceugenia hamoniana	BRA(RGS, SCA)
Myrceugenia hatschbachii	BRA(PAR)
Myrceugenia hoehnei	BRA(SCA)
Myrceugenia kleinii	BRA(PAR, SCA)
Myrceugenia lanceolata	CHL(VAL, LBO, MAU, BIO, ARA, RME)
Myrceugenia leptocalyx	BRA(RGS)
Myrceugenia leptospermoides	CHL(BIO, ARA)
Myrceugenia mesomischa	BRA(RGS, SCA)
Myrceugenia miersiana	BRA(PAR, RGS, SCA)
Myrceugenia myrcioides var. myrcioides	BRA(PAR, SCA)
Myrceugenia myrcioides var. acrophylla	BRA(PAR, RGS, SCA)
Myrceugenia myrtoides	BRA(RGS) / URY(CLA, TAC)
Myrceugenia obtusa	CHL(COQ, VAL, LBO, MAU, BIO, ARA, RME)
Myrceugenia ovalifolia	BRA(PAR)
Myrceugenia ovata var. acutata	BRA(PAR, SCA)
Myrceugenia ovata var. nannophylla	ARG(NEU) / CHL(MAU, BIO, ARA, LLA)
Myrceugenia ovata var. regnelliana	BRA(PAR, RGS, SCA)
Myrceugenia ovata var. ovata	CHL(BIO, ARA, LLA)
Myrceugenia oxysepala	BRA(PAR, RGS, SCA)
Myrceugenia parvifolia	CHL(MAU, BIO, ARA, LLA)
Myrceugenia pilotantha var. nothorufa	BRA(SCA)
Myrceugenia pilotantha var. pilotantha	BRA(SCA)
Myrceugenia pinifolia	CHL(MAU, BIO, ARA)
Myrceugenia planipes	ARG(NEU) / CHL(BIO, ARA, LLA, AIS)
Myrceugenia reitzii	BRA(PAR, SCA)
Myrceugenia rufa	CHL(COQ, VAL, RME)
Myrceugenia rufescens	BRA(PAR, SCA)
Myrceugenia schulzei	CHL(JFE)
Myrceugenia scutellata	BRA(PAR, SCA)
Myrceugenia seriatoramosa	BRA(PAR)
Myrceugenia venosa	BRA(PAR, SCA)
Myrcia anomala	ARG(COS, MIS) / BRA(PAR, RGS, SCA) / PRY(AMA, CAA, CAN, CON, COA, GUA, ITA, MIE, PAI)
Myrcia arborescens	BRA(PAR, RGS, SCA)
Myrcia bella	BRA(PAR) / PRY(AMA, CON)
Myrcia bicarinata	BRA(SCA)
Myrcia breviramis	BRA(PAR, SCA)
Myrcia calumbaensis	BRA(PAR, SCA)
Myrcia catharinensis	BRA(PAR, SCA)
Myrcia dasyblasta	BRA(Fuera del área del proyecto) / PRY(AMA, COA)
Myrcia dichrophylla	BRA(SCA)
Myrcia dictyophleba	BRA(PAR, SCA)
Myrcia eugeniopsoides	BRA(PAR, RGS, SCA)
Myrcia ferruginosa	BRA(PAR, RGS, SCA)
Myrcia gemmiflora	BRA(Fuera del área del proyecto) / PRY(SPE)
Myrcia glabra	BRA(RGS, SCA)
Myrcia guianensis	BRA(PAR, RGS, SCA) / PRY(CAN)
Myrcia hassleriana	PRY(CON, SPE)
Myrcia hatschbachii	BRA(PAR, RGS, SCA)
Myrcia heringii	BRA(PAR, SCA)
Myrcia jaguariaivenisis	BRA(PAR)
Myrcia lajeana	BRA(PAR, RGS, SCA)
Myrcia laruotteana var. paraguayensis	ARG(MIS) / BRA(PAR, SCA) / PRY(CAN, CEN, COA, SPE)
Myrcia laruotteana var. australis	ARG(COS, MIS) / BRA(PAR, SCA)
Myrcia laruotteana var. laruotteana	BRA(PAR, SCA)
Myrcia leptoclada	BRA(PAR, SCA)
Myrcia multiflora f. ovalifolia	BRA(PAR, SCA)
Myrcia multiflora var. glaucescens	BRA(PAR, RGS, SCA)
Myrcia multiflora var. multiflora	BRA(PAR, RGS, SCA) / PRY(APA, CAU, CAN, COA, ÑEE, PAI, SPE)
Myrcia multipunctata	BRA(PAR)
Myrcia oblongata	ARG(COS, MIS) / BRA(PAR, RGS, SCA) / PRY(CAA, CAN, PAI)
Myrcia obtecta var. obtecta	BRA(PAR, RGS, SCA) / PRY(AMA, CAN, SPE)
Myrcia obtecta var. alternifolia	BRA(SCA)
Myrcia pubipetala var. pubipetala	BRA(PAR, SCA)
Myrcia pubipetala var. magnifolia	BRA(SCA)
Myrcia racemosa var. gaudichaudiana	BRA(PAR, SCA)
Myrcia reitzii	BRA(PAR, SCA)
Myrcia richardiana var. fenzliana	BRA(PAR, RGS, SCA)
Myrcia richardiana var. richardiana	BRA(PAR, SCA)
Myrcia rostrata f. rostrata	BRA(PAR, SCA) / PRY(AMA, CAN)
Myrcia rostrata f. flexuosa	BRA(PAR)
Myrcia rostrata f. gracilis	BRA(PAR, SCA)
Myrcia rupicola	BRA(PAR, SCA)
Myrcia selloi var. microsiphonata	BRA(RGS, SCA)
Myrcia selloi var. selloi	ARG(CHA, COS, ERI, FOR, MIS, SFE) / BRA(RGS, SCA) / PRY(APA, AMA, CAA, CAN, CON, COA, GUA, ÑEE, PAI, PHA) / URY(ART, RIV, SAO)
Myrcia sosias	BRA(PAR, SCA)
Myrcia splendens	BRA(PAR)
Myrcia stemmeriana	BRA(SCA)
Myrcia tenuivenosa	BRA(PAR, SCA)
Myrcia tomentosa	BRA(PAR)
Myrcia vellozoi	BRA(PAR)
Myrcia venulosa var. venulosa	BRA(RGS, SCA)
Myrcia venulosa var. dives	BRA(PAR)
Myrcia verticillaris	BRA(RGS) / URY(ART, CLA, RIV, TAC)
Myrcianthes callicoma	ARG(TUC)
Myrcianthes cisplatensis	ARG(CAT, COR, COS, ERI, SAL, SFE, TUC) / BRA(RGS, SCA) / URY(COL, DUR, MAL, PAY, RIV, SAO, SOR, TAC, TYT)
Myrcianthes coquimbensis	CHL(COQ)
Myrcianthes gigantea	ARG(MIS) / BRA(PAR, RGS, SCA) / URY(RIV, TYT)
Myrcianthes mato	ARG(CAT, JUJ, SAL, TUC)
Myrcianthes minimifolia	ARG(JUJ)
Myrcianthes pedersenii	PRY(MIE)
Myrcianthes pseudomato	ARG(JUJ, SAL, TUC)
Myrcianthes pungens	ARG(CAT, CHA, COS, ERI, FOR, JUJ, MIS, SAL, SFE, TUC) / BRA(PAR, RGS, SCA) / PRY(APA, CAN, CEN, GUA, ÑEE, PAI) / URY(CLA, PAY, RIV, SAO, SOR, TAC)
Myrcianthes riparia	BRA(RGS, SCA)
Myrciaria axillaris	BRA(SCA)
Myrciaria cuspidata	BRA(PAR, RGS, SCA) / PRY(APY, APA, AMA, CAU, CAA, CAN, CON, COA, GUA, PAI, SPE)
Myrciaria floribunda	BRA(PAR, RGS, SCA) / PRY(APA, AMA, CAN, PAI)
Myrciaria plinioides	BRA(RGS, SCA)
Myrciaria tenella	ARG(JUJ, MIS, SAL) / BRA(PAR, RGS, SCA) / PRY(CAN) / URY(CLA, TAC)
Myriocarpa stipitata	ARG(JUJ, MIS, SAL) / BRA(PAR)
Myriophyllum aquaticum	ARG(BAI, COR, COS, ERI, JUJ, MIS, SAL, SFE, SJU, TUC) / BRA(PAR, RGS, SCA) / CHL(TAR, ANT, ATA, COQ, VAL, LBO, MAU, BIO, ARA, LLA, AIS, MAG, RME) / PRY(APY, CEN, CHO, COA, GUA, ÑEE) / URY(DUR, MON, SJO)
Myriophyllum quitense	ARG(BAI, CAT, CHU, COR, JUJ, LPA, MEN, NEU, RNE, SCR, SFE, SJU, TDF, TUC) / CHL(TAR, ANT, ATA, COQ, VAL, MAU, BIO, ARA, LLA, AIS, MAG, RME) / URY(MON, SJO)
Myriopteris aurea	ARG(CAT, COR, JUJ, LPA, MEN, SAL, SJU, SLU, TUC) / CHL(ANT)
Myriopteris microphylla	ARG(SAL)
Myriopteris myriophylla	ARG(BAI, CAT, COR, JUJ, LPA, LRI, MEN, SAL, SJU, SLU, TUC) / CHL(TAR)
Myriopteris notholaenoides	ARG(JUJ, SAL, TUC)
Myriopus breviflorus	ARG(COS, MIS) / BRA(PAR, RGS, SCA) / PRY(AMA, CEN, PAI) / URY(ROC)
Myriopus paniculatus	ARG(CAT, COS, FOR, JUJ, MIS, SAL, SDE, TUC) / BRA(PAR, RGS) / PRY(APY, AMA, CAA, CAN, CEN, CON, COA, GUA, ITA, SPE) / URY(SAO)
Myriopus rubicundus	ARG(CHA, COS, ERI, FOR, JUJ, MIS, SAL, SFE, SDE, TUC) / BRA(PAR, SCA) / PRY(APA, APY, BOQ, CAA, CAN, CEN, CON, COA, ÑEE, PAI, PHA, SPE)
Myriopus salzmannii	ARG(CHA, COS, FOR, JUJ, SAL) / BRA(Fuera del área del proyecto) / PRY(APY, AMA, BOQ, CEN, COA, ÑEE, PAI, PHA)
Myriopus villosus	ARG(COS, JUJ, MIS, TUC) / BRA(PAR, SCA)
Myriopus volubilis	ARG(CHA)
Myrocarpus frondosus	ARG(COS, MIS) / BRA(PAR, RGS, SCA) / PRY(APA, CAN, CON, COA, GUA, ITA, PAI)
Myrosmodes gymnandra	ARG(CAT, JUJ, LRI, TUC)
Myrosmodes nervosa	CHL(TAR, ANT)
Myrosmodes paludosa	ARG(JUJ, SAL, TUC)
Myroxylon peruiferum	ARG(JUJ, SAL) / BRA(PAR)
Myrrhinium atropurpureum var. octandrum	ARG(CAT, COS, ERI, JUJ, MIS, SAL, TUC) / BRA(PAR, RGS, SCA) / URY(DUR, MON, PAY, RIV, ROC, SAO, TAC, TYT)
Myrsine altomontana	BRA(PAR, SCA)
Myrsine balansae	ARG(MIS) / BRA(PAR, SCA) / PRY(APA, AMA, CAU, CAN, COA, GUA, PAI)
Myrsine coriacea	ARG(COS, ERI, JUJ, MIS, SAL, TUC) / BRA(PAR, RGS, SCA) / PRY(APA, AMA, CAA, CAN, CEN, COA, GUA, PAI) / URY(LAV, MAL, RIV, ROC, TYT)
Myrsine gardneriana	BRA(PAR, SCA)
Myrsine guianensis	BRA(PAR, RGS, SCA) / PRY(AMA, CAU, COA, PAI) / URY(ROC)
Myrsine laetevirens	ARG(BAI, CAT, COS, ERI, FOR, JUJ, MIS, SAL, SFE, TUC) / BRA(PAR, RGS) / PRY(APA, CAA, CAN, CEN, COA, GUA, PAI, PHA) / URY(CAS, COL, MAL, PAY, ROC, SJO, TAC)
Myrsine ligustrina	PRY(AMA, CAU)
Myrsine loefgrenii	ARG(COS, ERI, MIS) / BRA(PAR, RGS, SCA) / PRY(APA, AMA, SPE)
Myrsine matensis	BRA(Fuera del área del proyecto) / PRY(AMA, CEN, CON, COA, PAI, SPE)
Myrsine parvifolia	BRA(PAR, RGS, SCA) / URY(ROC)
Myrsine parvula	ARG(BAI, COS, ERI, MIS) / BRA(PAR, RGS, SCA) / PRY(APA, AMA, CAU, CAA, CAN, CEN, CON, COA, MIE, PAI, SPE) / URY(SAO, TAC, TYT)
Myrsine rubra	BRA(PAR)
Myrsine umbellata	ARG(MIS) / BRA(PAR, RGS, SCA) / PRY(AMA, CAU, CAA, COA, PAI) / URY(MON, ROC)
Myrsine venosa	BRA(PAR, SCA)
Myrsine wettsteinii	BRA(PAR, RGS, SCA)
Myrteola nummularia	ARG(NEU, RNE, SCR, TDF) / CHL(BIO, ARA, LLA, AIS, MAG, JFE)
