Haageocereus australis	CHL(TAR)
Haageocereus fascicularis	CHL(TAR)
Habenaria amambayensis	BRA(Fuera del área del proyecto) / PRY(AMA, CEN)
Habenaria anisitsii	BRA(Fuera del área del proyecto) / PRY(AMA)
Habenaria araneifolia	BRA(PAR, RGS, SCA)
Habenaria armata	BRA(PAR)
Habenaria balansae	BRA(PAR, RGS, SCA) / PRY(CAU)
Habenaria bractescens	ARG(BAI, CHA, COR, COS, ERI, FOR, JUJ, MIS, SAL, TUC) / BRA(PAR, RGS, SCA) / PRY(CAN) / URY(ART, CLA, COL, LAV, MAL, MON, RIV)
Habenaria castellanosii	URY(SJO)
Habenaria crassipes	BRA(RGS)
Habenaria distans	ARG(JUJ, SAL, TUC) / BRA(PAR)
Habenaria dusenii	BRA(PAR)
Habenaria dutraei	BRA(RGS)
Habenaria edwallii	BRA(PAR, RGS)
Habenaria ekmaniana	ARG(COS, MIS) / BRA(RGS, SCA) / PRY(SPE)
Habenaria exaltata	BRA(PAR, RGS)
Habenaria gourlieana	ARG(BAI, CHA, COR, COS, ERI, FOR, JUJ, LRI, MEN, MIS, SAL, SJU, SLU, TUC) / BRA(RGS) / PRY(CAU, ÑEE, SPE) / URY(CLA, COL, FLA, LAV, MAL, MON, RNO, RIV, ROC, SAO, SJO, SOR, TAC, TYT)
Habenaria graciliscapa	BRA(Fuera del área del proyecto) / URY(CAS, SAO)
Habenaria guentheriana	ARG(SAL)
Habenaria guilleminii	BRA(PAR, RGS, SCA) / PRY(AMA)
Habenaria gustavi-edwallii	BRA(RGS, SCA)
Habenaria habenarioides	BRA(PAR)
Habenaria hassleriana	ARG(MIS) / PRY(APA, CAU, CAA, COA, GUA, PAI)
Habenaria heleogena	BRA(PAR)
Habenaria henscheniana	BRA(PAR)
Habenaria hexaptera	ARG(CAT, COR, JUJ, SAL, SLU, TUC)
Habenaria humilis	BRA(PAR, SCA)
Habenaria inconspicua	BRA(PAR, RGS, SCA) / URY(CAS)
Habenaria integripetala	PRY(CAU)
Habenaria jaguariahyvae	BRA(PAR)
Habenaria johannensis	BRA(PAR, RGS, SCA) / PRY(COA, GUA, ÑEE)
Habenaria josephensis	BRA(PAR, RGS, SCA) / PRY(GUA)
Habenaria leucosantha var. leucosantha	BRA(PAR, RGS, SCA) / PRY(AMA)
Habenaria leucosantha var. riograndensis	BRA(RGS)
Habenaria leucosantha var. berroana	BRA(PAR) / URY(RIV)
Habenaria macrodactyla	BRA(PAR)
Habenaria macronectar	BRA(PAR, RGS, SCA) / PRY(GUA) / URY(RNO, SJO)
Habenaria megapotamensis	BRA(PAR, RGS)
Habenaria melanopoda	BRA(PAR, RGS, SCA)
Habenaria mitomorpha	BRA(PAR)
Habenaria montevidensis	BRA(PAR, RGS, SCA) / URY(CLA, LAV, MON, SJO, TAC)
Habenaria montiswilhelminae	BRA(PAR, RGS)
Habenaria nemorosa	BRA(PAR)
Habenaria nuda	BRA(PAR)
Habenaria obtusa	ARG(JUJ) / BRA(PAR) / PRY(AMA)
Habenaria paivaeana	ARG(COR, COS, JUJ, MIS, SAL, TUC) / BRA(RGS, SCA) / URY(CLA, LAV, MAL, MON, SJO, TAC)
Habenaria paranaensis	BRA(PAR) / PRY(PAI, SPE)
Habenaria parviflora	ARG(BAI, CAT, COR, COS, ERI, JUJ, MIS, SAL, SDE, TUC) / BRA(PAR, RGS, SCA) / PRY(COA, GUA, MIE) / URY(CAS, CLA, FLA, LAV, MAL, MON, PAY, RNO, RIV, ROC, SAO, SJO, SJO, TAC, TYT)
Habenaria petalodes	ARG(JUJ, MIS, SAL) / BRA(Fuera del área del proyecto)
Habenaria piraquarensis	BRA(PAR)
Habenaria platanthera	URY(CLA, MAL)
Habenaria pleiophylla	BRA(PAR, RGS, SCA)
Habenaria polygonoides	BRA(PAR)
Habenaria pumila	ARG(BAI, LRI, MEN, NEU, RNE, SJU) / CHL(ATA, COQ, LBO, MAU, BIO, ARA, LLA)
Habenaria regnellii	ARG(COS) / BRA(PAR, RGS, SCA)
Habenaria repens	ARG(BAI, CHA, COS, ERI, SFE) / BRA(PAR, RGS, SCA) / PRY(APA, CEN, GUA) / URY(CAS, MAL, MON, SJO)
Habenaria rodeiensis	BRA(PAR) / PRY(CON)
Habenaria rolfeana	BRA(PAR)
Habenaria rupicola	ARG(COR, COS) / BRA(PAR, SCA)
Habenaria sceptrum	BRA(RGS) / URY(TAC)
Habenaria schenckii	ARG(TUC) / BRA(Fuera del área del proyecto)
Habenaria schnittmeyeri	BRA(RGS)
Habenaria schwackei	BRA(PAR) / PRY(CAN)
Habenaria secunda	ARG(COS, ERI, MIS) / PRY(AMA, CAU, CAN)
Habenaria secundiflora	BRA(PAR)
Habenaria subfiliformis	BRA(PAR) / PRY(CAU)
Habenaria subviridis	BRA(PAR, SCA)
Habenaria tamanduensis	BRA(PAR)
Habenaria trifida	ARG(JUJ, MIS, SAL, SJU, TUC) / BRA(Fuera del área del proyecto) / PRY(APY, CON)
Habenaria ulaei	BRA(SCA)
Habenaria umbraticola	BRA(PAR, SCA)
Habenaria warmingii	ARG(SAL) / BRA(Fuera del área del proyecto)
Habranthus amambaicus	PRY(AMA)
Habranthus andalgalensis	ARG(CAT, SAL, SJU)
Habranthus auratus	PRY(PHA)
Habranthus brachyandrus	ARG(CHA, COR, COS, FOR, SFE, SLU) / PRY(SPE)
Habranthus caaguazuensis	PRY(CAU, CON)
Habranthus caeruleus	ARG(ERI) / BRA(PAR, RGS, SCA) / URY(CLA, MAL, RNO, ROC, SAO, SOR)
Habranthus calderensis	ARG(JUJ, SAL)
Habranthus chacoensis	ARG(CHA) / PRY(PHA)
Habranthus concinnus	BRA(PAR)
Habranthus correntinus	ARG(COS)
Habranthus gracilifolius	ARG(BAI, COS, SFE) / URY(MAL, RIV)
Habranthus jamesonii	ARG(BAI, CAT, CHU, LPA, LRI, MEN, RNE, SAL, SJU, SLU)
Habranthus leonensis	PRY(APY)
Habranthus martinezii	ARG(BAI, ERI, SAL)
Habranthus matacus	ARG(FOR)
Habranthus mendocensis	ARG(MEN)
Habranthus neumannii	ARG(JUJ)
Habranthus pedunculosus	ARG(BAI, CHA, COS, ERI, MIS, SFE) / BRA(RGS) / PRY(GUA, MIE) / URY(ART, MON, RIV)
Habranthus philadelphicus	PRY(APY)
Habranthus pictus	ARG(CAT)
Habranthus riojanus	ARG(LRI)
Habranthus robustus	ARG(CAT, COR, JUJ, LRI, MIS, SAL, SJU, SLU, TUC) / BRA(PAR, SCA)
Habranthus ruber	BRA(RGS)
Habranthus ruizlealii	ARG(LRI)
Habranthus salinarum	ARG(COS)
Habranthus sanavirone	ARG(COR)
Habranthus schulzianus	ARG(SFE)
Habranthus tubispathus	ARG(BAI, COS, ERI, SFE) / BRA(Fuera del área del proyecto) / CHL(BIO) / PRY(COA, PHA) / URY(CAS, CLA, LAV, MON, PAY, RNO, ROC, SJO, SOR, TYT)
Habranthus venturianus	ARG(SDE)
Habranthus versicolor	ARG(BAI) / PRY(APY) / URY(LAV, MAL, MON, SAO, SOR, TYT)
Hackelia revoluta	ARG(CAT, COR, JUJ, LRI, SAL, SLU, TUC)
Hackelochloa granularis	ARG(SAL) / PRY(AMA, CON, PAI)
Hagenbachia angusta	BRA(Fuera del área del proyecto) / PRY(AMA)
Hagenbachia hassleriana	PRY(CAN)
Hainardia cylindrica	ARG(BAI) / CHL(VAL, BIO) / URY(MON)
Halenia hieronymi	ARG(JUJ, SAL, TUC)
Halerpestes cymbalaria	ARG(BAI, CAT, CHU, COR, JUJ, LPA, LRI, MEN, NEU, RNE, SAL, SCR, SFE, SJU, SLU, TDF, TUC) / CHL(TAR, ANT, ATA, COQ, VAL, LBO, MAU, AIS, MAG, RME)
Halerpestes exilis	ARG(CAT, JUJ, LRI, MEN, SAL, SJU, TUC) / CHL(TAR, ANT, ATA, COQ)
Halerpestes uniflora	ARG(CAT, CHU, MEN, NEU, SAL, SCR, TDF) / CHL(TAR, ANT, ATA, MAU, BIO, AIS, MAG)
Halodule wrightii	BRA(SCA)
Halophytum ameghinoi	ARG(CAT, CHU, LRI, MEN, NEU, RNE, SCR, SJU, SLU)
Haloragis masafuerana var. asperrima	CHL(JFE)
Haloragis masafuerana var. masafuerana	CHL(JFE)
Haloragis masatierrana	CHL(JFE)
Halosicyos ragonesei	ARG(CAT, COR, LRI, MEN, SJU, SLU)
Hamadryas argentea	ARG(TDF)
Hamadryas delfinii	ARG(CHU, NEU, SCR, SJU, TDF) / CHL(MAG)
Hamadryas kingii	ARG(CHU, RNE, SCR) / CHL(MAG)
Hamadryas magellanica f. magellanica	ARG(TDF) / CHL(MAG)
Hamadryas magellanica f. paniculata	ARG(TDF)
Hamadryas sempervivoides	ARG(SCR) / CHL(MAG)
Hamelia patens	ARG(CHA, JUJ, MIS, SAL, TUC) / BRA(PAR, SCA) / PRY(APA, AMA, CAA, CAN, CON, COA, GUA, ÑEE, PAI, SPE)
Hancornia speciosa	BRA(PAR) / PRY(AMA, CAN, CON, SPE)
Handroanthus albus	ARG(MIS) / BRA(PAR, RGS, SCA) / PRY(APA, ITA)
Handroanthus catarinensis	BRA(PAR, SCA)
Handroanthus chrysotrichus	BRA(PAR, RGS, SCA)
Handroanthus heptaphyllus	ARG(CHA, COS, ERI, FOR, MIS, SFE) / BRA(PAR, RGS, SCA) / PRY(APY, APA, AMA, CAN, CEN, CON, COA, GUA, MIE, ÑEE, PAI, PHA, SPE) / URY(ROC, SAO)
Handroanthus impetiginosus	ARG(CAT, JUJ, SAL, TUC) / BRA(Fuera del área del proyecto) / PRY(APY, AMA, CAN, CEN, CON, COA, GUA, PAI, PHA)
Handroanthus lapacho	ARG(JUJ, SAL)
Handroanthus ochraceus	ARG(JUJ, SAL) / BRA(PAR, SCA) / PRY(APY, APA, AMA, CAU, CAN, CEN, COA, GUA, PAI, SPE)
Handroanthus pulcherrimus	ARG(COS, MIS) / BRA(RGS, SCA) / PRY(APA, CAU, CAA, ITA, MIE, ÑEE)
Handroanthus serratifolius	BRA(PAR)
Handroanthus umbellatus	BRA(PAR, RGS, SCA)
Handroanthus vellosoi	BRA(PAR)
Hapalorchis candidus	BRA(PAR, RGS)
Hapalorchis lineatus	ARG(MIS, SAL) / BRA(PAR, RGS, SCA)
Hapalorchis micrantha	BRA(PAR, RGS, SCA)
Hapalorchis pauciflorus	BRA(PAR, SCA)
Hapalorchis stellaris	BRA(RGS)
Haplopappus angustifolius	CHL(ATA, COQ)
Haplopappus anthylloides	ARG(MEN) / CHL(LBO, MAU, RME)
Haplopappus baylahuen	ARG(SJU) / CHL(ATA, COQ)
Haplopappus bezanillanus	CHL(COQ)
Haplopappus boelckei	ARG(MEN)
Haplopappus canescens	CHL(VAL, MAU, RME)
Haplopappus cerberoanus	CHL(ATA, COQ)
Haplopappus chrysanthemifolius	CHL(COQ, VAL, LBO, MAU, BIO, RME)
Haplopappus decurrens	CHL(COQ, VAL, LBO)
Haplopappus deserticolus	CHL(ANT, ATA, COQ)
Haplopappus diplopappus ssp. villosus	ARG(CHU, MEN, SCR) / CHL(VAL, LBO, MAU, RME)
Haplopappus donianus	CHL(VAL, MAU, BIO)
Haplopappus elatus	CHL(COQ)
Haplopappus foliosus	CHL(COQ, VAL, LBO, MAU, RME)
Haplopappus glutinosus	ARG(CHU, NEU, RNE, SCR) / CHL(VAL, LBO, MAU, BIO, ARA, LLA, AIS)
Haplopappus graveolens	CHL(RME)
Haplopappus grindelioides	ARG(CHU, MEN, NEU, RNE, SCR) / CHL(MAU, BIO, ARA, RME)
Haplopappus hirtellus	CHL(ATA, COQ, VAL)
Haplopappus humilis	CHL(LBO, RME)
Haplopappus integerrimus var. integerrimus	CHL(COQ, VAL, BIO, RME)
Haplopappus integerrimus var. punctatus	CHL(MAU, BIO)
Haplopappus ischnos	CHL(COQ)
Haplopappus kingii	CHL(ATA)
Haplopappus latifolius	CHL(COQ)
Haplopappus linifolius	CHL(ATA, COQ)
Haplopappus macraeanus	CHL(COQ, VAL)
Haplopappus macrocephalus	CHL(VAL, LBO, MAU, BIO, ARA, RME)
Haplopappus mendocinus	ARG(LPA, MEN)
Haplopappus meyenii	CHL(COQ)
Haplopappus mucronatus	CHL(COQ, VAL)
Haplopappus multifolius	CHL(VAL, RME)
Haplopappus nahuelbutae	CHL(ARA)
Haplopappus ochagavianus	CHL(VAL)
Haplopappus parvifolius	CHL(ATA, COQ)
Haplopappus pedunculosus	CHL(LBO, MAU, BIO)
Haplopappus philippii	CHL(ATA, COQ)
Haplopappus phyllophorus	CHL(ATA, COQ)
Haplopappus pinea	CHL(COQ)
Haplopappus pinnatifidus	CHL(VAL, LBO, MAU, RME)
Haplopappus platylepis	CHL(COQ, VAL)
Haplopappus poeppigianus	CHL(RME)
Haplopappus pristiphyllus	
Haplopappus pulchellus	CHL(COQ, VAL, LBO, MAU, RME)
Haplopappus reicheanus	CHL(COQ, RME)
Haplopappus remyanus	CHL(COQ, VAL, LBO, RME)
Haplopappus rengifoanus	CHL(COQ, LBO)
Haplopappus rigidus	ARG(CAT, SAL) / CHL(ANT, ATA, COQ)
Haplopappus rosulatus	CHL(ANT, ATA)
Haplopappus rotundifolius	CHL(VAL, RME)
Haplopappus saxatilis	CHL(COQ, MAU, RME)
Haplopappus scaposus	CHL(VAL, LBO)
Haplopappus schumannii	CHL(RME)
Haplopappus scrobiculatus	ARG(MEN, SJU) / CHL(COQ, VAL, LBO, MAU, BIO, ARA, RME)
Haplopappus serrulatus	CHL(RME)
Haplopappus stelliger	CHL(COQ)
Haplopappus stolpii	CHL(MAU, BIO, ARA, RME)
Haplopappus taeda	CHL(VAL, LBO, MAU)
Haplopappus uncinatus	CHL(COQ, VAL, LBO, MAU, RME)
Haplopappus velutinus	ARG(MEN) / CHL(COQ, VAL, LBO, MAU, BIO, RME)
Haplorhus peruviana	CHL(TAR)
Haroldia mendocina	ARG(MEN)
Harrisia bonplandii	ARG(CHA, COS, ERI, FOR, JUJ, SAL, SFE) / BRA(Fuera del área del proyecto) / PRY(APY, CON, COA, PAI, PHA, SPE)
Harrisia hahniana	PRY(CON)
Harrisia martinii	ARG(CHA, COS, ERI, FOR, SFE) / PRY(CON, COA, ÑEE, PHA)
Harrisia pomanensis ssp. pomanensis	ARG(CAT, COR, FOR, JUJ, LRI, SAL, SDE, SFE, TUC) / PRY(APY, PHA)
Harrisia pomanensis ssp. regelii	ARG(ERI, SFE) / URY(ART, RNO)
Harrisia tortuosa	ARG(CHA, COS, ERI, FOR, SFE) / PRY(APY, COA) / URY(ART)
Hatiora gaertneri	BRA(PAR, RGS, SCA)
Hatiora rosea	BRA(PAR, RGS, SCA)
Hatiora salicornioides	BRA(PAR)
Hatschbachiella tweedieana	ARG(BAI, COS, ERI, MIS, SFE) / BRA(PAR, RGS, SCA) / PRY(AMA, CAA, CEN, COA, GUA, MIE, PAI, SPE) / URY(CAS, CLA, COL, FLA, LAV, MAL, MON, RIV, ROC, SJO, TAC, TYT)
Hebanthe eriantha	ARG(MIS) / BRA(PAR, RGS, SCA) / PRY(APA, APY, AMA, CAU, CAA, GUA, ITA, SPE)
Hebanthe occidentalis	ARG(CHA, JUJ, SAL, TUC) / BRA(Fuera del área del proyecto) / PRY(AMA, CAU, CON, SPE)
Hebanthe occidentalis var. bangii	PRY(SPE)
Hebanthe pulverulenta	BRA(PAR, SCA)
Hebanthe spicata	BRA(PAR)
Hebe elliptica	ARG(TDF) / CHL(AIS, MAG)
Hebe salicifolia	CHL(LLA, AIS, MAG)
Hebeclinium macrophyllum	ARG(CHA, COS, FOR) / BRA(PAR, SCA) / PRY(AMA, CAN, CEN, CON, COA, GUA, PAI, SPE)
Hecistopteris pumila	BRA(PAR, SCA)
Hedeoma mandoniana	ARG(JUJ, SAL)
Hedeoma medium	ARG(BAI, ERI) / URY(PAY, SOR)
Hedeoma multiflora	ARG(BAI, COR, LPA, MEN, RNE, SDE, SLU) / BRA(RGS) / CHL(COQ, VAL, MAU) / URY(PAY)
Hedeoma polygalaefolium	BRA(RGS)
Hedeoma teyucuarensis	ARG(MIS)
Hedera helix	ARG(BAI, SAL)
Hedychium coronarium	ARG(BAI, COS, ERI, MIS, SAL, TUC) / BRA(PAR) / PRY(CAA, CAN, CEN, COA, GUA, SPE)
Hedyosmum brasiliense	BRA(PAR, SCA) / PRY(AMA)
Hedypnois rhagadioloides	ARG(BAI, DFE, ERI, LPA) / CHL(COQ, VAL, MAU, BIO, ARA) / URY(CAS, COL, FLA, MAL, MON, SAO, SJO, SJO)
Heimia apetala	ARG(ERI, MIS) / BRA(PAR, RGS, SCA) / PRY(APA, ITA) / URY(ART, CLA, MAL, ROC, TAC, TYT)
Heimia montana	ARG(JUJ, SAL, TUC)
Heimia salicifolia	ARG(BAI, CAT, CHA, COR, COS, ERI, FOR, JUJ, LRI, MIS, SAL, SDE, SFE, SJU, SLU, TUC) / BRA(PAR, RGS, SCA) / PRY(APY, APA, AMA, CAU, CAA, CAN, CEN, CON, COA, GUA, ITA, MIE, ÑEE, PAI, PHA) / URY(CLA, COL, FLA, MAL, RNO, ROC, TAC)
Heisteria salicifolia	BRA(SCA)
Heisteria silvianii	BRA(PAR, RGS, SCA)
Heladena multiflora	ARG(COS, MIS) / BRA(Fuera del área del proyecto) / PRY(CAU, CAN, GUA, PAI, SPE) / URY(SAO)
Helanthium bolivianum	ARG(COS, MIS, SFE) / BRA(PAR, RGS, SCA) / PRY(APA, APY, AMA, CAU, CAN, CEN, GUA, ÑEE, PAI)
Helanthium tenellum	ARG(COS, MIS) / BRA(PAR, RGS, SCA) / PRY(AMA, CAN, MIE, ÑEE) / URY(ROC)
Helenium argentinum	ARG(COR, SDE, SLU)
Helenium aromaticum	CHL(COQ, VAL, LBO, MAU, RME)
Helenium atacamense	CHL(ANT, ATA, COQ)
Helenium donianum	ARG(CAT, COR, LRI, MEN, SAL, SDE, SJU, SLU, TUC)
Helenium glaucum	CHL(COQ, VAL, LBO, MAU, BIO, ARA, LLA, RME)
Helenium insulare	CHL(BIO)
Helenium ovallense	CHL(COQ)
Helenium radiatum	ARG(BAI, COS, DFE, ERI, SFE) / URY(CAS, CLA, DUR, FLA, LAV, MAL, MON, PAY, RNO, RIV, SAO, SOR, TYT)
Helenium urmenetae var. urmenetae	CHL(ANT, ATA, COQ, RME)
Helenium urmenetae var. leguiffei	CHL(COQ)
Helenium vallenariense	CHL(ATA, COQ)
Helia oblongifolia	ARG(MIS) / BRA(PAR, SCA) / PRY(APA, AMA, CAU, CAN, CEN, COA, ITA, PAI, SPE)
Heliacme scorzonerifolia	BRA(PAR) / PRY(APY, AMA, CON)
Helianthus × laetiflorus	ARG(BAI)
Helianthus annuus	ARG(BAI, CAT, CHA, COR, ERI, LPA, SLU, SFE, SDE)
Helianthus petiolaris	ARG(BAI, COR, ERI, LPA, SLU)
Helianthus tuberosus	ARG(BAI, LPA) / URY(CAS, MON)
Heliconia brasiliensis	ARG(MIS, SAL) / BRA(SCA) / PRY(AMA)
Heliconia farinosa	BRA(PAR, RGS, SCA)
Heliconia hirsuta	ARG(MIS) / BRA(PAR) / PRY(AMA, CAU, CON, SPE)
Heliconia psittacorum	PRY(AMA, CAN)
Heliconia subulata ssp. gracilis	ARG(MIS, SAL) / BRA(PAR) / PRY(CAN)
Heliconia velloziana	BRA(RGS, SCA)
Helicteres brevispira	BRA(PAR) / PRY(AMA, SPE)
Helicteres gardneriana	BRA(Fuera del área del proyecto) / PRY(APY, APA, AMA, CAN, CON, PHA, SPE)
Helicteres lhotzkyana var. pubinervis	ARG(SAL)
Helicteres lhotzkyana var. lhotzkyana	BRA(Fuera del área del proyecto) / PRY(APY, AMA, CON)
Helietta apiculata	ARG(COS, MIS) / BRA(PAR, RGS, SCA) / PRY(APA, AMA, CAU, CAA, CAN, CEN, CON, COA, GUA, ITA, MIE, PAI, SPE)
Helietta puberula	BRA(Fuera del área del proyecto) / PRY(APY)
Heliocarpus popayanensis	ARG(CAT, JUJ, MIS, SAL, SDE, TUC) / BRA(PAR) / PRY(APA, AMA, CAU, CAA, CAN, CEN, COA, GUA, PAI, SPE)
Heliotropium abbreviatum	ARG(JUJ)
Heliotropium amplexicaule	ARG(BAI, CAT, CHA, COR, COS, DFE, ERI, FOR, JUJ, LPA, LRI, MEN, MIS, SAL, SDE, SFE, SJU, SLU, TUC) / BRA(PAR, RGS) / CHL(RME) / URY(CAS, MON, SOR, TAC)
Heliotropium angiospermum	BRA(PAR, SCA) / CHL(TAR) / PRY(COA)
Heliotropium catamarcense	ARG(CAT, LRI, MEN, SJU)
Heliotropium chenopodiaceum var. chenopodiaceum	CHL(ANT, ATA, COQ)
Heliotropium chenopodiaceum var. ericoideum	CHL(ANT, ATA, COQ)
Heliotropium chrysanthum	ARG(CAT, LPA, LRI, MEN, NEU, RNE, SAL, SJU)
Heliotropium curassavicum var. argentinum	ARG(BAI, CAT, CHA, COR, COS, DFE, ERI, FOR, JUJ, LPA, LRI, MEN, MIS, NEU, RNE, SAL, SDE, SFE, SJU, SLU, TUC) / BRA(RGS) / PRY(APY, CEN, PHA) / URY(MAL, MON)
Heliotropium curassavicum var. curassavicum	ARG(BAI, CHA, CHU, COR, COS, FOR, LRI, RNE, SAL, SLU, SDE) / CHL(TAR, ANT, ATA, COQ, VAL, LBO, RME) / PRY(APY, PHA)
Heliotropium curassavicum var. fruticulosum	ARG(LRI, MEN, SJU)
Heliotropium elongatum	ARG(CHA, COR, COS, ERI, FOR, MIS, SAL, SFE) / BRA(RGS) / PRY(APY, BOQ, CEN, COA, GUA, ÑEE, PAI, SPE) / URY(CLA)
Heliotropium eremogenum	CHL(ANT)
Heliotropium filifolium	CHL(ATA)
Heliotropium floridum	CHL(ATA)
Heliotropium geissei	ARG(MEN) / CHL(COQ, VAL, RME)
Heliotropium glutinosum	CHL(ATA)
Heliotropium huascoense	CHL(ATA)
Heliotropium inconspicuum	CHL(ANT, ATA)
Heliotropium indicum	ARG(CHA, COR, COS, ERI, FOR, JUJ, MIS, SAL, SFE, TUC) / BRA(Fuera del área del proyecto) / PRY(APY, BOQ, MIE, ÑEE, PHA)
Heliotropium jaffuelii	CHL(ANT)
Heliotropium johnstonii	ARG(CAT, COR, LRI, SDE, SJU)
Heliotropium krauseanum	CHL(TAR)
Heliotropium kurtzii	ARG(MEN, NEU)
Heliotropium leiocarpum	ARG(CHA, COS, ERI, MIS, SFE) / PRY(APA)
Heliotropium linariifolium	CHL(TAR, ANT, ATA)
Heliotropium longistylum	CHL(ATA, COQ, VAL)
Heliotropium megalanthum	CHL(ATA, COQ)
Heliotropium microstachyum	ARG(CAT, JUJ, LRI, SAL, SFE, SJU, TUC)
Heliotropium myosotifolium	CHL(TAR, ATA)
Heliotropium nicotianaefolium	ARG(BAI, CHA, COR, COS, DFE, ERI, FOR, JUJ, MIS, SAL, SFE, TUC) / PRY(COA, PAI) / URY(COL, PAY, RNO, SJO, SOR)
Heliotropium paronychioides	ARG(CHU, JUJ, LRI, MEN, NEU, RNE, SCR, SJU) / CHL(COQ, VAL, LBO, MAU, BIO, ARA, LLA, RME)
Heliotropium patagonicum	ARG(CHU, SCR) / CHL(MAG)
Heliotropium philippianum	CHL(ANT, ATA)
Heliotropium phylicoides	ARG(BAI, CHA, COS, ERI, FOR, MIS, SFE) / BRA(Fuera del área del proyecto) / URY(COL, LAV, SAO)
Heliotropium pinnatisectum	ARG(NEU)
Heliotropium pycnophyllum	CHL(ANT, ATA)
Heliotropium ruiz-lealii	ARG(SJU)
Heliotropium schreiteri	ARG(CHA, COR, FOR, SAL, SJU) / PRY(APY, PHA)
Heliotropium sclerocarpum	CHL(ATA)
Heliotropium sinuatum	CHL(TAR, ANT, ATA, COQ)
Heliotropium stenophyllum	CHL(ATA, COQ, VAL)
Heliotropium taltalense	CHL(ANT, ATA)
Heliotropium tiaridioides	ARG(COS, FOR, MIS) / BRA(PAR, RGS, SCA) / PRY(APA, CAA, CEN, ITA)
Heliotropium transalpinum	ARG(CHA, COS, FOR, JUJ, MIS, SAL) / BRA(PAR, RGS) / PRY(APA, CAU, CAA, CAN, CEN, CON, COA, GUA, ITA, MIE, ÑEE, PAI) / URY(ART, SAO)
Heliotropium veronicifolium	ARG(CAT, CHA, COR, FOR, JUJ, LRI, SAL, SDE, SFE, TUC) / PRY(APY, CON)
Helminthotheca echioides	ARG(BAI, DFE, ERI, LPA, MEN, RNE, SAL, SLU) / CHL(TAR, ATA, COQ, VAL, LBO, MAU, BIO, ARA, LLA, RME) / URY(MON)
Helogyne apaloidea	CHL(TAR)
Helogyne macrogyne	CHL(TAR, ANT)
Helogyne tacaquirensis	ARG(JUJ)
Helosis cayennensis	ARG(COS) / BRA(PAR, RGS, SCA)
Hemarthria altissima	ARG(BAI, CHA, COR, COS, DFE, ERI, FOR, JUJ, MIS, SAL, SLU, SFE, SDE, TUC) / BRA(PAR, RGS) / PRY(CEN, PAI, PHA) / URY(ART, CAS, COL, MON, PAY, RIV, ROC, SJO, SOR, TAC)
Hemidictyum marginatum	BRA(PAR, SCA)
Hemionitis tomentosa	ARG(CHA, COS, ERI, FOR, JUJ, MIS, SAL, SFE, TUC) / BRA(PAR, RGS, SCA) / PRY(AMA, CAN, GUA, ÑEE, PAI)
Hemipogon acerosus	PRY(AMA)
Hemipogon setaceus	BRA(PAR) / PRY(AMA, CAN)
Hennecartia omphalandra	ARG(COS, MIS) / BRA(PAR, RGS, SCA) / PRY(APA, AMA, CAU, CAA, CAN, GUA, ITA, MIE, SPE)
Henriettea glabra	BRA(SCA)
Heracleum mantegazzianum	ARG(NEU, RNE)
Herbertia amabilis	BRA(RGS)
Herbertia crosae	ARG(COS) / URY(ART)
Herbertia darwinii	ARG(COS, MIS) / BRA(RGS)
Herbertia lahue ssp. amoena	ARG(BAI, CHA, COR, COS, ERI, SAL, SFE) / BRA(RGS, SCA) / PRY(ITA, MIE, ÑEE) / URY(MON)
Herbertia lahue ssp. lahue	ARG(RNE) / CHL(VAL, LBO, MAU, BIO, ARA, LLA)
Herbertia pulchella	BRA(RGS) / URY(LAV)
Herbertia quareimana	ARG(COS) / BRA(RGS) / URY(ART)
Herbertia tigridioides	ARG(JUJ, SAL, TUC)
Herbertia zebrina	BRA(RGS)
Herbstia brasiliana	ARG(COS, MIS) / BRA(PAR, RGS, SCA) / PRY(APA, CEN, COA)
Herissantia crispa	ARG(CAT, COR, JUJ, LRI, SAL, SDE, SJU, SLU, TUC) / BRA(Fuera del área del proyecto) / PRY(APY)
Herissantia intermedia	ARG(CHA, COS, FOR) / BRA(Fuera del área del proyecto) / PRY(AMA)
Herissantia nemoralis	ARG(COS, MIS) / BRA(RGS) / PRY(PAI)
Herniaria austroamericana	ARG(JUJ)
Herniaria cinerea	ARG(CHU, RNE) / CHL(COQ)
Herniaria hirsuta	ARG(BAI, COR, LPA, SFE)
Herreria bonplandii	ARG(BAI, CHA, COS, ERI, FOR, MIS, SFE) / BRA(RGS) / PRY(APA, ÑEE)
Herreria montevidensis	ARG(BAI, COS, ERI, FOR, JUJ, MIS, SAL, SLU) / BRA(PAR, RGS) / PRY(APY, APA, SPE) / URY(COL, MON, RNO)
Herreria stellata	CHL(MAU, BIO, LLA)
Hesperis matronalis	ARG(NEU, RNE, TDF) / CHL(MAG)
Hesperozygis dimidiata	BRA(SCA)
Hesperozygis kleinii	BRA(SCA)
Hesperozygis nitida	BRA(PAR, RGS)
Hesperozygis rhododon	BRA(RGS)
Hesperozygis ringens	BRA(RGS)
Hesperozygis spathulata	BRA(PAR, SCA)
Heteranthera limosa	ARG(BAI, CHA, COR, COS, ERI, FOR, MIS, SAL, SFE, TUC) / BRA(RGS) / PRY(APY, BOQ, CEN, COA, ÑEE, PHA)
Heteranthera multiflora	ARG(BAI, CHA, COR, COS, JUJ, SAL, SFE, TUC) / BRA(RGS) / PRY(APY, PHA)
Heteranthera reniformis	ARG(BAI, COR, COS, ERI, FOR, MIS, SAL, TUC) / BRA(RGS, SCA) / PRY(AMA, CAU, CAN, CEN, CON, COA, GUA, MIE, ÑEE, PAI, SPE) / URY(RIV)
Heteranthera zosterifolia	ARG(ERI, MIS, SAL) / BRA(PAR, RGS, SCA) / PRY(AMA, PAI) / URY(LAV, RIV)
Heterocondylus grandis	ARG(MIS) / BRA(PAR, RGS, SCA) / PRY(APA, AMA, CAU, CAN, COA, GUA, PAI)
Heterocondylus vitalbae	ARG(MIS) / BRA(PAR) / PRY(APA, CAU, CAN, GUA, SPE)
Heterophyllaea pustulata	ARG(JUJ, SAL, TUC)
Heteropogon contortus	ARG(CHA, COR, COS, FOR, JUJ, MIS, SAL, SJU, SLU, TUC) / PRY(CON, PHA)
Heteropogon melanocarpus	ARG(JUJ, SAL) / PRY(APY)
Heteropsis oblongifolia	BRA(PAR)
Heteropsis rigidifolia	BRA(PAR, SCA)
Heteropterys aenea	BRA(PAR, RGS, SCA)
Heteropterys amplexicaulis	ARG(MIS) / PRY(AMA, CEN, CON, COA, PAI)
Heteropterys argyrophaea	ARG(COS, MIS) / BRA(PAR) / PRY(CAU, CON, COA, GUA, MIE, PAI) / URY(SAO)
Heteropterys bicolor	ARG(MIS) / BRA(PAR) / PRY(APA)
Heteropterys byrsonimifolia	BRA(PAR) / PRY(AMA)
Heteropterys cochleosperma	ARG(MIS, SAL) / BRA(PAR) / PRY(AMA, CAU, CAN, CEN, COA, GUA, PAI, SPE)
Heteropterys cultriformis	PRY(APY)
Heteropterys dumetorum	ARG(CAT, JUJ, LRI, SAL, SFE, TUC) / PRY(APY, CEN, GUA)
Heteropterys dusenii	BRA(PAR, RGS)
Heteropterys glabra	ARG(CHA, COS, ERI, FOR, MIS, SFE) / BRA(PAR, RGS, SCA) / PRY(APA, APY, AMA, BOQ, CEN, CON, COA, GUA, MIE, ÑEE, PAI, PHA, SPE) / URY(ART, RNO)
Heteropterys hypericifolia	ARG(CHA, COR, COS, ERI, FOR, MIS, SAL, SDE, SFE) / BRA(RGS) / PRY(APY, CEN, COA, GUA, PAI, PHA)
Heteropterys intermedia	ARG(COS, MIS) / BRA(PAR, SCA) / PRY(APA, CAU, CAA, CAN, GUA, PAI, SPE)
Heteropterys leschenaultiana	ARG(COS, MIS) / BRA(Fuera del área del proyecto)
Heteropterys microcarpa	ARG(MIS) / BRA(PAR, RGS, SCA)
Heteropterys mollis	ARG(JUJ)
Heteropterys mulgurae	ARG(MIS) / BRA(PAR)
Heteropterys nervosa	BRA(Fuera del área del proyecto) / PRY(Desconocida)
Heteropterys nitida	BRA(PAR)
Heteropterys pteropetala	BRA(Fuera del área del proyecto) / PRY(AMA, CON)
Heteropterys rhopalifolia	BRA(Fuera del área del proyecto) / PRY(APY, CEN)
Heteropterys schulziana	ARG(SAL)
Heteropterys sylvatica	ARG(JUJ, SAL) / BRA(Fuera del área del proyecto)
Heteropterys syringifolia	ARG(COS, FOR, MIS, SAL) / BRA(PAR, RGS, SCA) / PRY(APA, AMA, CAA, CON, SPE)
Heteropterys tomentosa	BRA(Fuera del área del proyecto) / PRY(AMA, CON, COA, PAI, SPE)
Heteropterys umbellata	BRA(PAR) / PRY(APY, CON, ÑEE)
Heterosperma diversifolium	ARG(JUJ, SAL, SLU, TUC)
Heterosperma nanum	ARG(JUJ, LRI, SAL, SJU, TUC) / CHL(TAR, ANT)
Heterosperma ovatifolium	ARG(CAT, COR, JUJ, LPA, LRI, SAL, SDE, SJU, SLU, TUC) / CHL(TAR)
Heterosperma tenuisectum	ARG(CAT, COR, JUJ, LRI, SAL, SJU, SLU, TUC)
Heterostachys olivascens	ARG(BAI, MEN, RNE)
Heterostachys ritteriana	ARG(BAI, CAT, CHA, CHU, COR, LPA, LRI, MEN, RNE, SAL, SJU, SLU, SFE, SDE) / PRY(APY, PHA)
Heterothalamulopsis wagenitzii	BRA(RGS, SCA)
Heterotheca subaxillaris	ARG(COR, LPA, SLU)
Heterotristicha schroederi	URY(RNO)
Heterozostera chilensis	CHL(ATA, COQ)
Hevea brasiliensis	BRA(PAR)
Hexasepalum apiculatum	BRA(PAR, RGS, SCA) / PRY(APY, AMA, CAU)
Hexasepalum radulum	BRA(PAR, SCA)
Hexasepalum teres	BRA(PAR, RGS) / PRY(AMA, CON)
Hibiscus acetosella	PRY(AMA)
Hibiscus amambayensis	BRA(Fuera del área del proyecto) / PRY(AMA)
Hibiscus bifurcatus	ARG(CHA) / BRA(PAR, SCA) / PRY(APA)
Hibiscus diversifolius ssp. rivularis	BRA(PAR, RGS, SCA)
Hibiscus furcellatus	ARG(CHA, COS, FOR, MIS) / BRA(PAR) / PRY(APY, AMA, CEN, CON, COA, PHA, SPE)
Hibiscus hasslerianus	BRA(Fuera del área del proyecto) / PRY(AMA, CAN)
Hibiscus radiatus	ARG(COS) / BRA(Fuera del área del proyecto) / PRY(AMA)
Hibiscus sororius	ARG(COS, MIS) / BRA(PAR) / PRY(CEN)
Hibiscus striatus	ARG(BAI, CHA, COS, ERI, FOR, JUJ, MIS, SAL, TUC) / BRA(PAR) / PRY(CEN, CON, COA, PAI, PHA, SPE) / URY(ART, DUR, PAY, ROC, SJO, TAC)
Hibiscus trionum	CHL(MAU, BIO) / URY(MON, SOR)
Hibiscus urticifolium	ARG(COS, MIS) / BRA(PAR, RGS) / PRY(AMA, SPE)
Hieracium × stoloniflorum	ARG(RNE)
Hieracium achalense	ARG(COR, SLU)
Hieracium adenocephalum	ARG(CAT, JUJ, LRI, SAL, TUC)
Hieracium antarcticum	ARG(NEU, RNE, SCR, TDF) / CHL(BIO, LLA, AIS, MAG)
Hieracium argentinense	ARG(CAT, JUJ, LRI, SAL, TUC)
Hieracium astroadenium	ARG(CAT, LRI, SLU, TUC)
Hieracium aurantiacum	ARG(TDF) / CHL(LLA)
Hieracium burkartii	ARG(BAI)
Hieracium catamarcense	ARG(CAT, LRI, MEN)
Hieracium chacoënse	ARG(BAI)
Hieracium chilense	ARG(CHU, MEN, NEU, RNE, SCR) / CHL(MAU, BIO, ARA, LLA, MAG, RME)
Hieracium cienegae	ARG(CAT, TUC)
Hieracium commersonii var. commersonii	ARG(COS, ERI, MIS, SFE) / BRA(RGS, SCA) / URY(ART, CAS, CLA, COL, FLA, LAV, MAL, MON, PAY, RNO, RIV, SJO, SOR, TAC, TYT)
Hieracium commersonii var. megapotanicum	BRA(PAR, RGS)
Hieracium cordobense	ARG(COR, SLU)
Hieracium criniceps	ARG(COR, MEN, SLU)
Hieracium dasychaetocomum	ARG(CAT, JUJ, SAL, TUC)
Hieracium eriadenium	ARG(JUJ, SAL)
Hieracium flagellare	ARG(TDF)
Hieracium fulvipes	ARG(JUJ, SAL)
Hieracium gigantium	ARG(CAT, COR, SLU)
Hieracium gilliesianum	ARG(COR, MEN, SJU, SLU)
Hieracium glaucifolium	ARG(CHU, NEU, RNE, SCR) / CHL(MAU, BIO, ARA, LLA)
Hieracium ignatianum	BRA(PAR)
Hieracium jaretanum	ARG(LRI)
Hieracium kieslingii	ARG(JUJ)
Hieracium lorentzianum	ARG(CAT, TUC)
Hieracium luteomontanum	ARG(JUJ)
Hieracium mandonii	ARG(CAT, JUJ, LRI, SAL, TUC)
Hieracium mendocinum	ARG(MEN, SJU)
Hieracium microcephalum	ARG(CAT, JUJ, LRI, SAL, TUC)
Hieracium mosenii	ARG(MIS) / BRA(PAR)
Hieracium murorum	ARG(TDF)
Hieracium neofurcatum	ARG(JUJ, SAL)
Hieracium niederleinii	ARG(CAT, JUJ, SAL, TUC)
Hieracium padcayense	ARG(CAT, JUJ, SAL)
Hieracium palezieuxii	ARG(BAI, CAT, COR, COS, LPA, SFE) / BRA(RGS) / URY(COL)
Hieracium paraguayense	ARG(COS, ERI) / BRA(PAR, SCA) / PRY(AMA)
Hieracium patagonicum	ARG(CHU, SCR, TDF) / CHL(MAU, BIO, ARA, LLA, MAG)
Hieracium pilosella ssp. euronotum	CHL(MAG)
Hieracium praealtum	ARG(NEU, RNE) / CHL(MAG)
Hieracium schreiteri	ARG(CAT, TUC)
Hieracium sordidum	ARG(CAT, LRI, TUC)
Hieracium stachyoideum	ARG(SAL)
Hieracium streptochaetum	ARG(CAT, JUJ, LRI, SAL, TUC)
Hieracium tandilense	ARG(BAI)
Hieracium tucumanicum var. esetosum	ARG(TUC)
Hieracium tucumanicum var. tucumanicum	ARG(CAT, JUJ, SAL, TUC)
Hieracium urvillei	BRA(PAR, SCA)
Hieracium vervoorstii	ARG(CAT)
Hieronyma alchorneoides	BRA(PAR, RGS, SCA)
Hieronymiella aurea	ARG(SAL)
Hieronymiella caletensis	ARG(JUJ)
Hieronymiella clidanthoides	ARG(CAT, LRI, MEN, SAL, SJU, TUC)
Hieronymiella marginata	ARG(CAT, JUJ, LRI, SAL, SJU, TUC)
Hieronymiella speciosa	ARG(CAT, JUJ, SAL)
Hildaea nemorosa	ARG(JUJ, SAL, TUC) / PRY(APA)
Hildaea pallens var. pallens	ARG(BAI, COS, ERI, JUJ, MIS, SAL, TUC) / BRA(PAR, RGS, SCA) / PRY(APA, AMA, CAU, CEN, COA, GUA, MIE, PAI) / URY(RIV, TAC)
Hildaea pallens var. major	ARG(MIS) / BRA(PAR, RGS, SCA)
Hildaea ruprechtii	ARG(JUJ, MIS) / BRA(PAR, RGS, SCA)
Hildaea tenuis	ARG(BAI, CHA, COS, MIS, SAL) / BRA(PAR, RGS, SCA) / PRY(APA, CAA, CAN, CON, COA, GUA, ÑEE, PAI)
Hilleria latifolia	ARG(JUJ, SAL) / BRA(Fuera del área del proyecto) / PRY(AMA, CAN)
Hillia illustris	BRA(PAR, SCA)
Hillia parasitica	BRA(PAR, RGS, SCA)
Hindsia ramosissima	BRA(PAR, SCA)
Hippeastrum aglaiae	ARG(CAT, JUJ, SAL, TUC)
Hippeastrum angustifolium	ARG(COS, MIS) / BRA(RGS) / PRY(PAI) / URY(RIV, TAC)
Hippeastrum argentinum	ARG(CAT, FOR, JUJ, SAL, TUC)
Hippeastrum aulicum	BRA(PAR)
Hippeastrum blossfeldiae	BRA(PAR, SCA)
Hippeastrum breviflorum	BRA(RGS, SCA)
Hippeastrum cybister	ARG(JUJ, SAL)
Hippeastrum glaucescens	ARG(MIS) / BRA(PAR, SCA)
Hippeastrum heuserianum	BRA(PAR, SCA)
Hippeastrum illustre	BRA(PAR)
Hippeastrum marumbiense	BRA(PAR)
Hippeastrum morelianum	BRA(SCA)
Hippeastrum papilio	BRA(RGS, SCA)
Hippeastrum parodii	ARG(CHA, COR, FOR, JUJ, SAL, SDE, SLU)
Hippeastrum psittacinum	BRA(PAR)
Hippeastrum reticulatum	ARG(MIS) / BRA(PAR)
Hippeastrum santacatarina	BRA(SCA)
Hippeastrum striatum	ARG(COS, MIS, TUC) / BRA(PAR, SCA) / URY(COL, MON, RNO, SJO, SOR)
Hippeastrum vittatum	ARG(MIS) / BRA(SCA) / PRY(APY, CAN, GUA)
Hippobroma longiflora	BRA(PAR, SCA)
Hippocratea volubilis	ARG(CHA, COS, MIS, SAL) / BRA(PAR, SCA) / PRY(APA, AMA, CAN, CON, COA, MIE, PHA)
Hippuris vulgaris	ARG(CHU, MEN, SCR, TDF) / CHL(BIO, LLA, MAG)
Hiraea cuneata	BRA(PAR, SCA)
Hiraea fagifolia	ARG(CHA, COS, MIS) / BRA(PAR) / PRY(APA, AMA, CAU, CAA, CAN, CEN, CON, COA, GUA, PAI, SPE)
Hiraea wiedeana	BRA(PAR)
Hirschfeldia incana	ARG(BAI, CHU, COR, COS, ERI, FOR, JUJ, LPA, LRI, MEN, NEU, RNE, SAL, SJU, SLU, SCR, SFE, SDE, TUC) / CHL(ATA, COQ, VAL, BIO, ARA, RME, JFE, IPA) / URY(PAY, SJO)
Hirtella burchellii	BRA(PAR) / PRY(AMA)
Hirtella hebeclada	BRA(PAR, RGS, SCA)
Histiopteris incisa	BRA(PAR, RGS, SCA) / CHL(LLA, AIS, MAG, JFE)
Hochreutinera hasslerana	ARG(CHA, COS, FOR, MIS, SAL, SFE) / BRA(RGS) / PRY(AMA, CAU, CEN, CON, COA, GUA, PAI, SPE)
Hoehnea epilobioides	BRA(PAR, RGS) / PRY(COA)
Hoehnea minima	BRA(PAR, SCA)
Hoehnea parvula	BRA(PAR, RGS, SCA)
Hoehnea scutellarioides	BRA(PAR, RGS, SCA)
Hoehneella gehrtiana	BRA(SCA)
Hoffmannia australis	ARG(JUJ, SAL, TUC)
Hoffmannia peckii	ARG(MIS) / BRA(PAR, SCA)
Hoffmannseggia aphylla	CHL(TAR)
Hoffmannseggia doellii ssp. argentina	ARG(CAT, LRI, MEN, SJU)
Hoffmannseggia doellii ssp. doellii	CHL(TAR, ANT)
Hoffmannseggia erecta	ARG(CAT, CHU, LPA, LRI, MEN, NEU, RNE, SJU)
Hoffmannseggia eremophila	ARG(CAT, MEN, SAL) / CHL(ANT, ATA)
Hoffmannseggia glauca	ARG(BAI, CAT, CHA, CHU, COR, JUJ, LPA, LRI, MEN, NEU, RNE, SAL, SJU, SLU, SCR, SFE, SDE, TUC) / CHL(ATA, COQ, VAL, RME)
Hoffmannseggia minor	ARG(CAT, JUJ, SAL) / CHL(TAR, ANT)
Hoffmannseggia prostrata	CHL(TAR, ANT, ATA)
Hoffmannseggia pumilio	ARG(CAT, COR, JUJ, LRI, SJU)
Hoffmannseggia trifoliata	ARG(BAI, CHU, LPA, NEU, RNE, SCR) / CHL(AIS)
Hoffmannseggia viscosa	CHL(TAR)
Hoffmannseggia yaviensis	ARG(CAT, JUJ, SAL, TUC)
Hohenbergia augusta	BRA(PAR, SCA)
Holcus lanatus	ARG(BAI, CHU, NEU, RNE, SCR, TDF) / BRA(PAR, RGS, SCA) / CHL(ARA) / URY(MON, SAO, SJO, SOR)
Hollermayera valdiviana	CHL(ARA, LLA)
Holmbergia tweedii	ARG(BAI, CHA, COR, COS, ERI, FOR, JUJ, LRI, SAL, SFE, SDE, TUC) / PRY(APY, APA, PHA) / URY(RNO, SOR)
Holocalyx balansae	ARG(CHA, COS, FOR, MIS) / BRA(PAR, RGS, SCA) / PRY(APA, AMA, CAA, CAN, CEN, CON, COA, ITA, ÑEE, PAI, SPE)
Holocheilus brasiliensis	ARG(BAI, COR, COS, ERI, MIS, SFE) / BRA(PAR, RGS, SCA) / PRY(APY) / URY(ART, CAS, CLA, DUR, LAV, MAL, MON, PAY, RNO, RIV, ROC, SAO, SJO, SOR, TYT)
Holocheilus fabrisii	ARG(JUJ, SAL, TUC)
Holocheilus hieracioides	ARG(BAI, CAT, CHA, COR, COS, ERI, FOR, JUJ, SAL, SDE, SFE, TUC) / PRY(APY, CEN, ITA, PHA) / URY(CAS, CLA, COL, DUR, FLO, FLA, MON, PAY, RNO, SAO, SJO, SOR)
Holocheilus illustris	ARG(MIS) / BRA(PAR, RGS, SCA) / URY(PAY, RNO, RIV)
Holocheilus monocephalus	BRA(RGS, SCA)
Holocheilus pinnatifidus	BRA(PAR)
Holocheilus schulzii	ARG(CHA, COS, FOR, MIS) / BRA(PAR) / PRY(APA, AMA, CAN, SPE)
Holosteum umbellatum	ARG(BAI, CHU, COR, NEU, RNE)
Homalocarpus bowlesioides	CHL(ATA, COQ, VAL, RME)
Homalocarpus dichotomus	CHL(ATA, COQ, VAL, LBO, RME)
Homalocarpus digitatus	CHL(ATA)
Homalocarpus dissectus	CHL(COQ, VAL, RME)
Homalocarpus integerrimus	CHL(ANT, ATA)
Homalocarpus nigripetalus	CHL(COQ, VAL, RME)
Homalopetalum joinvillense	BRA(SCA)
Homolepis glutinosa	ARG(COS, MIS) / BRA(PAR, RGS, SCA) / PRY(APA, AMA, CAU, CAA, CAN, CEN, CON, COA, GUA, PAI) / URY(TYT)
Homolepis villaricensis	ARG(COS, MIS) / BRA(PAR) / PRY(APY, APA, CAU, CAA, CEN, CON, COA, GUA, MIE, PAI, SPE)
Hordeum brachyatherum	CHL(COQ, VAL, MAU, MAG)
Hordeum chilense	ARG(NEU, RNE, SCR) / CHL(TAR, ANT, COQ, VAL, LBO, BIO, MAG, RME, JFE)
Hordeum comosum	ARG(CHU, LRI, MEN, NEU, RNE, SCR, SJU, TDF) / CHL(TAR, ANT, ATA, COQ, VAL, LBO, MAU, BIO, ARA, MAG, RME)
Hordeum cordobense	ARG(CHA, COR, COS, ERI, LPA, SFE, SJU, SLU, TUC)
Hordeum erectifolium	ARG(BAI)
Hordeum euclaston	ARG(BAI, CHU, COR, COS, DFE, ERI, LPA, MEN, RNE, SCR, SFE, TUC) / BRA(RGS) / URY(MAL, MON)
Hordeum flexuosum	ARG(BAI, CHA, CHU, COS, DFE, ERI, LPA, MEN, SCR) / URY(Desconocida)
Hordeum fuegianum	ARG(TDF) / CHL(MAG)
Hordeum jubatum	ARG(BAI, CHU, LPA, MEN, NEU, RNE, SLU, SFE, TDF) / CHL(MAG)
Hordeum lechleri	ARG(CHU, MEN, NEU, RNE, SCR, TDF) / CHL(MAG)
Hordeum marinum ssp. marinum	ARG(BAI, CHU, MEN, NEU) / CHL(VAL, MAU, BIO, ARA, LLA, MAG, RME)
Hordeum marinum ssp. gussoneanum	CHL(COQ, VAL, LBO, MAU, BIO, RME)
Hordeum murinum ssp. murinum	ARG(BAI, CHU, LPA, MEN, NEU, RNE, SLU, SCR, TDF) / CHL(ANT, ATA, COQ, VAL, LBO, MAU, BIO, ARA, LLA, RME, JFE)
Hordeum murinum ssp. glaucum	ARG(BAI, CHU, LPA, MEN, NEU, RNE, SJU, SLU, SCR, TDF)
Hordeum murinum ssp. leporinum	ARG(BAI, CHU, DFE, LPA, MEN, NEU, RNE, SLU, SCR, TDF) / CHL(VAL, BIO) / URY(MAL)
Hordeum muticum	ARG(CAT, COR, JUJ, LRI, SAL, SJU, SLU, TUC) / CHL(TAR, ANT, ATA)
Hordeum parodii	ARG(BAI, CHU, LPA, MEN, NEU, RNE, SCR)
Hordeum patagonicum ssp. patagonicum	ARG(CHU, MEN, SCR)
Hordeum patagonicum ssp. magellanicum	ARG(SCR, TDF) / CHL(MAG)
Hordeum patagonicum ssp. mustersii	ARG(SCR)
Hordeum patagonicum ssp. santacrucense	ARG(CHU, RNE, SCR) / CHL(MAG)
Hordeum patagonicum ssp. setifolium	ARG(SCR)
Hordeum procerum	ARG(BAI, CHU, LPA, MEN, NEU, RNE, SCR, SLU, TDF)
Hordeum pubiflorum ssp. halophilum	ARG(CAT, CHU, JUJ, LRI, MEN, NEU, RNE, SAL, SCR, SJU, TDF, TUC) / CHL(ANT, ATA, MAG)
Hordeum pubiflorum ssp. pubiflorum	ARG(NEU, SCR, TDF) / CHL(BIO, MAG)
Hordeum pusillum	ARG(BAI, COR, COS, DFE, ERI, LPA, MEN, RNE, SFE)
Hordeum stenostachys	ARG(BAI, CAT, CHA, CHU, COR, DFE, ERI, JUJ, LPA, LRI, MEN, MIS, RNE, SDE, SFE, SJU, SLU, TUC) / BRA(RGS, SCA) / URY(FLA, LAV)
Hordeum tetraploideum	ARG(CHU, MEN, NEU, RNE, SCR) / CHL(LLA, AIS)
Hordeum vulgare var. vulgare	ARG(BAI, CHA, COR, ERI, LPA, MEN, NEU, RNE, SCR, SFE, SLU) / BRA(PAR, RGS, SCA) / CHL(ATA, BIO, ARA, RME) / URY(Desconocida)
Hordeum vulgare var. trifurcatum	ARG(JUJ)
Hornungia procumbens	ARG(CHU, LPA, LRI, MEN, NEU, RNE, SCR, SJU) / CHL(TAR, ATA, COQ, MAG)
Houlletia brocklehurstiana	BRA(PAR)
Houssayanthus incanus	ARG(CHA, COS, ERI, FOR, SFE) / PRY(APY, CEN, CON, COA, ÑEE, PHA)
Houssayanthus monogynus	ARG(FOR) / BRA(Fuera del área del proyecto) / PRY(CEN, MIE, ÑEE, PAI)
Hovenia dulcis	ARG(COS, MIS) / BRA(RGS, SCA) / PRY(CAU, CAA, CEN, COA, GUA, PAI)
Huarpea andina	ARG(SJU)
Huberia semiserrata	BRA(PAR, RGS, SCA)
Huidobria chilensis	CHL(ANT, ATA)
Huidobria fruticosa	CHL(TAR, ANT, ATA)
Humulus lupulus	ARG(NEU, RNE)
Humulus scandens	ARG(BAI, LPA)
Huntleya meleagris	BRA(PAR, RGS, SCA)
Huperzia badiniana	BRA(SCA)
Huperzia biformis	BRA(PAR, SCA)
Huperzia catharinae	BRA(SCA)
Huperzia flexibilis	BRA(PAR, SCA)
Huperzia fontinaloides	BRA(PAR, SCA)
Huperzia friburgensis	BRA(PAR) / PRY(PAI)
Huperzia fuegiana	ARG(CHU) / CHL(AIS, MAG)
Huperzia hexasticha	BRA(PAR, RGS, SCA)
Huperzia pungentifolia	BRA(PAR, RGS)
Huperzia quadrifariata	BRA(PAR, SCA)
Huperzia saururoides	ARG(SCR, TDF)
Huperzia sellowiana	BRA(SCA)
Huperzia subulata	
Huperzia taxifolia	BRA(PAR, SCA)
Hyalis argentea var. argentea	ARG(CAT, COR, LPA, LRI, MEN, SAL, SJU)
Hyalis argentea var. latisquama	ARG(BAI, CHU, COR, LPA, MEN, NEU, RNE, SLU)
Hyalis argentea var. macrosperma	ARG(MEN)
Hyalis lancifolia	ARG(CAT, CHA, FOR, JUJ, SAL, SDE, TUC) / PRY(PHA)
Hyaloseris andrade-limae	ARG(SDE)
Hyaloseris camataquiensis	ARG(JUJ)
Hyaloseris cinerea var. cinerea	ARG(CAT, LRI, SJU, SLU)
Hyaloseris cinerea var. tomentella	ARG(COR, LRI, SJU, SLU)
Hyaloseris rubicunda	ARG(CAT, LRI, SAL, SJU, TUC)
Hyaloseris salicifolia	ARG(CAT, CHA, JUJ, SAL, TUC)
Hybanthus melchiorianus	PRY(APY, PHA)
Hybanthus nanus	ARG(COS, ERI, MIS) / BRA(RGS) / URY(MON, RNO, SOR)
Hydnocarpus pentandrus	PRY(CEN)
Hydrangea serratifolia	ARG(CHU, RNE) / CHL(VAL, LBO, MAU, BIO, ARA, LLA, AIS, RME)
Hydrocleys martii	ARG(COS) / BRA(SCA) / URY(DUR, ROC)
Hydrocleys mattogrossensis	BRA(Fuera del área del proyecto) / PRY(APY)
Hydrocleys modesta	ARG(COS) / BRA(Fuera del área del proyecto) / PRY(ÑEE, PAI)
Hydrocleys nymphoides	ARG(BAI, CHA, COS, ERI, FOR, SFE, TUC) / BRA(PAR, SCA) / PRY(APY, AMA, CEN, CHO, CON, COA, ÑEE, NAS, PHA) / URY(ROC)
Hydrocotyle bonariensis	ARG(BAI, CAT, CHA, COR, COS, ERI, FOR, JUJ, LPA, LRI, MEN, MIS, RNE, SAL, SJU, SLU, SFE, SDE, TUC) / BRA(PAR, RGS, SCA) / CHL(TAR, COQ, VAL, BIO) / PRY(CAN, ITA, ÑEE) / URY(ART, CAS, CLA, COL, FLA, MON, RNO, ROC, SAO, SJO, SOR)
Hydrocotyle bowlesioides	ARG(CHA, MIS) / PRY(APA, AMA, CEN, GUA, PAI)
Hydrocotyle callicephala	ARG(MIS, SFE) / BRA(PAR, RGS, SCA) / PRY(APA, CAA)
Hydrocotyle chamaemorus	ARG(BAI, CHU, NEU, RNE, SCR, TDF) / CHL(BIO, ARA, LLA, AIS, MAG)
Hydrocotyle cryptocarpa	ARG(BAI, COS, ERI) / CHL(COQ, LBO, BIO, ARA) / URY(CAS, FLA, MAL, MON, PAY, RIV, ROC, SAO, SJO, SJO)
Hydrocotyle exigua	ARG(CHA, COS, MIS, SFE) / BRA(PAR, RGS, SCA) / PRY(CAA, GUA) / URY(MAL, SAO, TYT)
Hydrocotyle filipes	ARG(SAL, TUC)
Hydrocotyle indecora	ARG(NEU, RNE, SCR) / CHL(COQ, MAU, BIO, ARA, LLA, AIS)
Hydrocotyle itatiaiensis	BRA(SCA)
Hydrocotyle langsdorfii	BRA(PAR, RGS, SCA)
Hydrocotyle leucocephala	ARG(BAI, CHA, COS, ERI, FOR, JUJ, MEN, MIS) / BRA(PAR, RGS, SCA) / PRY(APA, CAA, CAN, CEN, COA, ITA, ÑEE) / URY(ART, COL, MON, SAO, TAC)
Hydrocotyle modesta	ARG(BAI, CAT, COR, COS, ERI, JUJ, MEN, SAL, SJU, SLU, SFE, SDE) / CHL(VAL, LBO, ARA, LLA, RME) / URY(ART, CAS, FLO, FLA, LAV, MON, PAY, SAO)
Hydrocotyle poeppigii	CHL(BIO, ARA, LLA, AIS)
Hydrocotyle pusilla	ARG(BAI, COS, ERI, MIS, SFE) / BRA(PAR, RGS, SCA) / PRY(APA, MIE) / URY(LAV, MON, RIV, TAC)
Hydrocotyle quinqueloba	BRA(PAR, RGS, SCA)
Hydrocotyle ranunculoides	ARG(BAI, CHA, CHU, COR, COS, ERI, FOR, JUJ, LPA, LRI, MEN, NEU, RNE, SAL, SCR, SDE, SFE, SJU, SLU, TUC) / BRA(PAR, RGS, SCA) / CHL(COQ, VAL, LBO, MAU, BIO, ARA, LLA, RME) / PRY(CAA, ÑEE, PHA) / URY(COL, MON, SOR)
Hydrocotyle umbellata	BRA(PAR) / CHL(TAR, VAL, BIO) / PRY(APY, CAA, CEN)
Hydrocotyle verticillata	ARG(BAI, CAT, CHA, COS, ERI, JUJ, MIS) / BRA(RGS, SCA) / CHL(LBO, MAU, RME) / PRY(COA) / URY(CAS, COL, MAL, MON, ROC)
Hydrolea elatior	ARG(CHA, COS, ERI, MIS, SFE) / BRA(Fuera del área del proyecto) / PRY(APY, AMA, CAU, ÑEE, PHA) / URY(FLA)
Hydrolea spinosa var. spinosa	ARG(BAI, CHA, COS, ERI, FOR, JUJ, MIS, SAL, SFE, TUC) / BRA(PAR, RGS, SCA) / PRY(APY, CEN, COA, PAI, PHA)
Hydrolea spinosa var. paraguayensis	ARG(COS, FOR, MIS) / BRA(PAR, SCA) / PRY(APY, CAA, CEN, COA, ÑEE, PAI, SPE)
Hygrophila costata	ARG(BAI, COS, ERI, MIS) / BRA(PAR, RGS, SCA) / PRY(APA, AMA, CAU, CAA, CAN, CEN, COA, GUA, ITA, MIE, PAI, SPE) / URY(RIV)
Hygrophila guianensis	ARG(BAI, COS, ERI, FOR, MIS, SAL, SFE, TUC) / BRA(RGS, SCA) / PRY(AMA, CAA, CEN, COA, GUA, ITA, PAI, SPE)
Hymenachne amplexicaulis	ARG(BAI, CHA, COS, DFE, ERI, FOR, MIS, SAL, SFE) / BRA(PAR) / PRY(APA, APY, AMA, BOQ, CAU, CAA, CAN, CEN, CHO, CON, COA, GUA, ITA, ÑEE, NAS, PAI, PHA, SPE) / URY(MON)
Hymenachne donacifolia	ARG(MIS, SAL) / BRA(RGS, SCA) / PRY(CAN, CEN, CON, GUA, PHA, SPE)
Hymenachne grumosa	ARG(BAI, CHA, COS, DFE, ERI, MIS, SFE) / BRA(PAR, RGS, SCA) / PRY(AMA, CAA, CAN, CEN, COA, GUA, ITA, PAI, PHA) / URY(CAS, COL, RNO, ROC, SJO, TAC)
Hymenachne pernambucense	ARG(BAI, CHA, COS, ERI, FOR, MIS, SFE) / BRA(PAR, RGS, SCA) / PRY(APA, AMA, CAU, CAA, CEN, COA, GUA, ÑEE, PAI, SPE) / URY(ART)
Hymenaea courbaril	BRA(Fuera del área del proyecto) / PRY(CAN)
Hymenaea martiana	ARG(MIS) / BRA(Fuera del área del proyecto) / PRY(AMA, CON)
Hymenaea stigonocarpa var. stigonocarpa	BRA(Fuera del área del proyecto) / PRY(APY, APA, AMA, CAN, CEN, COA, PAI)
Hymenaea stigonocarpa var. pubescens	BRA(Fuera del área del proyecto) / PRY(AMA)
Hymenasplenium laetum	ARG(MIS, SAL, TUC) / BRA(RGS) / PRY(CAN, CON)
Hymenasplenium triquetrum	ARG(MIS) / BRA(PAR, RGS, SCA) / PRY(APY)
Hymenophyllum asperulum	ARG(CHU, NEU, RNE, SCR) / CHL(LBO, MAU, BIO, ARA, LRI, LLA, AIS)
Hymenophyllum asplenioides	BRA(PAR, RGS, SCA)
Hymenophyllum caespitosum	ARG(CHU, NEU, RNE, SCR, TDF) / CHL(LLA, AIS, MAG, JFE)
Hymenophyllum capurroi	ARG(JUJ, SAL, TUC)
Hymenophyllum caudiculatum var. caudiculatum	ARG(CHU) / BRA(PAR, RGS, SCA) / CHL(VAL, BIO, ARA, LLA, AIS, MAG, RME, JFE) / PRY(PAI)
Hymenophyllum cordobense	ARG(CAT, COR, JUJ, SAL, TUC)
Hymenophyllum crispum	ARG(JUJ, SAL) / BRA(RGS, SCA)
Hymenophyllum cruentum	ARG(CHU) / CHL(MAU, BIO, ARA, LLA, AIS, MAG, JFE)
Hymenophyllum cuneatum var. cuneatum	CHL(BIO, ARA, LLA, AIS, MAG, JFE)
Hymenophyllum cuneatum var. rariforme	CHL(JFE)
Hymenophyllum darwinii	ARG(NEU, RNE, SCR, TDF) / CHL(MAU, BIO, ARA, LLA, AIS, MAG)
Hymenophyllum delicatulum	BRA(RGS)
Hymenophyllum dentatum	ARG(NEU, RNE, TDF) / CHL(BIO, ARA, LLA, AIS)
Hymenophyllum dicranotrichum	CHL(BIO, ARA, LLA, AIS)
Hymenophyllum elegans	BRA(PAR, SCA)
Hymenophyllum falklandicum	ARG(CHU, NEU, RNE, SCR, TDF) / CHL(BIO, ARA, LLA, AIS, MAG, JFE)
Hymenophyllum ferrugineum	ARG(CHU, NEU, RNE, SCR, TDF) / CHL(LLA, AIS, MAG, JFE)
Hymenophyllum filmenofilicum	BRA(PAR)
Hymenophyllum fragile	BRA(PAR, RGS)
Hymenophyllum fuciforme	ARG(CHU, RNE) / CHL(MAU, BIO, ARA, LLA, AIS, MAG, JFE)
Hymenophyllum fucoides	BRA(RGS, SCA)
Hymenophyllum glaziovii	BRA(PAR)
Hymenophyllum hirsutum	BRA(PAR, RGS, SCA)
Hymenophyllum krauseanum	ARG(CHU, NEU, RNE) / CHL(BIO, ARA, LLA, AIS)
Hymenophyllum lineare	BRA(PAR, RGS)
Hymenophyllum magellanicum	ARG(CHU, NEU, RNE) / BRA(PAR, RGS, SCA) / CHL(BIO, ARA, LLA, AIS, MAG)
Hymenophyllum microcarpum	BRA(PAR, SCA)
Hymenophyllum myriocarpum	BRA(PAR)
Hymenophyllum nahuelhuapiense	ARG(CHU, NEU, RNE, TDF) / CHL(LLA, MAG)
Hymenophyllum pectinatum	ARG(CHU, NEU, RNE, SCR, TDF) / CHL(MAU, BIO, ARA, LLA, AIS, MAG, JFE)
Hymenophyllum peltatum	ARG(NEU, RNE, SCR, TDF) / BRA(RGS) / CHL(COQ, MAU, BIO, ARA, LLA, AIS, MAG)
Hymenophyllum plicatum	ARG(NEU, RNE, TDF) / CHL(LBO, MAU, BIO, ARA, LLA, AIS, MAG, RME, JFE)
Hymenophyllum plumosum	BRA(PAR)
Hymenophyllum polyanthos	ARG(JUJ, SAL) / BRA(PAR, RGS, SCA)
Hymenophyllum pulchellum	BRA(PAR, RGS, SCA)
Hymenophyllum quetrihuense	ARG(CHU, NEU, RNE)
Hymenophyllum rufum	BRA(PAR, RGS, SCA)
Hymenophyllum rugosum	CHL(JFE)
Hymenophyllum secundum	ARG(CHU, NEU, RNE, SCR, TDF) / CHL(LLA, AIS, MAG, JFE)
Hymenophyllum tortuosum	ARG(CHU, NEU, RNE, SCR, TDF) / CHL(ARA, LLA, AIS, MAG, JFE)
Hymenophyllum ulei	BRA(SCA)
Hymenophyllum umbratile	ARG(NEU, RNE) / CHL(LLA)
Hymenophyllum vestitum	BRA(PAR)
Hymenostephium debile	ARG(CAT, JUJ, SAL, TUC)
Hymenoxys anthemoides	ARG(BAI, CAT, CHA, COR, COS, DFE, ERI, FOR, LPA, SAL, SJU, SLU, SFE, SDE, TUC) / BRA(RGS) / PRY(PHA) / URY(ART, COL, MON, PAY, RNO, SAO)
Hymenoxys cabrerae	ARG(BAI, CHU, COR, LPA, RNE, SFE)
Hymenoxys robusta	ARG(JUJ)
Hymenoxys tweediei	ARG(BAI, ERI) / BRA(RGS) / URY(FLO, RNO, SOR)
Hyparrhenia bracteata	BRA(PAR) / PRY(AMA)
Hyparrhenia rufa	ARG(CHA, COS, MIS) / BRA(PAR, SCA) / PRY(AMA, CEN, CON, PHA, SPE)
Hypenia glauca	BRA(PAR) / PRY(AMA, CAN)
Hyperbaena domingensis	BRA(PAR, RGS, SCA)
Hyperbaena hassleri	ARG(CHA, FOR) / BRA(Fuera del área del proyecto) / PRY(CEN, CON, GUA, ÑEE)
Hyperbaena oblongifolia	ARG(MIS) / BRA(SCA) / PRY(APA, COA, PAI)
Hypericum androsaemum	CHL(LBO, LLA)
Hypericum austrobrasiliense	BRA(RGS, SCA)
Hypericum brasiliense	ARG(BAI, CHA, COR, COS, DFE, ERI, FOR, JUJ, MIS, TUC) / BRA(PAR, RGS, SCA) / PRY(APA, APY, AMA, CAA, CAN, COA) / URY(ART, MON, RNO, RIV, TYT)
Hypericum brevistylum	ARG(JUJ, SAL)
Hypericum caespitosum	CHL(MAU, BIO, ARA, LLA)
Hypericum campestre ssp. campestre	ARG(BAI, COS, ERI, MIS, SFE) / BRA(PAR, RGS) / PRY(CAN, COA) / URY(RIV)
Hypericum campestre ssp. tenue	ARG(CHA, MIS) / PRY(CAU, CAN, CON, MIE)
Hypericum campestre ssp. pauciflorum	BRA(PAR, RGS, SCA)
Hypericum caprifoliatum	ARG(MIS) / BRA(PAR, RGS, SCA)
Hypericum carinatum	ARG(BAI, COR, COS, DFE, ERI, FOR, JUJ, MIS, SAL) / BRA(PAR, RGS, SCA) / PRY(CAU, CEN, CON, GUA, MIE, SPE) / URY(CLA, RIV, ROC, TYT)
Hypericum cavernicola	BRA(RGS) / URY(TAC)
Hypericum connatum	ARG(BAI, CHA, COR, COS, ERI, FOR, JUJ, MIS, SAL, SFE, SLU, TUC) / BRA(PAR, RGS, SCA) / PRY(APA, CAU, GUA, MIE, PAI) / URY(ART, CAS, COL, LAV, MAL, RIV, ROC, TYT)
Hypericum cordatum ssp. cordatum	BRA(PAR, RGS, SCA)
Hypericum cordatum ssp. kleinii	BRA(PAR, SCA)
Hypericum denudatum	ARG(MIS) / BRA(PAR, RGS, SCA)
Hypericum gentianoides	BRA(RGS) / PRY(COA, PAI)
Hypericum humifusum	ARG(NEU)
Hypericum legrandii	URY(RIV)
Hypericum linoides	ARG(BAI) / BRA(RGS) / URY(FLO, FLA, TAC)
Hypericum lorentzianum	ARG(COS, ERI, MIS, SAL) / BRA(PAR, RGS, SCA) / PRY(APY, CAN, CON, GUA) / URY(ART, CAS, MON, ROC)
Hypericum microlicioides	BRA(PAR, SCA)
Hypericum mutilum	ARG(BAI, COS, ERI, JUJ, MIS, SAL, TUC) / BRA(PAR, RGS, SCA) / PRY(MIE) / URY(RIV)
Hypericum myrianthum ssp. myrianthum	ARG(COS, ERI, MIS) / BRA(RGS) / URY(CLA, LAV, MAL, RNO, RIV, ROC, SAO, TAC, TYT)
Hypericum myrianthum ssp. tamariscinum	BRA(RGS) / URY(CLA, LAV, MAL, MON, SOR)
Hypericum pedersenii	BRA(RGS)
Hypericum perforatum	ARG(BAI, CHU, LPA, NEU, RNE) / BRA(Fuera del área del proyecto) / CHL(LBO, MAU, BIO, ARA, LLA, RME, JFE) / URY(MON)
Hypericum piriai	BRA(PAR, RGS, SCA) / URY(MAL, ROC)
Hypericum polyanthemum	ARG(COS) / BRA(RGS, SCA) / URY(CLA, TAC)
Hypericum rigidum ssp. rigidum	BRA(PAR, SCA)
Hypericum rigidum ssp. meridionale	BRA(PAR, SCA)
Hypericum rigidum ssp. sellowianum	BRA(PAR, RGS, SCA)
Hypericum rigidum ssp. bracteatum	BRA(PAR)
Hypericum robsonii	ARG(MIS)
Hypericum salvadorense	BRA(RGS)
Hypericum silenoides	ARG(COR, JUJ, SAL, TUC) / CHL(ANT, ARA, LLA)
Hypericum teretiusculum	ARG(MIS) / BRA(PAR, RGS, SCA) / PRY(GUA)
Hypericum ternum	BRA(PAR, RGS, SCA)
Hypochaeris acaulis	ARG(MEN, NEU) / CHL(COQ, MAU, BIO, ARA, RME)
Hypochaeris alba	ARG(COS) / PRY(ITA)
Hypochaeris albiflora	ARG(BAI, CAT, CHA, COR, COS, DFE, ERI, JUJ, LPA, LRI, MIS, SAL, SFE, TUC) / BRA(RGS, SCA) / PRY(GUA, MIE, SPE) / URY(LAV)
Hypochaeris apargioides	CHL(VAL, LBO, MAU, BIO, ARA, RME)
Hypochaeris arenaria	ARG(CHU, MEN, NEU, RNE, SCR, TDF) / CHL(VAL, BIO, ARA, LLA, AIS, MAG)
Hypochaeris argentina	ARG(COR, JUJ, SAL, SLU, TUC)
Hypochaeris caespitosa	ARG(COR, SLU)
Hypochaeris catharinensis	BRA(RGS, SCA)
Hypochaeris chillensis	ARG(BAI, CAT, CHA, COR, COS, ERI, JUJ, LPA, MEN, MIS, RNE, SAL, SDE, SFE, SJU, SLU, TUC) / BRA(PAR, RGS, SCA) / PRY(AMA, CAU, CAN, GUA, MIE, ÑEE, PAI) / URY(CAS, CLA, COL, FLO, FLA, LAV, MAL, MON, PAY, RIV, SAO, SJO, SOR, TYT)
Hypochaeris chondrilloides	ARG(BAI, CAT, CHU, COR, JUJ, LPA, LRI, MEN, NEU, RNE, SAL, SCR, SJU, SLU, TDF) / CHL(ANT, ATA)
Hypochaeris clarionoides	ARG(MEN) / CHL(COQ, VAL, RME)
Hypochaeris cupressorum	CHL(LBO, MAU, RME)
Hypochaeris deserticola	CHL(ATA)
Hypochaeris echegarayi	ARG(CAT, JUJ, SAL, SJU, TUC)
Hypochaeris elata	ARG(CAT, COR, JUJ, LRI, SAL, SJU, SLU, TUC)
Hypochaeris eremophila	ARG(CAT, JUJ, SAL, TUC) / CHL(TAR, ANT)
Hypochaeris foliosa	CHL(ANT)
Hypochaeris gayana	ARG(CHU, MEN, NEU, RNE) / CHL(MAU, BIO, ARA, RME)
Hypochaeris glabra	ARG(BAI, COS, ERI, LPA) / BRA(RGS, SCA) / CHL(COQ, VAL, MAU, BIO, RME, JFE, IPA) / URY(CAS, CLA, FLA, LAV, MAL, MON, PAY, SJO, SOR, TYT)
Hypochaeris grandidentata	CHL(ANT, ATA)
Hypochaeris grisebachii	ARG(BAI, COS, ERI) / URY(CAS, CLA, FLA, MAL)
Hypochaeris hispidula	CHL(LLA)
Hypochaeris hookeri	ARG(CHU, MEN, NEU, RNE, SCR)
Hypochaeris incana var. incana	ARG(CHU, NEU, RNE, SCR, TDF) / CHL(AIS, MAG)
Hypochaeris incana var. integrifolia	ARG(NEU, RNE, SCR, TDF) / CHL(MAG)
Hypochaeris laciniosa	CHL(BIO)
Hypochaeris lessingii	CHL(BIO, ARA)
Hypochaeris lutea	BRA(PAR, RGS, SCA) / PRY(APA, AMA) / URY(CLA, FLA, SJO)
Hypochaeris megapotamica	ARG(BAI, COR, COS, ERI, SFE) / BRA(RGS, SCA) / URY(CAS, CLA, COL, FLA, LAV, MAL, MON, PAY, ROC, SJO, SOR)
Hypochaeris melanolepis	CHL(VAL)
Hypochaeris meyeniana	ARG(CAT, JUJ, LRI, SAL, TUC)
Hypochaeris microcephala	ARG(BAI, CAT, CHA, COR, COS, DFE, ERI, FOR, JUJ, LPA, MIS, SAL, SLU, SFE) / URY(ART, CAS, CLA, COL, FLA, LAV, MAL, MON, RNO, ROC, TYT)
Hypochaeris montana var. montana	ARG(LRI, MEN, NEU, SCR, SJU) / CHL(RME)
Hypochaeris nahuelvutae	CHL(ARA)
Hypochaeris neopinnatifida	ARG(BAI) / BRA(RGS)
Hypochaeris palustris	ARG(MEN, NEU, RNE, SCR) / CHL(BIO, ARA, LLA, AIS, MAG)
Hypochaeris pampasica	ARG(BAI, CAT, CHU, COR, COS, DFE, ERI, LPA, LRI, MEN, RNE, SAL, SJU, SLU)
Hypochaeris parodii	ARG(CAT, JUJ, SAL, TUC)
Hypochaeris patagonica	ARG(CHU, SCR, TDF)
Hypochaeris petiolaris	ARG(BAI, CAT, CHU, COR, ERI, LPA, RNE, SFE, SLU, TUC) / URY(CAS, MON, SOR)
Hypochaeris pilosa	CHL(BIO, ARA)
Hypochaeris radicata	ARG(BAI, CHU, COR, DFE, ERI, JUJ, LPA, MEN, NEU, RNE, SAL, SLU, SCR, SFE, TDF) / BRA(PAR, RGS, SCA) / CHL(COQ, VAL, MAU, BIO, ARA, LLA, AIS, MAG, JFE, IPA) / URY(CAS, COL, FLO, MAL, MON, ROC, SJO)
Hypochaeris scorzonerae var. glabrata	CHL(ATA, COQ, VAL, RME)
Hypochaeris scorzonerae var. scorzonerae	CHL(ATA, COQ, VAL, LBO, RME)
Hypochaeris scorzonerae var. ramosa	CHL(VAL)
Hypochaeris spathulata var. chiloensis	CHL(LBO, LLA)
Hypochaeris spathulata var. spathulata	CHL(LBO, MAU, BIO, ARA, LLA)
Hypochaeris taraxacoides	ARG(CAT, JUJ, LRI, SAL, TUC) / CHL(TAR, ANT)
Hypochaeris tenerifolia	ARG(CHU, MEN, NEU, TDF) / CHL(BIO, ARA, LLA, MAG)
Hypochaeris tenuifolia var. eurylepis	ARG(CHU, MEN, NEU, RNE) / CHL(LBO, MAU, BIO, ARA, LLA)
Hypochaeris tenuifolia var. linearifolia	ARG(NEU) / CHL(LBO, MAU, RME)
Hypochaeris tenuifolia var. tenuifolia	ARG(MEN, NEU, RNE) / CHL(COQ, VAL, LBO, MAU, BIO, ARA, LLA, AIS, MAG, RME)
Hypochaeris thermarum	CHL(MAU)
Hypochaeris thrincioides	CHL(COQ, VAL, LBO, MAU, BIO, ARA, LLA, RME)
Hypochaeris toltensis	CHL(ARA)
Hypochaeris tropicalis var. australis	ARG(COS, ERI) / PRY(MIE) / URY(ART, CLA, FLA, PAY, SAO, SOR)
Hypochaeris tropicalis var. tropicalis	ARG(COS, MIS) / BRA(RGS) / PRY(PAI)
Hypochaeris variegata	ARG(BAI, COS, ERI, LPA, MIS) / BRA(RGS) / URY(COL, LAV, MAL, MON)
Hypoestes phyllostachya	PRY(APA)
Hypolepis acantha	BRA(PAR, RGS)
Hypolepis hostilis	BRA(RGS, SCA)
Hypolepis mitis	BRA(PAR, RGS, SCA)
Hypolepis poeppigii	ARG(CAT, COR, JUJ, SAL, TUC) / CHL(COQ, VAL, LBO, MAU, BIO, ARA, LLA, AIS, MAG, RME, JFE)
Hypolepis repens	BRA(Fuera del área del proyecto) / PRY(AMA, CON)
Hypolepis rigescens	BRA(PAR)
Hypolepis rugosula ssp. pradoana	BRA(PAR, RGS, SCA)
Hypolepis rugosula ssp. poeppigiana	ARG(BAI, CHU, MEN, NEU, RNE) / CHL(COQ, VAL, BIO, ARA, LLA, AIS, MAG, JFE)
Hypolepis stolonifera var. stolonifera	ARG(MIS) / BRA(PAR, RGS, SCA)
Hypolepis stolonifera var. delasotae	ARG(MIS) / BRA(PAR)
Hypolepis stolonifera var. nebularis	BRA(PAR, SCA)
Hypolytrum schraderianum	BRA(PAR, SCA)
Hypoxis catamarcensis	ARG(CAT)
Hypoxis decumbens	ARG(BAI, CHA, COS, DFE, ERI, JUJ, MIS, SAL, TUC) / BRA(PAR, RGS, SCA) / PRY(APA, CAA, CAN, CEN, COA, GUA, MIE, ÑEE) / URY(RNO, ROC)
Hypoxis humilis	ARG(COR)
Hypseocharis pimpinellifolia	ARG(CAT, JUJ, LRI, SAL, TUC)
Hypseocharis tridentata	ARG(JUJ, SAL, TUC)
Hyptis alata ssp. rugosula	ARG(COS) / BRA(PAR) / PRY(CAU, SPE)
Hyptis albicoma	BRA(Fuera del área del proyecto) / PRY(AMA, CAN, GUA)
Hyptis angulosa	BRA(SCA)
Hyptis australis	ARG(MIS)
Hyptis balansae	ARG(COS, MIS) / BRA(PAR, RGS, SCA) / PRY(CAU, CAN, COA, GUA, PAI)
Hyptis brevipes	ARG(BAI, CHA, COS, ERI, FOR, MIS, SFE) / BRA(PAR, RGS, SCA) / PRY(APY, BOQ, CAA, CEN, COA, GUA, PAI, PHA) / URY(RIV)
Hyptis caespitosa	BRA(PAR) / PRY(APA, AMA, CAU, CAN, CON, GUA, SPE)
Hyptis campestris	BRA(PAR)
Hyptis comaroides	ARG(COS, MIS) / BRA(PAR, RGS, SCA) / PRY(CAU, CAA, CAN, COA, GUA, ITA, MIE, PAI, SPE)
Hyptis dumetorum	ARG(FOR) / PRY(APY, CAU, CAN, CEN, CON, COA, GUA, PAI, SPE)
Hyptis hassleri	PRY(APA, CAU, CAN, SPE)
Hyptis hirsuta	BRA(Fuera del área del proyecto) / PRY(CEN, COA, ITA, PAI)
Hyptis homalophylla	BRA(PAR)
Hyptis inodora	BRA(PAR, RGS, SCA)
Hyptis lacustris	BRA(PAR, RGS, SCA)
Hyptis lagenaria	ARG(MIS) / BRA(PAR, RGS, SCA)
Hyptis lappacea	ARG(BAI, CHA, COS, ERI, FOR, JUJ, MIS, SAL, SFE, TUC) / BRA(PAR, RGS, SCA) / PRY(APA, APY, BOQ, CAU, CAA, CEN, CHO, CON, COA, GUA, ÑEE, PAI, PHA) / URY(SAO, TAC)
Hyptis lappulacea	ARG(MIS) / BRA(PAR, SCA) / PRY(AMA)
Hyptis lorentziana	ARG(BAI, CHA, COS, ERI, FOR, MIS) / BRA(PAR, RGS, SCA) / PRY(CAU, CAN, COA, PAI) / URY(ART, COL, RNO, SAO, TAC, TYT)
Hyptis lutescens	BRA(Fuera del área del proyecto) / PRY(AMA, CAN)
Hyptis marrubioides	BRA(PAR)
Hyptis meridionalis	BRA(PAR)
Hyptis microphylla	BRA(Fuera del área del proyecto) / PRY(AMA)
Hyptis muelleri	ARG(COS, MIS) / BRA(PAR, RGS, SCA) / PRY(APA, CAU, CAN, COA, GUA, PAI, SPE) / URY(RIV)
Hyptis pachyarthra	PRY(AMA, CAN)
Hyptis pulchella	BRA(PAR) / PRY(AMA, CAN)
Hyptis radicans	BRA(SCA)
Hyptis recurvata	ARG(COS) / BRA(PAR, RGS)
Hyptis sylvularum	ARG(MIS)
Hyptis tetracephala	BRA(RGS, SCA)
Hyptis tetragona	BRA(Fuera del área del proyecto) / PRY(AMA, CAN, GUA)
Hyptis tweedii	BRA(RGS)
Hyptis uliginosa	ARG(MIS) / BRA(PAR, RGS, SCA)
Hyptis umbrosa	BRA(PAR, SCA)
Hyptis villosa	BRA(Fuera del área del proyecto) / PRY(AMA, CAN)
Hysterionica aberrans var. aberrans	ARG(TUC)
Hysterionica aberrans var. hunzikeri	ARG(CAT, JUJ, TUC)
Hysterionica bakeri	ARG(CAT, CHA, COR, JUJ, SAL, SDE, TUC)
Hysterionica cabrerae	ARG(LRI, MEN, SJU)
Hysterionica dianthifolia var. dianthifolia	ARG(COR)
Hysterionica dianthifolia var. pulvinata	ARG(COR)
Hysterionica filiformis	ARG(COR, ERI, SFE) / BRA(RGS) / URY(CLA, COL, LAV, RIV, ROC)
Hysterionica glaucifolia	ARG(MEN)
Hysterionica jasionoides	ARG(BAI, CAT, CHA, COR, ERI, FOR, JUJ, LPA, LRI, MEN, NEU, RNE, SAL, SJU, SLU, SCR, SFE, SDE, TUC)
Hysterionica matzenbacherii	BRA(SCA)
Hysterionica montevidensis	ARG(COS, ERI, MIS) / BRA(RGS) / PRY(CEN, ITA) / URY(ART, PAY, RNO, RIV, SAO, TAC)
Hysterionica nebularis	BRA(RGS)
Hysterionica pinifolia	ARG(BAI) / BRA(RGS) / URY(CAS, CLA, COL, LAV, MAL, MON, ROC)
Hysterionica pinnatiloba	BRA(RGS)
Hysterionica pinnatisecta	BRA(SCA)
Hysterionica pulchella	ARG(CAT, LRI, SAL, TUC)