Ugni candollei	CHL(MAU, BIO, ARA, LLA)
Ugni molinae	ARG(CHU, NEU, RNE) / CHL(VAL, LBO, MAU, BIO, ARA, LLA, AIS, MAG)
Ugni selkirkii	CHL(JFE)
Ulantha apinnula	CHL(MAU)
Ulantha grandiflora	CHL(MAU, BIO, ARA)
Uleiorchis prataënsis	BRA(PAR)
Uleiorchis ulaei	BRA(SCA)
Ulex europaeus	ARG(BAI, CHU, NEU, RNE, SCR, TDF) / BRA(RGS, SCA) / CHL(BIO, ARA, LLA) / URY(CAS, MON, ROC, SJO)
Ullucus tuberosus ssp. aborigineus	ARG(JUJ)
Uncinia andina	ARG(NEU, RNE) / CHL(BIO, ARA)
Uncinia araucana	CHL(ARA)
Uncinia aspericaulis	CHL(JFE)
Uncinia austroamericana	ARG(TDF) / CHL(MAG)
Uncinia chilensis	ARG(NEU, RNE) / CHL(BIO, ARA)
Uncinia costata	CHL(JFE)
Uncinia douglasii	CHL(JFE)
Uncinia erinacea	CHL(MAU, BIO, ARA, LLA, AIS, MAG)
Uncinia hamata	ARG(COR, JUJ, SAL, TUC)
Uncinia lechleriana	ARG(CHU, TDF) / CHL(AIS, MAG)
Uncinia macloviana	ARG(CHU, RNE, SCR, TDF) / CHL(BIO, LLA, AIS, MAG, JFE)
Uncinia macloviformis	CHL(JFE)
Uncinia macrolepis	ARG(SCR, TDF) / CHL(MAG)
Uncinia macrophylla	CHL(BIO, LLA)
Uncinia multifaria	CHL(BIO, ARA, LLA)
Uncinia negeri	ARG(NEU, RNE) / CHL(ARA, LLA, AIS)
Uncinia phleoides	ARG(BAI, CAT, CHU, COR, JUJ, NEU, RNE, SAL, TUC) / CHL(COQ, VAL, MAU, BIO, ARA, LLA, AIS, RME, JFE)
Uncinia scabriuscula	ARG(NEU, RNE) / CHL(ARA, LLA, AIS, JFE)
Uncinia setifolia	CHL(COQ, VAL, LBO, MAU, RME)
Uncinia tenuis	ARG(CHU, NEU, RNE, SCR, TDF) / CHL(ARA, LLA, AIS, MAG, JFE)
Uncinia trichocarpa	CHL(COQ, MAU, BIO, ARA, LLA)
Uncinia triquetra	ARG(CHU, TDF) / CHL(LLA, AIS, MAG)
Urena lobata	BRA(PAR) / PRY(AMA)
Urera altissima	ARG(JUJ, SAL, TUC)
Urera aurantiaca	ARG(CHA, COS, ERI, FOR, JUJ, MIS, SAL, SFE) / BRA(PAR, RGS, SCA) / PRY(CEN, COA, ÑEE, PAI, PHA)
Urera baccifera	ARG(CAT, CHA, COS, FOR, JUJ, MIS, SAL, TUC) / BRA(PAR, RGS, SCA) / PRY(APA, APY, CAA, CAN, CEN, ÑEE, PAI, SPE)
Urera caracasana	ARG(CHA, COS, JUJ, SAL, TUC) / BRA(PAR) / PRY(APA, ÑEE, PAI)
Urera nitida	BRA(PAR, RGS, SCA)
Urmenetea atacamensis	ARG(CAT, JUJ, SAL) / CHL(ANT, ATA)
Urocarpidium albiflorum	CHL(TAR)
Urocarpidium chilensis	CHL(ANT, ATA, COQ)
Urocarpidium echinatum	ARG(JUJ, SAL, TUC)
Urocarpidium mathewsii	CHL(ANT, ATA, COQ)
Urocarpidium pentacoccum	ARG(CAT)
Urocarpidium pentandrum	ARG(CAT, JUJ, LRI, SAL, TUC)
Urocarpidium peruvianum	CHL(TAR, ANT, COQ)
Urocarpidium sanambrosianum	CHL(IDE)
Urochloa adspersa	ARG(CHA, COS, FOR, JUJ, SAL, SDE, SFE, TUC) / BRA(Fuera del área del proyecto) / PRY(APY, BOQ, CEN, CHO, CON, COA, MIE, PAI, PHA)
Urochloa arrecta	ARG(FOR, MIS) / BRA(SCA)
Urochloa brizantha	ARG(COS, FOR, MIS) / BRA(PAR, RGS, SCA) / PRY(APA, APY, AMA, BOQ)
Urochloa decumbens	ARG(COS, MIS) / BRA(PAR, SCA) / PRY(APY, AMA, CAU, CAA, CEN, COA, GUA, SPE)
Urochloa dictyoneura	BRA(Fuera del área del proyecto) / PRY(AMA)
Urochloa fusca	ARG(CHA, FOR, JUJ, SAL, TUC) / BRA(SCA) / PRY(APY)
Urochloa humidicola	ARG(COS) / BRA(SCA)
Urochloa lorentziana	ARG(CAT, CHA, COR, COS, ERI, FOR, JUJ, LRI, SAL, SJU, SLU, SFE, SDE, TUC) / BRA(Fuera del área del proyecto) / PRY(APY, PHA)
Urochloa mosambicensis	ARG(JUJ, SAL, SDE)
Urochloa mutica	ARG(CHA, COS, FOR, JUJ, MIS, SAL) / BRA(PAR, RGS, SCA) / PRY(APY, CEN, CON, COA)
Urochloa panicoides	ARG(BAI, CAT, CHA, COR, JUJ, LPA, SAL, SFE, SDE, TUC)
Urochloa paucispicata	ARG(BAI, CAT, CHA, COR, COS, FOR, JUJ, LRI, SAL, SLU, SFE, SDE, TUC) / BRA(Fuera del área del proyecto) / PRY(APY, BOQ, CEN, CON, COA, PHA)
Urochloa plantaginea	ARG(BAI, CHA, COR, COS, ERI, FOR, JUJ, MIS, SAL, SFE, SDE, TUC) / BRA(PAR, RGS, SCA) / PRY(APY, CEN, CON, COA, SPE) / URY(ART, RNO, RIV)
Urochloa platyphylla	ARG(BAI, CHA, COR, COS, DFE, ERI, FOR, JUJ, LPA, LRI, SAL, SLU, SFE, SDE, TUC) / BRA(RGS) / PRY(CEN, ÑEE, PAI) / URY(ART)
Urochloa ruziziensis	BRA(SCA)
Urolepis hecatantha	ARG(BAI, CAT, CHA, COR, COS, ERI, FOR, JUJ, MIS, SAL, SFE, SDE, TUC) / BRA(PAR, RGS, SCA) / PRY(APA, AMA, BOQ, CAU, CAA, CAN, CEN, CON, COA, GUA, MIE, PAI, PHA, SPE) / URY(ART, CAS, CLA, MON, PAY, RNO, RIV, ROC, TAC, TYT)
Urospatha sagittifolia	BRA(Fuera del área del proyecto) / PRY(AMA)
Urospermum picroides	ARG(BAI, DFE, SFE) / CHL(COQ, VAL, RME) / URY(MON)
Urtica berteroana	CHL(COQ, VAL, RME)
Urtica chamaedryoides ssp. microsperma	ARG(CAT, COR, JUJ, LRI, SAL, SJU, TUC)
Urtica circularis	ARG(BAI, CAT, CHA, COR, COS, ERI, FOR, JUJ, LRI, MIS, SAL, SDE, SFE, SJU, SLU, TUC) / BRA(PAR, RGS, SCA) / PRY(CEN, COA, SPE) / URY(CLA, LAV, MAL, MON, SJO)
Urtica dioica	ARG(COR) / CHL(BIO, ARA, LLA)
Urtica echinata	ARG(CAT, JUJ, LRI, SAL, TUC) / CHL(TAR, ANT)
Urtica flabellata	ARG(JUJ) / CHL(TAR)
Urtica glomeruliflora	CHL(JFE)
Urtica gracilis ssp. mollis	ARG(BAI, CAT, CHA, CHU, COR, JUJ, LRI, MEN, NEU, RNE, SAL, SJU, TUC) / CHL(ANT, ATA, COQ, VAL, LBO, MAU, ARA, LLA, AIS, MAG, RME)
Urtica lilloi	ARG(CAT, JUJ, SAL, TUC)
Urtica magellanica	ARG(CHU, NEU, RNE, SCR, TDF) / CHL(COQ, VAL, LBO, MAU, BIO, ARA, LLA, AIS, MAG, RME)
Urtica masafuerae	CHL(JFE)
Urtica spatulata	ARG(BAI, CAT, COR, COS, DFE, ERI, LPA, SCR, SDE, SFE, SLU, TUC) / BRA(PAR) / PRY(CEN) / URY(CLA, FLO, MON, SJO)
Urtica trichantha	CHL(TAR, ANT)
Urtica urens	ARG(BAI, CAT, COR, COS, DFE, ERI, JUJ, LPA, LRI, MEN, MIS, NEU, RNE, SJU, SLU, SCR, SFE, SDE, TDF, TUC) / BRA(SCA) / CHL(TAR, ANT, COQ, VAL, LBO, MAU, BIO, ARA, LLA, MAG, RME, JFE) / URY(CAS, FLA, MON, RNO, SOR)
Urvillea chacoënsis	ARG(CAT, CHA, COR, COS, FOR, JUJ, LRI, SAL, SDE, SJU, TUC) / BRA(Fuera del área del proyecto) / PRY(APY, CEN, PHA)
Urvillea filipes	BRA(PAR) / PRY(APY, AMA, CON, PHA)
Urvillea glabra	BRA(PAR, RGS, SCA)
Urvillea laevis	ARG(MIS) / BRA(PAR, SCA) / PRY(APY, APA, PAI)
Urvillea triphylla	BRA(PAR, RGS, SCA)
Urvillea ulmacea	ARG(JUJ, MIS, SAL) / BRA(PAR, RGS, SCA) / PRY(APY, APA, AMA, CAU, CAN, CEN, CON, COA, GUA, PAI, SPE)
Urvillea uniloba	ARG(BAI, COS, DFE, ERI, MIS, SFE) / BRA(RGS, SCA) / PRY(APA, ITA, PAI) / URY(ART, DUR, MON, PAY, RNO, ROC, SAO, SOR, TAC)
Utricularia breviscapa	ARG(COS) / BRA(Fuera del área del proyecto) / PRY(CEN, CON)
Utricularia cucullata	BRA(PAR)
Utricularia erectiflora	BRA(SCA)
Utricularia foliosa	ARG(CHA, COS, FOR, MIS, SFE) / BRA(PAR, RGS, SCA) / PRY(APY, BOQ, CEN, CON, COA, ÑEE, PHA) / URY(ROC)
Utricularia gibba	ARG(BAI, CAT, CHA, COR, COS, ERI, FOR, JUJ, MIS, SAL, SFE, SJU, TUC) / BRA(PAR, RGS, SCA) / CHL(ATA, COQ, MAU, BIO, ARA, LLA) / PRY(APY, CEN, CON, COA, ITA, PHA) / URY(COL, ROC)
Utricularia laxa	ARG(COS, MIS) / BRA(PAR, RGS, SCA) / PRY(COA, GUA, PAI) / URY(RNO)
Utricularia myriocista	ARG(COS) / BRA(Fuera del área del proyecto)
Utricularia nana	BRA(PAR) / PRY(Desconocida)
Utricularia nervosa	ARG(COS, FOR, MIS) / BRA(PAR, SCA) / PRY(APA, CAU, CAN, CEN, COA, MIE, PAI, SPE) / URY(RIV)
Utricularia nigrescens	BRA(PAR)
Utricularia olivacea	BRA(RGS)
Utricularia platensis	ARG(BAI, CHA, COS, ERI, RNE, SFE) / BRA(RGS) / PRY(CAU) / URY(CAS, COL, ROC)
Utricularia poconensis	ARG(CHA, COS) / BRA(Fuera del área del proyecto)
Utricularia praelonga	ARG(COS, MIS) / BRA(PAR, RGS, SCA) / PRY(APY, AMA, CAU, CAA, CEN, COA, GUA, ITA, MIE, PAI, SPE)
Utricularia pusilla	ARG(COS, ERI) / BRA(Fuera del área del proyecto) / PRY(APY, CEN, COA, MIE)
Utricularia reniformis	BRA(PAR, RGS, SCA)
Utricularia simulans	BRA(Fuera del área del proyecto) / PRY(CON)
Utricularia subulata	ARG(COS) / BRA(PAR, RGS, SCA) / PRY(SPE) / URY(CAS)
Utricularia tricolor	ARG(COS, MIS) / BRA(PAR, RGS, SCA) / PRY(CAU, CAN, COA, GUA, SPE) / URY(RIV)
Utricularia tridentata	ARG(ERI, MIS) / BRA(PAR, RGS, SCA) / URY(CAS, MON, SJO)
Utricularia triloba	ARG(COS) / BRA(PAR, SCA) / PRY(AMA, COA)
