Lablab purpureus	URY(MON)
Laburnum anagyroides	ARG(NEU, RNE)
Lachemilla asplenifolia	ARG(LRI, TUC)
Lachemilla bipinnatifida	ARG(TUC)
Lachemilla diplophylla	CHL(TAR, ANT)
Lachemilla frigida	ARG(COR, JUJ, SAL, TUC)
Lachemilla grisebachiana	ARG(TUC)
Lachemilla pedicellata	ARG(TUC)
Lachemilla pinnata	ARG(CAT, COR, JUJ, LRI, SAL, SLU, TUC) / CHL(TAR, ANT)
Lachemilla sandiensis	CHL(TAR)
Lachnagrostis filiformis	ARG(BAI, ERI, LPA, SFE) / CHL(VAL, MAU, LLA, IPA)
Lacistema aggregatum	ARG(JUJ, MIS)
Lacistema hasslerianum	ARG(JUJ, MIS) / BRA(PAR) / PRY(APA, AMA, CAU, CAN, PAI)
Lacistema lucidum	BRA(PAR)
Lactoris fernandeziana	CHL(JFE)
Lactuca canadensis	BRA(PAR)
Lactuca saligna	ARG(BAI, CAT, DFE, LPA, MEN, NEU, SLU) / URY(FLA, MON, PAY)
Lactuca sativa	ARG(BAI, COR) / CHL(TAR, RME)
Lactuca serriola	ARG(BAI, CAT, CHA, CHU, COR, COS, DFE, ERI, JUJ, LPA, LRI, MEN, MIS, NEU, RNE, SAL, SJU, SLU, SFE) / BRA(RGS, SCA) / CHL(ANT, COQ, VAL, LBO, MAU, BIO, ARA, RME) / PRY(PAI) / URY(ART, COL, MON, PAY, RNO, RIV, SAO, SOR, TAC)
Lactuca virosa	CHL(MAU, BIO, ARA, RME)
Laennecia altoandina	ARG(JUJ)
Laennecia artemisioides	ARG(JUJ, SAL) / CHL(TAR)
Laennecia sophiifolia	ARG(CAT, CHA, COR, JUJ, LPA, LRI, MEN, SAL, SDE, SJU, SLU, TUC)
Laetia americana	BRA(Fuera del área del proyecto) / PRY(CON, PHA)
Lafoensia nummularifolia	ARG(MIS) / BRA(PAR, SCA)
Lafoensia vandelliana	BRA(PAR, SCA) / PRY(AMA, CEN, CON, COA, PAI)
Lagascea mollis	ARG(CHA, COR, COS, FOR, JUJ, SAL, SDE, TUC) / PRY(APY, CEN)
Lagenaria siceraria	ARG(COS, JUJ) / BRA(PAR, RGS) / PRY(APY, CAA, PAI) / URY(SOR)
Lagenocarpus junciformis	BRA(RGS)
Lagenocarpus polyphyllus	BRA(PAR)
Lagenocarpus rigidus ssp. rigidus	BRA(PAR, SCA)
Lagenocarpus rigidus ssp. tenuifolius	BRA(PAR, SCA)
Lagenocarpus triqueter	BRA(PAR, SCA)
Lagenophora hariotii	ARG(CHU, NEU, RNE, SCR, TDF) / CHL(MAU, BIO, ARA, LLA, AIS, MAG, JFE)
Lagenophora hirsuta	ARG(CHU, NEU, RNE) / CHL(MAU, BIO, ARA, LLA, MAG, RME)
Lagenophora nudicaulis	ARG(CHU, NEU, RNE, TDF) / CHL(LBO, MAU, BIO, ARA, LLA, AIS, MAG)
Laguncularia racemosa	BRA(PAR, SCA)
Lagurus ovatus	ARG(BAI) / BRA(RGS) / CHL(COQ, VAL, LBO, MAU, BIO, ARA, LLA, MAG) / URY(MON)
Lamanonia cuneata	BRA(PAR, SCA) / PRY(COA, PAI)
Lamanonia ternata	ARG(MIS) / BRA(PAR, RGS) / PRY(GUA, PAI)
Lamarckia aurea	ARG(BAI, LPA, MEN, SFE) / CHL(ATA, COQ, VAL, RME)
Lamium amplexicaule	ARG(BAI, CHU, COR, DFE, ERI, MIS, NEU, RNE, SAL, SJU, SLU, SCR, SFE, TDF, TUC) / CHL(ANT, ATA, COQ, VAL, MAU, BIO, ARA, MAG, RME) / URY(MON, SOR)
Lamium hybridum	ARG(TDF)
Lamium purpureum	ARG(BAI, LPA, TDF)
Lampaya medicinalis	CHL(ANT)
Lampayo castellani	ARG(JUJ)
Lampayo hieronymi	ARG(CAT, LRI, SAL) / CHL(ANT)
Landoltia punctata	CHL(MAG)
Langsdorffia hypogaea	BRA(PAR, SCA) / PRY(AMA, CAN, SPE)
Lanium berkeleyi	BRA(SCA)
Lankesterella caespitosa	BRA(PAR, RGS, SCA)
Lankesterella ceracifolia	ARG(COS, MIS) / BRA(PAR, RGS, SCA)
Lankesterella salehi	BRA(PAR)
Lantana achyranthifolia	ARG(JUJ, SAL) / PRY(APY, AMA, CON, COA, ITA, SPE)
Lantana balansae	ARG(CHA, COR, COS, FOR, LRI, MIS, SFE) / PRY(APY, CAU, CAA, CEN, CON, COA, ÑEE, PHA) / URY(LAV)
Lantana camara	ARG(BAI, COR, COS, DFE, ERI, FOR, JUJ, MIS, SAL, SFE, SDE, TUC) / BRA(PAR, RGS) / PRY(APA, AMA, CAU, CAA, CAN, CEN, CON, COA, GUA, ITA, MIE, PAI) / URY(LAV)
Lantana canescens	ARG(CAT, JUJ, SAL, TUC) / BRA(PAR) / PRY(APY)
Lantana entrerriensis	ARG(BAI, COS, ERI, MIS)
Lantana fucata	ARG(BAI, CAT, COR, COS, ERI, FOR, JUJ, MIS, SAL, SJU, SFE, SDE, TUC) / BRA(PAR, RGS, SCA) / PRY(APY, APA, AMA, CEN, CON, COA, GUA, ITA, MIE, ÑEE, PAI, PHA) / URY(PAY, RIV, TAC)
Lantana grisebachii	ARG(CAT, CHA, COR, ERI, FOR, JUJ, LRI, MEN, SAL, SJU, SLU, SFE, TUC)
Lantana hypoleuca	PRY(AMA, CAN, CON)
Lantana lundiana	ARG(MIS) / BRA(Fuera del área del proyecto) / PRY(APA, MIE, PAI)
Lantana magnibracteata	ARG(JUJ, SAL, TUC)
Lantana megapotamica	ARG(BAI, COR, COS, ERI, FOR, LRI, MIS, SJU, SLU, SFE, SDE) / BRA(RGS) / PRY(APY, BOQ) / URY(LAV, RIV, ROC, TAC, TYT)
Lantana micrantha	ARG(CAT, COS, FOR, JUJ, MIS, SAL, TUC) / PRY(APY, AMA, CEN, COA, GUA, PAI, PHA, SPE)
Lantana montevidensis	ARG(BAI, CHA, COS, ERI, FOR, LRI, MIS, SLU, SFE) / BRA(PAR, RGS) / PRY(APA, CAU, MIE, ÑEE) / URY(MAL, RNO, SJO)
Lantana ramboi	BRA(RGS)
Lantana tilcarensis	ARG(JUJ, SAL, TUC)
Lantana trifolia f. trifolia	ARG(COS, FOR, JUJ, MIS, SAL, TUC) / BRA(PAR) / PRY(APY, AMA, CAA, CEN, CON, COA, GUA, ITA, MIE, ÑEE, PAI, SPE)
Lantana trifolia f. hirsuta	ARG(JUJ, SAL)
Lantana undulata	BRA(PAR, SCA)
Lantana velutina	ARG(FOR, SAL) / PRY(APY, PHA)
Lantana xenica	ARG(CAT, COR, LRI, MEN, SJU, SLU, SDE, TUC)
Lanugothamnus albolanosus	BRA(RGS)
Lanugothamnus anabelae	BRA(RGS, SCA)
Lanugothamnus pluricapitulatus	BRA(RGS)
Lapageria rosea	CHL(COQ, VAL, LBO, MAU, BIO, ARA, LLA)
Laportea aestuans	BRA(PAR, SCA)
Lappula redowskii	ARG(CHU, LPA, LRI, MEN, NEU, RNE, SCR, SJU, SLU) / CHL(MAG)
Lapsana communis	ARG(BAI, CAT, COR, NEU) / CHL(COQ, VAL, LBO, MAU, BIO, ARA, LLA, AIS, RME, JFE)
Lardizabala biternata	CHL(VAL, LBO, MAU, BIO, ARA, LLA, RME, JFE)
Larrea ameghinoi	ARG(CHU, NEU, RNE, SCR)
Larrea cuneifolia	ARG(BAI, CAT, CHU, COR, LPA, LRI, MEN, NEU, RNE, SAL, SDE, SJU, SLU, TUC)
Larrea divaricata	ARG(BAI, CAT, CHU, COR, LPA, LRI, MEN, NEU, RNE, SAL, SDE, SJU, SLU, TUC) / CHL(ATA, VAL, BIO, RME)
Larrea nitida	ARG(BAI, CAT, CHU, LPA, LRI, MEN, NEU, RNE, SAL, SJU) / CHL(ATA, COQ, VAL, RME)
Lasiacis divaricata var. austroamericana	ARG(JUJ, MIS, SAL) / BRA(PAR, RGS, SCA) / PRY(APY, APA, AMA, CAU, CAA, GUA, PAI, PHA)
Lasiacis ligulata	BRA(PAR, SCA)
Lasiacis sorghoidea	ARG(CHA, COS, FOR, JUJ, MIS, SAL) / BRA(PAR) / PRY(APA, APY, AMA, BOQ, CAA, CAN, CEN, CON, COA, GUA, ÑEE, PAI, PHA, SPE)
Lastarriaea chilensis	CHL(ATA, COQ, VAL, LBO, RME)
Lasthenia kunthii	ARG(CHU, RNE) / CHL(COQ, VAL, LBO, MAU, BIO, ARA, MAG, RME)
Lastreopsis amplissima	ARG(MIS) / BRA(PAR, RGS, SCA) / PRY(CAA, CAN)
Latace andina f. andina	ARG(JUJ, MEN, NEU, SJU) / CHL(VAL, LBO, LLA, RME)
Latace andina f. lutea	ARG(MEN, NEU) / CHL(VAL, RME)
Latace serenense	CHL(ATA, COQ)
Lathyrus berteroanus	CHL(COQ, VAL, LBO, MAU, BIO, RME)
Lathyrus cabrerianus	ARG(NEU, RNE) / CHL(BIO, ARA, LLA, AIS)
Lathyrus campestris	ARG(CHU) / CHL(MAU, LLA)
Lathyrus cicera	CHL(VAL)
Lathyrus crassipes	ARG(COS) / BRA(RGS) / CHL(BIO, LLA, RME)
Lathyrus cryophilus	ARG(MEN)
Lathyrus elegans	BRA(PAR)
Lathyrus hasslerianus	ARG(MIS) / BRA(PAR, RGS, SCA)
Lathyrus hirsutus var. ecirrhosus	ARG(BAI)
Lathyrus hirsutus var. hirsutus	ARG(BAI) / URY(MON)
Lathyrus hookeri	ARG(BAI, CHU, NEU, RNE, SLU) / BRA(RGS) / CHL(LBO, BIO, RME) / URY(COL, PAY, SOR)
Lathyrus ibicuiensis	BRA(RGS)
Lathyrus japonicus var. japonicus	CHL(BIO, ARA, LLA)
Lathyrus japonicus var. aleuticus	CHL(AIS)
Lathyrus latifolius	ARG(BAI, CAT, LPA, MEN, NEU, RNE) / URY(FLA, MON)
Lathyrus linearifolius	ARG(COS) / BRA(PAR, RGS, SCA)
Lathyrus lomanus	CHL(ANT)
Lathyrus macropus	ARG(CAT, MEN, SAL, SJU, SLU) / CHL(VAL, ARA, RME)
Lathyrus macrostachys	ARG(CHA, COS, FOR, JUJ, MIS, SFE) / BRA(RGS) / PRY(PHA) / URY(CLA, FLA, MAL, RNO, SJO, TAC)
Lathyrus magellanicus var. magellanicus	ARG(CHU, LPA, NEU, RNE, SCR, TDF) / CHL(VAL, LBO, MAG)
Lathyrus magellanicus var. longipes	ARG(NEU) / CHL(LBO, RME)
Lathyrus magellanicus var. gladiatus	ARG(CHU, MEN, NEU, RNE) / CHL(ARA)
Lathyrus magellanicus var. glaucescens	ARG(CHU, NEU, RNE, SCR, TDF) / CHL(AIS)
Lathyrus magellanicus var. tucumanensis	ARG(CAT, JUJ, SAL, TUC) / CHL(LLA) / URY(CAS, CLA, SJO)
Lathyrus multiceps	ARG(NEU, RNE, SLU) / CHL(VAL, LBO, MAU, BIO, ARA, RME)
Lathyrus nervosus	ARG(BAI, CHU, LPA, MIS, RNE, SAL, SCR) / BRA(PAR, RGS, SCA) / CHL(ARA, AIS, MAG) / URY(CAS, CLA, LAV, MAL, MON, RIV, ROC, SJO, TYT)
Lathyrus nigrivalvis	ARG(CHA, COS, ERI, FOR, SFE) / PRY(PHA)
Lathyrus nitens	BRA(PAR, RGS, SCA) / URY(CLA, RNO, RIV, SAO, TAC)
Lathyrus paraguariensis	BRA(PAR, RGS, SCA) / PRY(APA)
Lathyrus paranensis	ARG(BAI, COS, ERI) / BRA(PAR, RGS, SCA) / URY(CAS, CLA, FLA, MAL, MON, PAY, RNO, RIV, ROC, SJO, SOR, TYT)
Lathyrus parodii var. parodii	ARG(BAI) / BRA(PAR, RGS) / URY(CLA, MON, RNO, RIV, SJO)
Lathyrus parodii var. brevipetiolata	ARG(BAI) / BRA(RGS)
Lathyrus pastorei	ARG(NEU, RNE)
Lathyrus pubescens var. pubescens	ARG(BAI, CAT, CHU, COR, COS, ERI, LPA, RNE, SAL, SCR, SLU, TUC) / BRA(RGS, SCA) / CHL(COQ, VAL, BIO, ARA, LLA, RME) / URY(ART, CAS, CLA, COL, FLA, LAV, MAL, MON, PAY, RNO, RIV, SJO, SOR, TAC)
Lathyrus pubescens var. monticola	ARG(SAL, TUC)
Lathyrus pusillus	ARG(BAI, CHA, CHU, COR, COS, ERI, LPA, MIS, NEU, RNE, SFE) / BRA(RGS, SCA) / CHL(LLA) / PRY(ITA) / URY(ART, CAS, CLA, COL, DUR, FLA, LAV, MAL, MON, RNO, RIV, SAO, SJO, SOR, TAC, TYT)
Lathyrus sativus	CHL(LBO, MAU, BIO) / URY(MON)
Lathyrus subandinus	CHL(VAL, MAU, BIO, ARA, RME)
Lathyrus subulatus	ARG(BAI, COR, ERI, LPA, MIS, SFE) / BRA(RGS, SCA) / URY(ART, CAS, CLA, COL, DUR, FLO, FLA, LAV, MAL, MON, PAY, RNO, RIV, ROC, SAO, SJO, SOR, TAC)
Lathyrus tomentosus	ARG(BAI, CHU, SFE) / URY(CAS, COL, MON, ROC, SJO)
Lathyrus tropicalandinus	ARG(CAT, SAL, TUC)
Latua pubiflora	CHL(BIO, ARA, LLA)
Laurelia sempervirens	CHL(MAU, BIO, ARA, LLA)
Laureliopsis philippiana	ARG(CHU, NEU, RNE) / CHL(MAU, BIO, ARA, LLA, AIS)
Laurembergia tetrandra	BRA(PAR, RGS, SCA) / PRY(AMA) / URY(CAS)
Lavoisiera phyllocalycina	BRA(PAR)
Lavoisiera pulchella	BRA(PAR)
Leandra acutiflora	BRA(PAR, SCA)
Leandra amplexicaulis	BRA(PAR, SCA)
Leandra aurea	BRA(PAR)
Leandra australis var. australis	ARG(COS, MIS) / BRA(PAR, RGS, SCA) / PRY(AMA, CAU, CAA, CAN, CEN, GUA)
Leandra australis var. angustifolia	ARG(COS) / BRA(PAR, SCA)
Leandra australis var. phaeotricha	BRA(RGS, SCA) / URY(ART, CLA)
Leandra balansae	ARG(MIS, SAL) / BRA(SCA) / PRY(APA, CAU, CAA, CEN, PAI)
Leandra barbinervis	BRA(PAR, SCA)
Leandra bergiana	BRA(SCA)
Leandra calvescens	BRA(PAR, SCA)
Leandra camporum	BRA(RGS)
Leandra carassana	BRA(PAR, RGS, SCA)
Leandra cardiophylla	BRA(PAR, SCA)
Leandra catharinensis	BRA(PAR, RGS, SCA)
Leandra chaetodon	PRY(AMA)
Leandra confusa	BRA(PAR)
Leandra cordifolia	BRA(PAR, SCA)
Leandra cordigera var. transiens	BRA(SCA)
Leandra cordigera var. cordigera	BRA(PAR, SCA)
Leandra crenata	ARG(MIS, SAL) / BRA(Fuera del área del proyecto) / PRY(APA, COA, PAI)
Leandra debilis	BRA(PAR, SCA)
Leandra dispar	BRA(PAR, RGS)
Leandra dubia	BRA(SCA)
Leandra echinata	BRA(PAR, SCA)
Leandra eichleri	BRA(PAR)
Leandra erostrata var. minor	ARG(SAL) / BRA(PAR)
Leandra erostrata var. erostrata	ARG(MIS, SAL) / BRA(PAR, RGS, SCA) / PRY(AMA)
Leandra fallax	BRA(PAR, SCA)
Leandra fastigiata	BRA(PAR)
Leandra foveolata	BRA(PAR)
Leandra fragilis	BRA(PAR, SCA)
Leandra glabrata	BRA(PAR)
Leandra glazioviana	BRA(PAR, SCA)
Leandra gracilis	BRA(PAR, SCA)
Leandra hatschbachii	BRA(PAR)
Leandra herincquiana	PRY(CAU)
Leandra hirtella	BRA(PAR, SCA)
Leandra horrida	BRA(PAR, SCA)
Leandra humilis var. glabrata	BRA(SCA)
Leandra ionopogon	BRA(PAR, SCA)
Leandra itatiaiae	BRA(PAR, SCA)
Leandra lacunosa	BRA(PAR) / PRY(COA)
Leandra laevigata	BRA(PAR, RGS, SCA)
Leandra longisetosa	BRA(PAR)
Leandra longistyla	BRA(PAR)
Leandra luctatoris	BRA(SCA)
Leandra macropora	BRA(SCA)
Leandra melastomoides	BRA(PAR, SCA)
Leandra microphylla	BRA(PAR)
Leandra multiplinervis	BRA(PAR)
Leandra neglecta	BRA(PAR, SCA)
Leandra niederleinii	ARG(MIS)
Leandra opaca	BRA(RGS)
Leandra pallida var. brevifolia	BRA(SCA)
Leandra pallida var. pallida	BRA(PAR, SCA)
Leandra parvifolia	BRA(PAR)
Leandra pilonensis	BRA(PAR, SCA)
Leandra planifilamentosa	BRA(PAR, RGS, SCA)
Leandra polystachya	BRA(PAR, RGS, SCA)
Leandra purpurascens	BRA(PAR, RGS, SCA)
Leandra purpureo-villosa	BRA(PAR, RGS, SCA)
Leandra quinquedentata	BRA(PAR, SCA)
Leandra ramboi	BRA(RGS)
Leandra refracta	BRA(PAR, SCA)
Leandra regnellii	ARG(MIS, SAL) / BRA(PAR, RGS, SCA)
Leandra reitzii	BRA(PAR, SCA) / PRY(AMA, CEN, COA, PAI)
Leandra reversa	BRA(PAR, SCA)
Leandra riograndensis	BRA(PAR, RGS, SCA)
Leandra sabiaënsis	BRA(PAR, SCA)
Leandra salicina	BRA(PAR)
Leandra scabra	BRA(PAR, SCA)
Leandra sericea	BRA(PAR)
Leandra simplicicaulis	BRA(PAR, SCA)
Leandra sulfurea	BRA(PAR, SCA)
Leandra tetraquera	BRA(PAR, SCA)
Leandra ulaei	BRA(SCA)
Leandra urbaniana	BRA(SCA)
Leandra variabilis	BRA(PAR, RGS, SCA)
Leandra xanthocoma	ARG(MIS) / BRA(PAR, RGS, SCA) / PRY(CAN)
Leandra xanthostachya	BRA(PAR, SCA)
Lebetanthus myrsinites	ARG(TDF) / CHL(LLA, AIS, MAG)
Lecanophora ameghinoi	ARG(CAT, CHU, LRI, MEN, NEU, RNE, SCR, SJU)
Lecanophora chubutensis	ARG(CHU, MEN, NEU, RNE, SCR)
Lecanophora ecristata	ARG(BAI, CHU, LPA, MEN, NEU, RNE, SCR, SJU, SLU)
Lecanophora heterophylla	ARG(CAT, COR, LPA, LRI, MEN, NEU, RNE, SJU, SLU, TUC)
Lecanophora jarae	ARG(CAT)
Lecanophora ruiz-lealii	ARG(RNE)
Lecanophora subacaulis	ARG(SCR) / CHL(MAG)
Leersia hexandra	ARG(BAI, CHA, COR, COS, DFE, ERI, FOR, JUJ, LPA, MIS, SAL, SLU, SFE, TUC) / BRA(PAR, RGS, SCA) / PRY(APY, BOQ, PHA) / URY(DUR, ROC)
Leersia ligularis var. grandiflora	ARG(FOR, MIS) / BRA(PAR, RGS, SCA) / PRY(GUA) / URY(MON)
Leersia virginica	BRA(PAR, RGS, SCA)
Legenere valdiviana	ARG(CHU) / CHL(LLA)
Legrandia concinna	CHL(MAU, BIO)
Leiothrix arechavaletae	URY(MON, RIV)
Leiothrix flavescens var. flavescens	BRA(PAR, RGS, SCA)
Leiothrix flavescens var. polystemma	BRA(PAR)
Lellingeria apiculata	BRA(PAR)
Lellingeria brevistipes	BRA(PAR, RGS, SCA)
Lellingeria ciliolepis	ARG(SAL)
Lellingeria depressa	BRA(PAR, SCA)
Lellingeria itatimensis	BRA(PAR, RGS)
Lellingeria tamandarei	BRA(SCA)
Lemna aequinoctialis	ARG(CHA, CHU, COR, COS, ERI, FOR, JUJ, LRI, MEN, MIS, SAL, SJU, SFE, SDE, TUC) / BRA(SCA) / PRY(APY, CAU, ITA, ÑEE, PHA, SPE)
Lemna disperma	ARG(SFE)
Lemna gibba	ARG(BAI, CAT, CHA, CHU, COR, COS, ERI, FOR, JUJ, LPA, LRI, MEN, RNE, SAL, SCR, SDE, SFE, SJU, SLU, TUC) / BRA(RGS) / CHL(TAR, ANT, COQ, VAL, LBO, BIO, LLA, RME) / PRY(APY, PHA) / URY(CAS, MON, TYT)
Lemna minuta	ARG(BAI, CAT, CHA, CHU, COR, COS, ERI, FOR, JUJ, LRI, MEN, NEU, RNE, SAL, SCR, SDE, SFE, SJU, TUC) / BRA(RGS, SCA) / CHL(TAR, ANT, COQ, VAL, LBO, MAU, BIO, ARA, LLA, RME) / PRY(APY, CEN, COA, PAI) / URY(CAS, FLA, MON, ROC, SJO, TYT)
Lemna valdiviana	ARG(BAI, CHA, CHU, COR, COS, ERI, FOR, JUJ, LPA, MEN, MIS, NEU, SAL, SCR, SFE, TUC) / BRA(RGS, SCA) / CHL(TAR, VAL, MAU, ARA, LLA, RME) / PRY(CEN) / URY(CAS, MON, ROC, SJO, TYT)
Lenzia chamaepitys	ARG(JUJ, LRI, SJU) / CHL(ANT, ATA, COQ)
Leonotis nepetifolia	ARG(BAI, COS, ERI, MIS) / BRA(RGS, SCA) / PRY(CEN, COA, PAI) / URY(ART, PAY)
Leontochir ovallei var. ovallei	CHL(ATA)
Leontochir ovallei var. luteus	CHL(ATA)
Leontodon autumnalis	ARG(SCR) / CHL(VAL, MAG)
Leontodon hirtus	CHL(VAL, BIO)
Leontodon saxatilis	ARG(BAI, COR) / CHL(VAL, LBO, MAU, BIO, ARA, LLA, JFE)
Leonurus cardiaca	ARG(BAI)
Leonurus japonicus	ARG(BAI, CHA, COR, COS, ERI, FOR, JUJ, MIS, SAL, SDE, SFE, TUC) / BRA(PAR, RGS, SCA) / PRY(APA, CAA, CEN, PAI) / URY(ART, CLA, PAY, RNO)
Lepanthopsis floripecten	BRA(PAR, RGS, SCA)
Lepechinia chamaedryoides	CHL(COQ, VAL, LBO, MAU, BIO, ARA, LLA)
Lepechinia floribunda	ARG(BAI, CAT, CHA, COR, FOR, JUJ, LRI, MEN, SAL, SLU, TUC)
Lepechinia meyenii	ARG(CAT, COR, JUJ, LRI, SAL, TUC)
Lepechinia salviae	CHL(COQ, VAL, RME)
Lepechinia subhastata	CHL(VAL)
Lepechinia vesiculosa	ARG(CAT, JUJ, SAL, TUC)
Lepidagathis alopecuroides	PRY(AMA)
Lepidagathis alvarezia	ARG(JUJ, SAL) / BRA(Fuera del área del proyecto) / PRY(CEN, COA, GUA, PAI)
Lepidagathis meridionalis	BRA(PAR, SCA)
Lepidaploa argyrotricha	BRA(PAR, SCA)
Lepidaploa balansae	ARG(COS, MIS) / BRA(PAR, RGS, SCA) / PRY(APA, AMA, CAU, CAA, CAN, CON, COA, GUA, PAI, SPE)
Lepidaploa chamissonis	ARG(CHA, COS, FOR) / BRA(PAR, SCA) / PRY(APY, CHO, PAI, PHA)
Lepidaploa novarae	ARG(SAL)
Lepidaploa pseudomuricata	BRA(PAR, RGS, SCA)
Lepidaploa psilostachya	ARG(MIS) / BRA(PAR) / PRY(APA, COA)
Lepidaploa remotiflora	ARG(COS, FOR, JUJ, MIS, SAL, TUC) / BRA(Fuera del área del proyecto) / PRY(APA, APY, AMA, BOQ, CAU, CAA, CAN, CEN, CON, COA, GUA, ITA, MIE, ÑEE, PAI, PHA, SPE)
Lepidaploa setososquamosa	ARG(SAL) / PRY(APA, AMA, CAN, CON)
Lepidaploa sororia	
Lepidaploa tarijensis	ARG(JUJ, SAL)
Lepidium angustissimum	CHL(ATA, COQ)
Lepidium appelianum	ARG(CHU, MEN, NEU, RNE)
Lepidium argentinum	ARG(CAT, JUJ, LRI, MEN, SAL, TUC)
Lepidium auriculatum	ARG(BAI, CHA, CHU, COR, COS, ERI, FOR, JUJ, LPA, MEN, MIS, NEU, RNE, SAL, SJU, SLU, SCR, SFE, SDE, TUC) / CHL(COQ, VAL, LBO, MAU, BIO, LLA, AIS, MAG) / PRY(APA, CEN, COA, PAI, SPE) / URY(ART, CAS, CLA, COL, CLA, FLA, LAV, MON, PAY, RNO, SJO, SJO, TYT)
Lepidium bipinnatifidum	BRA(RGS) / CHL(VAL, LBO, MAU, BIO, LLA) / URY(MON)
Lepidium boelckeanum	ARG(BAI, COR, COS, LPA, MEN, SLU, SFE, SDE)
Lepidium boelckei	ARG(CAT, JUJ, LRI, SAL)
Lepidium bonariense	ARG(BAI, CAT, CHA, CHU, COR, COS, DFE, ERI, FOR, JUJ, LPA, LRI, MEN, MIS, NEU, RNE, SAL, SJU, SLU, SFE, SDE, TUC) / BRA(RGS, SCA) / CHL(TAR, ANT, ATA, COQ, VAL, BIO, RME, JFE, IPA) / PRY(AMA, CEN, COA) / URY(ART, CAS, CLA, COL, FLA, MAL, MON, ROC, SAO, SJO, TYT)
Lepidium burkartii	ARG(ERI)
Lepidium campestre	
Lepidium chalepense	ARG(CHU, COR, MEN, NEU, RNE, SLU, TDF)
Lepidium chichicara	CHL(TAR, ATA, COQ)
Lepidium coronopus	CHL(LLA)
Lepidium cumingianum	CHL(TAR, VAL, LBO, BIO, RME)
Lepidium densiflorum	ARG(LPA, MEN, SLU)
Lepidium depressum	ARG(CAT, JUJ, LRI, SAL, TUC)
Lepidium didymum	ARG(BAI, CAT, CHA, COR, COS, DFE, ERI, FOR, JUJ, LPA, LRI, MEN, MIS, SAL, SCR, SDE, SFE, SJU, SLU, TDF, TUC) / BRA(RGS, SCA) / CHL(TAR, ANT, ATA, COQ, VAL, LBO, MAU, BIO, ARA, LLA, MAG, RME, IPA) / PRY(CEN, COA) / URY(MON)
Lepidium draba	ARG(BAI, CHU, LPA, MEN, NEU, RNE, SCR, SFE, SLU, TDF) / CHL(TAR, ATA, COQ, VAL, AIS, RME) / URY(MON)
Lepidium filisegmentum	ARG(CHU, LPA, RNE, SCR)
Lepidium gracile	ARG(BAI, CHA, COR, COS, FOR, SLU, SFE, SDE) / PRY(CON, PHA)
Lepidium heterophyllum	
Lepidium hickenii	ARG(BAI)
Lepidium horstii	CHL(VAL)
Lepidium johnstonii	ARG(SAL) / CHL(ANT)
Lepidium jujuyanum	ARG(JUJ)
Lepidium latifolium	ARG(COR) / CHL(MAU)
Lepidium meyenii	ARG(CAT, JUJ, LRI, SAL, TUC) / CHL(TAR)
Lepidium myrianthum	ARG(CAT, CHU, LPA, LRI, MEN, NEU, RNE, SJU, SLU) / CHL(ANT)
Lepidium nitidum	CHL(VAL, MAU, BIO)
Lepidium parodii	ARG(BAI, CHU, ERI, RNE, SFE)
Lepidium pedersenii	ARG(CHA, COS, FOR, MIS, SFE, TUC) / PRY(APA, APY)
Lepidium perfoliatum	ARG(CHU, NEU, RNE, SCR)
Lepidium philippianum	CHL(RME)
Lepidium pinnatifidum	ARG(RNE)
Lepidium pseudodidymum	ARG(SCR, TDF) / CHL(VAL, LBO, MAU, BIO, LLA, AIS, MAG, RME)
Lepidium pubescens	CHL(VAL, LBO, BIO, RME)
Lepidium rahmeri	ARG(JUJ, SAL, TUC) / CHL(TAR, ANT)
Lepidium raimondii	CHL(TAR, ATA)
Lepidium reichei	ARG(SJU) / CHL(COQ, RME)
Lepidium rhytidocarpum	ARG(BAI, CHU, ERI, SFE) / URY(PAY, SAO, TAC)
Lepidium santacruzensis	ARG(SCR)
Lepidium sativum	ARG(CHU, MEN, SCR, TDF) / CHL(BIO)
Lepidium serratum	ARG(COS, ERI) / URY(SOR)
Lepidium spathulatum	CHL(ANT, ATA)
Lepidium spicatum	ARG(BAI, CHU, COR, ERI, LPA, MEN, RNE, SJU, SLU, SCR, SFE) / CHL(ATA, BIO, ARA, LLA, MAG, RME) / URY(CAS, COL, LAV)
Lepidium strictum	CHL(TAR, ANT, ATA, VAL, MAU, BIO, ARA, LLA, RME)
Lepidium stuckertianum	ARG(CAT, CHA, COR, COS, FOR, LPA, LRI, SAL, SJU, SLU, SFE, SDE, TUC)
Lepidium tandilense	ARG(BAI, RNE) / URY(MON)
Lepidium virginicum	ARG(JUJ) / BRA(PAR) / CHL(VAL, IDE) / PRY(CAU, CEN, GUA)
Lepidoceras chilense	CHL(VAL, MAU, BIO, ARA, LLA)
Lepidophyllum cupressiforme	ARG(SCR, TDF) / CHL(MAG)
Lepidothamnus fonkii	ARG(CHU, NEU, RNE, SCR) / CHL(LLA, AIS, MAG)
Lepismium lineare	ARG(COS, MIS) / BRA(PAR, RGS, SCA) / PRY(CAU)
Leptinella scariosa	ARG(NEU, RNE, SCR, TDF) / CHL(BIO, LLA, AIS, MAG)
Leptocarpha rivularis	CHL(ARA)
Leptochloa chloridiformis	ARG(BAI, CHA, COR, COS, DFE, ERI, FOR, SDE, SFE, TUC) / PRY(APY, CON, PHA) / URY(RNO)
Leptochloa fusca ssp. fascicularis	ARG(BAI, CAT, COR, SAL, SLU) / PRY(BOQ, CHO)
Leptochloa fusca ssp. muelleri	ARG(DFE)
Leptochloa fusca ssp. uninervia	ARG(BAI, CHA, COR, COS, DFE, ERI, FOR, JUJ, LPA, LRI, MEN, MIS, NEU, RNE, SAL, SJU, SLU, SFE, SDE, TUC) / CHL(TAR, ANT, ATA) / PRY(APY, CEN, CON, PAI, PHA) / URY(ART)
Leptochloa fusca ssp. fusca	ARG(BAI, ERI, LRI, MIS, RNE, SJU) / PRY(APY)
Leptochloa panicea ssp. brachiata	ARG(CHA, COS, FOR, JUJ, MIS, SAL, SFE, TUC) / PRY(CEN)
Leptochloa scabra	ARG(COS, FOR) / BRA(Fuera del área del proyecto) / PRY(APY, CEN, PHA)
Leptochloa virgata	ARG(CAT, CHA, COR, COS, DFE, ERI, FOR, JUJ, LRI, MIS, SAL, SFE, SDE, TUC) / BRA(PAR, SCA) / PRY(APA, APY, AMA, BOQ, CAU, CAA, CEN, CHO, CON, COA, GUA, ITA, MIE, NAS, PAI, PHA, SPE)
Leptoglossis linifolia	ARG(CAT, COR, LPA, LRI, MEN, RNE, SAL, SJU, SLU, SDE, TUC)
Leptophyllochloa micrathera	ARG(CHU, NEU, RNE) / CHL(VAL, MAU, BIO, ARA, LLA, JFE)
Leptosiphon pusillus	CHL(COQ, VAL, LBO, RME)
Leptostelma catharinense	BRA(SCA)
Leptostelma maxima	ARG(MIS) / BRA(PAR, RGS, SCA) / PRY(CAU, GUA, PAI)
Leptostelma meyeri	ARG(CHA, ERI)
Leptostelma tucumanense	ARG(CAT, TUC)
Leptostelma tweediei	ARG(CHA, COS, ERI, FOR, JUJ, MIS) / BRA(PAR, RGS, SCA) / PRY(APY, APA, AMA, CAU, CAA, CAN, CEN, CON, COA, GUA, PAI) / URY(CAS, CLA, MAL, MON, RNO, RIV, SJO, TAC)
Leptostigma arnottianum	ARG(NEU, RNE) / CHL(BIO, ARA, LLA)
Leptotes bicolor	BRA(PAR, RGS, SCA) / PRY(ITA)
Leptotes tenuis	BRA(SCA)
Leptotes unicolor	ARG(COS, MIS) / BRA(PAR) / PRY(APA, SPE)
Lepuropetalon spathulatum	ARG(ERI) / BRA(RGS) / CHL(VAL, LBO, MAU, BIO, ARA, LLA, RME) / URY(MAL, MON)
Lessingianthus alegretensis	BRA(RGS)
Lessingianthus brevifolius	ARG(COS, ERI, MIS) / BRA(PAR, RGS, SCA) / PRY(APA, AMA, CAU, CAN, CEN, COA, GUA, ITA, MIE, PAI, SPE) / URY(RIV, SAO, TAC)
Lessingianthus cataractum	ARG(MIS) / BRA(PAR, RGS, SCA)
Lessingianthus centauropsideus	ARG(SAL)
Lessingianthus correntinus	ARG(COS)
Lessingianthus glabratus var. glabratus	ARG(COS, ERI, MIS) / BRA(PAR, RGS, SCA) / PRY(APA, AMA, CAU, CAA, CAN, CEN, CON, COA, GUA, ITA, MIE, PAI, PHA, SPE) / URY(RIV, SAO, TAC)
Lessingianthus glabratus var. angustifolius	ARG(COS, ERI, MIS)
Lessingianthus intermedius	ARG(ERI) / BRA(RGS) / URY(MAL, MON)
Lessingianthus laniferus	ARG(COS, MIS) / BRA(PAR, RGS, SCA)
Lessingianthus lorentzii	ARG(COS, ERI, MIS)
Lessingianthus mollissimus var. mollisimus	ARG(BAI, COR, COS, ERI, MIS, SFE) / BRA(PAR, RGS) / PRY(APA, CAU, CAN)
Lessingianthus mollissimus var. microcephalus	ARG(COR, COS, MIS)
Lessingianthus niederleinii	ARG(COS, MIS) / BRA(PAR, RGS) / PRY(APA, APY, AMA, BOQ, CAU, CAA, CAN, CEN, CON, COA, PAI, PHA, SPE)
Lessingianthus paraguariensis	PRY(AMA)
Lessingianthus plantaginodes	ARG(COR, COS, ERI, MIS, SFE) / BRA(PAR, RGS, SCA) / URY(MON)
Lessingianthus polyphyllus	ARG(COS, MIS) / BRA(PAR, RGS, SCA) / PRY(AMA, CAU, CAA, CAN, COA, MIE)
Lessingianthus pseudoincanus	ARG(BAI, CHA, COR, COS, ERI, FOR, MEN, SAL, SLU, SFE, SDE) / BRA(RGS) / PRY(CEN, ÑEE) / URY(ROC)
Lessingianthus pubescens	BRA(RGS, SCA) / PRY(APA, APY, AMA, CAU, CEN, CON, COA, MIE, SPE)
Lessingianthus pusillus	ARG(CHA, COS, FOR, SFE, SDE) / PRY(APY, AMA, CAU, CEN, COA, MIE, PAI, PHA)
Lessingianthus rubricaulis	ARG(BAI, CHA, COR, COS, ERI, FOR, JUJ, MIS, SAL, SFE, TUC) / BRA(PAR, RGS, SCA) / PRY(APA, APY, AMA, BOQ, CAN, CEN, CON, COA, GUA, MIE, ÑEE, PAI, PHA, SPE) / URY(PAY, RIV)
Lessingianthus saltensis	ARG(CAT, COR, JUJ, LRI, SAL, SDE, TUC) / PRY(APY)
Lessingianthus sellowii	ARG(CHA, COS, ERI, FOR, MIS, SFE) / BRA(PAR, RGS, SCA) / PRY(APA, AMA, COA, MIE) / URY(ART, MON, PAY, RIV, TAC)
Lessingianthus spicatus	ARG(MIS)
Lessingianthus teyucuarensis	ARG(MIS)
Leucaena leucocephala ssp. glabrata	ARG(JUJ)
Leucanthemum vulgare	ARG(BAI, CAT, CHU, COR, ERI, NEU, RNE, SCR, SFE, TDF) / BRA(RGS) / CHL(COQ, MAU, BIO, ARA, LLA, MAG, RME) / URY(CAS, COL, MON, SJO, SOR)
Leucheria achillaeifolia	ARG(CHU, LPA, MEN, NEU, RNE, SCR, SJU) / CHL(MAU, BIO, ARA, AIS, MAG)
Leucheria amoena	ARG(MEN, NEU) / CHL(MAU)
Leucheria apiifolia	CHL(MAU)
Leucheria bridgesii	CHL(COQ, VAL, LBO, RME)
Leucheria candidissima	ARG(CHU, MEN, NEU, RNE, SCR) / CHL(MAU, RME)
Leucheria cerberoana	CHL(ANT, ATA, COQ, VAL, RME)
Leucheria coerulescens	ARG(CHU, NEU, RNE) / CHL(BIO, ARA, LLA)
Leucheria congesta	ARG(MEN, SJU) / CHL(COQ, VAL, RME)
Leucheria cumingii	CHL(ANT, ATA, COQ)
Leucheria daucifolia	CHL(TAR)
Leucheria diemii var. purpurea	ARG(SCR)
Leucheria diemii var. diemii	ARG(NEU, SCR)
Leucheria eriocephala	ARG(SCR)
Leucheria floribunda	ARG(MEN) / CHL(VAL, LBO, MAU, RME)
Leucheria garciana	CHL(LBO, MAU)
Leucheria gayana	ARG(MEN) / CHL(VAL, LBO, MAU, RME)
Leucheria gilliesii	ARG(MEN, NEU) / CHL(MAU, ARA)
Leucheria glabriuscula	CHL(RME)
Leucheria glacialis	ARG(CHU, MEN, NEU, RNE) / CHL(MAU, BIO, ARA, LLA, AIS)
Leucheria glandulosa	CHL(COQ, VAL, LBO, BIO, RME)
Leucheria graui	CHL(MAU)
Leucheria hahnii	ARG(CHU, SCR, TDF) / CHL(AIS, MAG)
Leucheria hieracioides	CHL(VAL, LBO, MAU, RME)
Leucheria leontopodioides	ARG(MEN, SCR, TDF) / CHL(MAG)
Leucheria lithospermifolia ssp. lithospermifolia	ARG(MEN, NEU) / CHL(MAU, BIO, ARA)
Leucheria lithospermifolia ssp. integrifolia	CHL(MAU, BIO)
Leucheria magna	ARG(CHU, RNE) / CHL(ARA, AIS)
Leucheria menana	CHL(ATA, COQ)
Leucheria millefolium	ARG(CHU, NEU, RNE, SCR) / CHL(MAU, BIO, ARA, AIS, MAG)
Leucheria multiflora	CHL(COQ, VAL, LBO, RME)
Leucheria nutans	ARG(CHU, NEU, RNE) / CHL(BIO, ARA)
Leucheria oligocephala	CHL(VAL, LBO, RME)
Leucheria paniculata	ARG(RNE) / CHL(BIO, ARA)
Leucheria papillosa	ARG(CHU, NEU, RNE, SCR) / CHL(BIO, ARA, LLA, AIS)
Leucheria polyclados	CHL(ATA)
Leucheria pteropogon	ARG(CAT, JUJ, SAL, TUC) / CHL(ANT)
Leucheria purpurea	ARG(SCR, TDF) / CHL(MAG)
Leucheria rosea	ARG(MEN) / CHL(VAL, LBO, MAU, RME)
Leucheria runcinata	ARG(MEN, SJU) / CHL(ATA, COQ, VAL, LBO, MAU, RME)
Leucheria salina ssp. zöllneri	ARG(MEN) / CHL(COQ, LBO, RME)
Leucheria salina ssp. salina	ARG(LRI, MEN, NEU, SJU) / CHL(ATA, COQ, VAL, RME)
Leucheria scrobiculata	ARG(MEN, SJU) / CHL(VAL, LBO, RME)
Leucheria senecioides	CHL(COQ, VAL, LBO, MAU, BIO, ARA, RME)
Leucheria suaveolens	ARG(TDF)
Leucheria tenuis	CHL(VAL, LBO, ARA, RME)
Leucheria thermarum	ARG(NEU, RNE) / CHL(BIO, ARA, LLA, AIS)
Leucheria tomentosa	CHL(COQ, VAL, MAU, RME)
Leucheria viscida	ARG(MEN) / CHL(COQ, LBO, MAU, BIO, ARA, RME)
Leucochloron incuriale	BRA(PAR)
Leucocoryne alliacea	CHL(COQ, VAL, LBO, MAU, BIO, ARA, LLA, RME)
Leucocoryne angosturae	CHL(RME)
Leucocoryne appendiculata	CHL(TAR, ANT, ATA)
Leucocoryne arrayanensis	CHL(RME)
Leucocoryne candida	CHL(LBO)
Leucocoryne codehuensis	CHL(LBO)
Leucocoryne conconensis	CHL(VAL)
Leucocoryne conferta	CHL(COQ, VAL)
Leucocoryne connivens	CHL(MAU)
Leucocoryne conostyla	CHL(COQ)
Leucocoryne coquimbensis var. coquimbensis	CHL(COQ, VAL)
Leucocoryne coquimbensis var. alba	CHL(COQ)
Leucocoryne coronata	CHL(ANT, ATA)
Leucocoryne curacavina	CHL(RME)
Leucocoryne dimorphopetala	CHL(ATA, COQ)
Leucocoryne editiana	CHL(COQ)
Leucocoryne foetida	CHL(VAL, MAU)
Leucocoryne fragrantissima	CHL(RME)
Leucocoryne fuscostriata	CHL(COQ)
Leucocoryne gilliesioides	CHL(RME)
Leucocoryne inclinata	CHL(COQ)
Leucocoryne ixioides	CHL(COQ, VAL, LBO, MAU, BIO, RME)
Leucocoryne leucogyna	CHL(VAL)
Leucocoryne lilacea	CHL(COQ, VAL)
Leucocoryne lurida	CHL(COQ)
Leucocoryne macropetala	CHL(ATA, COQ)
Leucocoryne maulensis	CHL(MAU)
Leucocoryne modesta	CHL(VAL)
Leucocoryne mollensis	CHL(COQ, VAL)
Leucocoryne montana	CHL(VAL)
Leucocoryne pachystyla	CHL(VAL)
Leucocoryne porphyrea	CHL(COQ)
Leucocoryne praealta	CHL(VAL)
Leucocoryne purpurea	CHL(COQ, VAL)
Leucocoryne quilimarina	CHL(COQ)
Leucocoryne rungensis	CHL(RME)
Leucocoryne simulans	CHL(COQ)
Leucocoryne subulata	CHL(RME)
Leucocoryne taguataguensis	CHL(LBO)
Leucocoryne talinensis	CHL(COQ)
Leucocoryne tricornis	CHL(RME)
Leucocoryne ungulifera	CHL(LBO)
Leucocoryne valparadisea	CHL(VAL)
Leucocoryne violacescens	CHL(COQ, VAL, RME)
Leucocoryne vittata	CHL(COQ, VAL)
Leucotrichum organense	BRA(PAR, RGS, SCA)
Leucotrichum schenckii	BRA(PAR, RGS, SCA)
Leunisia laeta	CHL(COQ, VAL)
Levisticum officinale	CHL(LLA, MAG)
Leymus arenarius	ARG(SCR, TDF) / CHL(MAG)
Liabum acuminatum	ARG(SAL)
Libertia chilensis	ARG(NEU, RNE) / CHL(MAU, BIO, ARA, LLA, AIS, MAG, JFE)
Libertia falcata	CHL(LLA)
Libertia insignis	CHL(LLA, AIS)
Libertia sessiliflora	CHL(VAL, MAU, BIO, ARA, LLA)
Libertia tricocca	CHL(LBO, MAU, BIO, ARA)
Libertia umbellata	CHL(ARA, LLA)
Licania humilis	BRA(Fuera del área del proyecto) / PRY(Desconocida)
Licaria armeniaca	BRA(PAR, RGS, SCA)
Ligaria cuneifolia	ARG(BAI, CAT, COR, COS, ERI, FOR, JUJ, LPA, LRI, MEN, SAL, SJU, SLU, SFE, SDE, TUC) / BRA(RGS) / CHL(COQ, VAL, BIO, RME) / URY(CAS, COL, MAL, RNO, SAO, TAC, TYT)
Ligeophila juruensis	ARG(MIS) / BRA(PAR)
Ligeophila rosea	ARG(MIS) / BRA(PAR) / PRY(APA)
Ligustrum lucidum	ARG(BAI, COR, ERI, LPA, SAL, SFE, TUC) / URY(PAY, RNO, SJO)
Ligustrum sinense	ARG(BAI, COS, ERI, SAL, SFE, TUC) / URY(COL, PAY, RNO, RIV, SJO, SOR)
Lilaeopsis attenuata ssp. attenuata	ARG(BAI, CHA, COS, ERI, LPA) / URY(CLA, COL, FLA, MON, SOR)
Lilaeopsis brasiliensis	ARG(BAI, COS, ERI, MIS) / BRA(PAR, RGS, SCA) / PRY(APA, CEN, COA, GUA) / URY(MON, RIV, SJO, TAC)
Lilaeopsis carolinensis	ARG(BAI, CHA, COS, ERI, JUJ, MEN, MIS, SFE) / BRA(RGS) / PRY(CEN, COA, PAI) / URY(COL, MON, SJO)
Lilaeopsis macloviana	ARG(CAT, CHU, JUJ, LRI, MEN, RNE, SAL, SCR, SJU, TDF, TUC) / CHL(TAR, ANT, ATA, COQ, VAL, BIO, ARA, LLA, AIS, MAG, RME)
Lilaeopsis tenuis	BRA(PAR, SCA)
Limnobium laevigatum	ARG(BAI, CHA, COS, ERI, FOR, SAL, SFE, TUC) / BRA(Fuera del área del proyecto) / CHL(VAL, BIO, RME) / PRY(ÑEE, PHA) / URY(ROC)
Limnocharis flava	ARG(CHA, COS, SAL) / BRA(Fuera del área del proyecto) / PRY(APY, AMA, BOQ, CEN, PHA)
Limnocharis laforestii	ARG(CHA, COS) / BRA(Fuera del área del proyecto) / PRY(APY, AMA, PHA)
Limonium brasiliense	ARG(BAI, CHU, ERI, LPA, MEN, NEU, RNE, SCR, SFE) / BRA(PAR, RGS, SCA) / URY(ROC)
Limonium guaicuru	CHL(ATA, COQ, VAL)
Limosella australis	ARG(BAI, CAT, CHU, COR, JUJ, MEN, NEU, RNE, SAL, SCR, SFE, TDF) / CHL(ANT, COQ, VAL, LBO, MAU, BIO, ARA, LLA, AIS, MAG, RME)
Linaria canadensis	ARG(BAI, CHA, COR, COS, DFE, ERI, FOR, LPA, MEN, MIS, RNE, SFE, SLU) / BRA(PAR, RGS, SCA) / CHL(ARA) / URY(CAS, COL, DUR, FLA, LAV, MAL, MON, RIV, SJO, SOR)
Linaria genistifolia ssp. dalmatica	ARG(NEU, RNE)
Linaria purpurea	ARG(NEU, RNE)
Linaria vulgaris	ARG(MIS, NEU)
Lindernia dubia var. inundata	ARG(COS, ERI)
Lindernia dubia var. dubia	ARG(BAI, COS, ERI, SFE) / BRA(RGS) / CHL(MAU, BIO, ARA, LLA, RME) / PRY(ITA) / URY(ART, DUR, ROC, SOR, TYT)
Lindernia rotundifolia	BRA(PAR, SCA)
Lindsaea arcuata	BRA(PAR, SCA)
Lindsaea bifida	BRA(PAR, SCA)
Lindsaea botrychioides	BRA(PAR, RGS, SCA)
Lindsaea guianensis ssp. lancecastrum	BRA(PAR) / PRY(AMA, CAN)
Lindsaea lancea var. lancea	ARG(MIS) / BRA(PAR, RGS, SCA) / PRY(CAA, CAN, COA, SPE)
Lindsaea ovoidea	BRA(PAR, SCA)
Lindsaea portoricensis	PRY(CAN)
Lindsaea quadrangularis ssp. quadrangularis	BRA(PAR)
Lindsaea quadrangularis ssp. terminalis	ARG(MIS) / BRA(PAR, RGS, SCA) / PRY(COA)
Lindsaea stricta	BRA(PAR, SCA) / PRY(SPE)
Lindsaea virescens var. virescens	BRA(PAR, SCA)
Lindsaea virescens var. catharinae	BRA(PAR, SCA)
Linum bienne	ARG(BAI) / CHL(ANT, ATA, COQ, VAL, LBO, MAU, BIO, ARA, LLA, RME)
Linum brevifolium	BRA(PAR, SCA) / URY(RIV)
Linum burkartii	ARG(BAI, ERI) / BRA(RGS) / URY(FLA)
Linum carneum	ARG(ERI, FOR) / BRA(RGS) / URY(COL, FLA)
Linum catharticum	ARG(TDF) / CHL(MAG)
Linum chamissonis	CHL(BIO, ARA)
Linum cremnophilum	CHL(ANT, ATA)
Linum erigeroides	ARG(ERI) / BRA(RGS) / URY(Desconocida)
Linum junceum	ARG(BAI, COS)
Linum littorale var. littorale	ARG(BAI, COS, ERI, SFE) / BRA(PAR, RGS, SCA) / URY(FLA, RIV)
Linum littorale var. oblongifolium	BRA(SCA)
Linum macraei var. macraei	CHL(COQ, VAL, LBO, MAU, BIO, RME)
Linum macraei var. marticorenae	CHL(VAL, LBO, MAU, BIO)
Linum prostratum	CHL(ANT)
Linum ramosissimum	CHL(COQ)
Linum scoparium	ARG(COR, TUC) / URY(LAV, TYT)
Linum smithii	BRA(RGS, SCA)
Linum usitatissimum	ARG(BAI, COR, COS, ERI, JUJ, MEN, NEU, RNE, SAL, SFE) / CHL(ATA, VAL, BIO, ARA) / URY(MON)
Liparis nervosa	ARG(COS, JUJ, MIS, SAL) / BRA(PAR, RGS, SCA) / PRY(CAN, COA)
Liparis vexillifera	ARG(COR, JUJ, SAL, TUC) / BRA(PAR, RGS)
Lippia aberrans	PRY(CAU, CAN)
Lippia alba var. lanceolata	ARG(COS, ERI, FOR, SAL) / PRY(APY, PHA)
Lippia alba var. alba	ARG(BAI, CHA, COR, COS, ERI, FOR, JUJ, MIS, SAL, SFE, SDE) / BRA(PAR, RGS) / PRY(APY, APA, AMA, CAU, CAA, CAN, CEN, CON, GUA, ITA, ÑEE, PHA) / URY(MAL, RNO, SAO, SJO)
Lippia angustifolia	ARG(COS, MIS) / BRA(PAR) / PRY(CAU, CAN, CEN, CON, COA, MIE, ÑEE, SPE)
Lippia arechavaletae	ARG(COS, ERI) / BRA(PAR, RGS, SCA) / URY(CLA, PAY, RNO, SAO, SOR)
Lippia aristata	ARG(CHA, FOR, JUJ, SAL, SDE, TUC) / BRA(Fuera del área del proyecto) / PRY(APA, APY, AMA, BOQ, PHA, SPE)
Lippia asperrima	ARG(CHA, COS, ERI, FOR, MIS, SAL, SFE, TUC) / BRA(RGS) / PRY(APY, APA, CAU, CAA, CEN, COA, GUA, ITA, MIE, ÑEE, PAI, PHA) / URY(CLA, FLA)
Lippia balansae	BRA(Fuera del área del proyecto) / PRY(APA, CAU, CAA, CAN, CEN, COA, GUA, PAI, SPE)
Lippia brasiliensis	ARG(FOR, MIS) / BRA(RGS) / PRY(APY, APA, AMA, CAA, CAN, CEN, GUA, SPE)
Lippia campestris	BRA(PAR)
Lippia coarctata	ARG(COS, ERI) / BRA(RGS) / URY(ART, FLA, PAY, TAC)
Lippia coriacea	PRY(CEN)
Lippia ekmanii	ARG(COS, MIS) / BRA(RGS)
Lippia felippei	BRA(Fuera del área del proyecto) / PRY(CAN, SPE)
Lippia fragrans	CHL(ANT, ATA, COQ)
Lippia grandiflora	ARG(COS, ERI, MIS) / BRA(PAR) / PRY(APA, CAU, COA, MIE)
Lippia grata	ARG(CAT, LRI, SAL, SDE) / BRA(Fuera del área del proyecto) / PRY(APY, BOQ)
Lippia grisebachiana	ARG(CAT, JUJ, LRI, SAL, TUC)
Lippia hassleriana	PRY(APA, AMA, CAU, CAA, CAN, SPE)
Lippia hieracifolia	ARG(COS, MIS) / BRA(PAR, RGS) / PRY(APA, CAU, CAA, COA, MIE, SPE) / URY(RIV)
Lippia hirta	BRA(PAR, SCA)
Lippia integrifolia	ARG(CAT, COR, JUJ, LRI, SAL, SJU, SLU, TUC)
Lippia junelliana	ARG(CAT, CHA, COR, JUJ, LRI, SAL, SJU, SLU, SDE, TUC)
Lippia lamiana	PRY(AMA)
Lippia lasiocalycina	BRA(PAR) / PRY(AMA, CON)
Lippia lasiocalyx	ARG(JUJ, SAL)
Lippia lippioides	ARG(COS, JUJ, MIS, SAL, TUC) / BRA(PAR, SCA) / PRY(APA, APY, CAA, CEN, COA, GUA, MIE, ÑEE, PAI, PHA, SPE)
Lippia longepedunculata	BRA(Fuera del área del proyecto) / PRY(AMA, CAU, CEN, CON, PAI, PHA)
Lippia lupulina	ARG(MIS) / BRA(PAR) / PRY(APY, APA, AMA, CAU, CAN, CON, COA, SPE)
Lippia origanoides	ARG(MIS, SAL) / BRA(PAR) / PRY(APY, AMA, CON, COA, PAI)
Lippia paranensis	BRA(PAR)
Lippia pumila	BRA(PAR, SCA)
Lippia recolletae	ARG(COS, MIS) / BRA(PAR) / PRY(AMA, CAU, CAA, CAN, CEN, CON, COA, GUA, ITA, MIE, PAI, SPE)
Lippia renifolia	BRA(Fuera del área del proyecto)
Lippia salsa	ARG(CAT, COR, LPA, LRI, MEN, SAL, SDE, SFE, SJU, SLU, TUC)
Lippia sandwithiana	PRY(AMA)
Lippia sclerophylla	ARG(MIS) / PRY(APA, AMA, CAU, CAA, CAN, CEN, CON, COA, GUA, ITA)
Lippia suffruticosa	ARG(JUJ, SAL, TUC)
Lippia tegulifera	ARG(COS, MIS) / BRA(PAR) / PRY(AMA, CAU, CAA, CAN, CON, COA, GUA, PAI)
Lippia tristis	PRY(AMA, CAN, PAI, SPE)
Lippia turbinata f. magnifolia	ARG(CAT, CHA, JUJ, LRI, SAL, SJU, TUC)
Lippia turbinata f. turbinata	ARG(BAI, CAT, CHA, COR, FOR, JUJ, LPA, LRI, MEN, SAL, SJU, SLU, SFE, SDE, TUC) / CHL(ATA) / PRY(APY, PHA)
Lippia turnerifolia var. polytricha	ARG(COS, MIS) / BRA(PAR, SCA) / PRY(AMA, CAU, CAN, GUA, ITA, MIE, PAI) / URY(RIV)
Lippia turnerifolia var. turnerifolia	ARG(CHA, COS, ERI, FOR, JUJ, MIS, SAL, SFE, TUC) / BRA(RGS) / PRY(APA, APY, AMA, CAU, CAN, CEN, CON, COA, GUA, PAI, PHA, SPE)
Lippia villafloridana	ARG(CHA, COS, ERI, FOR, SFE) / PRY(CAU, MIE, PAI) / URY(CLA, PAY, SAO)
Lithachne pauciflora	ARG(CHA, COS, FOR, MIS, SAL, SFE) / BRA(PAR, RGS) / PRY(GUA)
Lithodraba mendocinensis	ARG(MEN, NEU)
Lithospermum officinale	ARG(NEU)
Lithraea brasiliensis	ARG(ERI, MIS) / BRA(PAR, RGS, SCA) / URY(CLA, FLA, LAV, MAL, MON, ROC, TAC, TYT)
Lithraea caustica	CHL(COQ, VAL, LBO, MAU, BIO, ARA, RME)
Lithraea molleoides	ARG(CAT, CHA, COR, COS, ERI, FOR, JUJ, LRI, MIS, SAL, SFE, SJU, SLU, TUC) / BRA(PAR, RGS) / PRY(AMA, CAU, CAA, CAN, CEN, COA, GUA, ITA, MIE, ÑEE, PAI, SPE) / URY(ART, CLA, DUR, FLA, LAV, MON, PAY, RIV, SAO, SOR, TAC)
Littorella australis	ARG(NEU, TDF) / CHL(ARA, LLA, MAG)
Llagunoa glandulosa	CHL(ANT, ATA, COQ)
Loasa acanthifolia	ARG(NEU) / CHL(MAU, BIO, ARA, LLA)
Loasa acerifolia	ARG(CHU, NEU, RNE) / CHL(COQ, MAU, BIO, ARA, LLA)
Loasa argentina	ARG(CHU, MEN, NEU, RNE, SCR) / CHL(AIS, MAG)
Loasa arnottiana	CHL(COQ)
Loasa bergii	ARG(BAI, CHU, MEN, NEU, RNE, SCR) / CHL(AIS, MAG)
Loasa caespitosa	CHL(ATA, COQ, VAL, RME)
Loasa elongata	CHL(ANT, ATA, COQ)
Loasa floribunda	CHL(COQ, VAL, RME)
Loasa gayana	CHL(ARA, LLA)
Loasa heterophylla	ARG(MEN) / CHL(COQ, VAL, MAU, RME)
Loasa humilis	CHL(MAU)
Loasa illapelina	CHL(COQ)
Loasa incurva	ARG(MEN, NEU)
Loasa insons	ARG(MEN) / CHL(COQ, VAL, LBO, MAU, RME)
Loasa lateritia	ARG(MEN, NEU) / CHL(COQ, MAU, BIO, ARA)
Loasa longiseta	CHL(TAR, ANT, ATA, COQ)
Loasa malesherbioides	ARG(SJU) / CHL(ANT, ATA)
Loasa martinii	CHL(ARA, LLA)
Loasa micrantha	CHL(LBO, MAU, BIO, ARA, RME)
Loasa mollensis	CHL(VAL)
Loasa multifida	CHL(ATA, COQ)
Loasa nana	ARG(NEU, RNE) / CHL(ARA, LLA)
Loasa nitida	CHL(TAR, ANT)
Loasa pallida	CHL(ATA, COQ, VAL, RME)
Loasa paradoxa	CHL(VAL, RME)
Loasa pinnatifida	ARG(NEU) / CHL(LBO, MAU, BIO, ARA, LLA, RME)
Loasa placei	CHL(ATA, COQ, VAL, LBO, RME)
Loasa prostrata	CHL(COQ, VAL, LBO, RME)
Loasa sagittata	CHL(LLA)
Loasa sclareifolia	ARG(NEU) / CHL(ATA, COQ, VAL, LBO, MAU, BIO, ARA, RME)
Loasa sigmoidea	ARG(MEN) / CHL(ATA, COQ, MAU, RME)
Loasa tricolor	ARG(MEN, NEU, SJU) / CHL(ATA, COQ, VAL, RME)
Loasa triloba	CHL(ATA, COQ, VAL, LBO, MAU, BIO, ARA)
Loasa volubilis	CHL(VAL, MAU, BIO, ARA, RME)
Lobelia anceps	BRA(RGS, SCA) / CHL(ANT, VAL, LBO, MAU, BIO, ARA, LLA, RME, JFE)
Lobelia aquatica	ARG(COS) / BRA(PAR) / PRY(CON)
Lobelia bridgesii	CHL(ARA, LLA)
Lobelia camporum	ARG(MIS) / BRA(PAR, RGS, SCA)
Lobelia exaltata	BRA(PAR, SCA)
Lobelia excelsa	CHL(COQ, VAL, LBO, MAU, RME)
Lobelia fastigiata	BRA(Fuera del área del proyecto) / PRY(CEN)
Lobelia hassleri	ARG(COS, MIS) / BRA(PAR, RGS, SCA) / PRY(APA, CAU, CAA)
Lobelia hederacea var. elliptica	ARG(BAI, COS, ERI, MIS, RNE) / BRA(RGS, SCA) / URY(LAV)
Lobelia hederacea var. hederacea	ARG(BAI, CHA, COS, ERI, FOR, MIS, SFE) / BRA(PAR, RGS, SCA) / PRY(APA, CAN, COA)
Lobelia langeana	BRA(PAR, SCA)
Lobelia nana var. flagelliformis	ARG(CAT, COR, JUJ, SAL, TUC)
Lobelia nana var. nana	ARG(COR, SAL)
Lobelia nummularioides var. prostrata	ARG(COS, MIS) / PRY(CAN, GUA)
Lobelia nummularioides var. nummularioides	BRA(PAR, SCA) / PRY(COA, GUA)
Lobelia oligophylla	ARG(CHU, JUJ, LRI, MEN, NEU, RNE, SAL, SJU, SCR, TDF) / CHL(TAR, ANT, ATA, COQ, VAL, LBO, MAU, BIO, ARA, LLA, AIS, MAG, RME)
Lobelia polyphylla	CHL(ATA, COQ, VAL, RME)
Lobelia reniformis	ARG(MIS) / BRA(SCA) / PRY(Desconocida)
Lobelia tupa	CHL(VAL, LBO, MAU, BIO, ARA, LLA, JFE)
Lobelia xalapensis	ARG(CHA, COS, FOR, JUJ, MIS, SAL, SDE, TUC) / BRA(SCA) / PRY(APY, AMA, CAA, CAN, CEN, CON, COA, GUA, PAI, SPE)
Lobivia bruchii	ARG(TUC)
Lobivia chrysantha var. chrysantha	ARG(SAL)
Lobivia chrysantha var. hypocyrta	ARG(SAL)
Lobivia chrysochete var. minutiflora	ARG(SAL)
Lobivia chrysochete var. chrysochete	ARG(JUJ, SAL)
Lobivia crassicaulis	ARG(CAT)
Lobivia densispina	ARG(JUJ)
Lobivia einsteinii	ARG(JUJ, SAL)
Lobivia euanthema	ARG(JUJ)
Lobivia famatimensis var. famatimensis	ARG(LRI, SJU)
Lobivia famatimensis var. sanjuanensis	ARG(SJU)
Lobivia formosa var. formosa	ARG(CAT, LRI, MEN, SJU) / CHL(ANT)
Lobivia formosa var. rosarioana	ARG(LRI)
Lobivia gonjianii	ARG(JUJ)
Lobivia haematantha var. haematantha	ARG(CAT, SAL, TUC)
Lobivia haematantha var. kuehnrichii	ARG(SAL)
Lobivia haematantha var. fechseri	ARG(SAL)
Lobivia haematantha var. amblayensis	ARG(SAL)
Lobivia jajoiana var. paucicostata	ARG(JUJ)
Lobivia jajoiana var. jajoiana	ARG(JUJ)
Lobivia kieslingii	ARG(TUC)
Lobivia korethroides	ARG(JUJ, SAL)
Lobivia longispina	ARG(JUJ, SAL) / CHL(TAR)
Lobivia marsoneri var. iridescens	ARG(JUJ)
Lobivia marsoneri var. marsoneri	ARG(JUJ)
Lobivia nigricans	ARG(SAL)
Lobivia pugionacantha	ARG(JUJ)
Lobivia pygmaea	ARG(JUJ)
Lobivia saltensis	ARG(SAL)
Lobivia sanguiniflora	ARG(SAL)
Lobivia schreiteri var. riolarensis	ARG(CAT)
Lobivia schreiteri var. schreiteri	ARG(TUC)
Lobivia silvestrii	ARG(SAL, TUC)
Lobivia walteri	ARG(SAL)
Lobularia maritima	ARG(BAI, CAT, COR, ERI, JUJ, LPA, MEN, NEU, SAL, SJU, SLU) / CHL(TAR, ANT, COQ, VAL, MAU, BIO, ARA, LLA, RME) / URY(MON)
Lockhartia ludibunda	BRA(PAR, SCA)
Lockhartia lunifera	BRA(PAR, SCA)
Loefgrenianthus blanche-amesii	BRA(PAR)
Logfia gallica	CHL(COQ, VAL, LBO, MAU, BIO, ARA, RME)
Lolium multiflorum	ARG(BAI, CAT, CHA, CHU, COR, COS, DFE, ERI, JUJ, LPA, MEN, MIS, NEU, RNE, SAL, SJU, SLU, SCR, SFE, TDF, TUC) / BRA(PAR, RGS) / CHL(TAR, ANT, ATA, COQ, VAL, LBO, MAU, BIO, ARA, LLA, MAG, RME, JFE) / PRY(CEN) / URY(MAL)
Lolium perenne	ARG(BAI, CHA, CHU, COR, ERI, JUJ, LPA, MEN, NEU, RNE, SJU, SLU, SCR, SFE, SDE, TDF) / BRA(PAR, RGS, SCA) / CHL(COQ, VAL, LBO, MAU, BIO, ARA, LLA, MAG, RME, JFE, IPA) / URY(MON)
Lolium remotum	ARG(BAI)
Lolium rigidum ssp. rigidum	ARG(BAI, COR, COS, ERI, LPA, MEN, MIS, RNE, SFE) / CHL(COQ, VAL, LBO, BIO, ARA, LLA, MAG, RME)
Lolium rigidum ssp. lepturoides	ARG(BAI, RNE)
Lolium temulentum	ARG(BAI, CHU, COR, COS, DFE, ERI, LPA, MEN, RNE, SAL, SJU, SLU, SFE, TDF) / BRA(RGS) / CHL(COQ, VAL, BIO, ARA, LLA, RME) / URY(MON)
Lomagramma guianensis	BRA(PAR, RGS, SCA) / PRY(CAN)
Lomanthus bangii	ARG(JUJ, SAL)
Lomariopsis marginata	BRA(PAR, RGS, SCA)
Lomatia dentata	ARG(CHU, NEU, RNE) / CHL(VAL, MAU, BIO, ARA, LLA)
Lomatia ferruginea	ARG(CHU, NEU, RNE, SCR) / CHL(MAU, BIO, ARA, LLA, AIS, MAG)
Lomatia hirsuta ssp. obliqua	ARG(CHU, NEU, RNE) / CHL(VAL, MAU, BIO, ARA)
Lonchocarpus campestris	ARG(COS, MIS) / BRA(PAR, RGS, SCA) / PRY(APA, GUA)
Lonchocarpus cultratus	BRA(PAR, RGS, SCA)
Lonchocarpus fluvialis	ARG(CHA, COR, FOR, SFE) / PRY(APY, CEN, CON, PHA)
Lonchocarpus graciliflorus	BRA(PAR)
Lonchocarpus grazielae	BRA(SCA)
Lonchocarpus lilloi	ARG(JUJ, SAL)
Lonchocarpus muehlbergianus	ARG(COS, MIS) / BRA(PAR, RGS, SCA) / PRY(APA, CAU, SPE)
Lonchocarpus nitidus	ARG(BAI, COS, ERI, MIS) / BRA(PAR, RGS, SCA) / PRY(APA, CON, COA, GUA, ITA, PAI) / URY(ART, COL, MON, PAY, RNO, ROC, SAO, SOR)
Lonchocarpus nudiflorens	BRA(Fuera del área del proyecto) / PRY(APY, CON)
Lonchocarpus subglaucescens	BRA(PAR)
Lonchocarpus torrensis	BRA(RGS)
Lonicera japonica var. repens	ARG(BAI)
Lonicera japonica var. japonica	ARG(BAI, COS, ERI, JUJ, NEU, RNE, SAL) / BRA(RGS, SCA) / URY(CAS, FLA, MAL, MON, PAY, RIV, SJO, SOR, TAC)
Lophocarpinia aculeatifolia	ARG(CHA, FOR, SAL) / PRY(APY)
Lophopappus cuneatus	ARG(JUJ) / CHL(TAR)
Lophopappus foliosus	ARG(JUJ) / CHL(TAR)
Lophopappus tarapacanus	CHL(TAR)
Lophophytum leandri	ARG(COS, MIS) / BRA(PAR, SCA) / PRY(APY)
Lophophytum mirabile ssp. bolivianum	ARG(JUJ, SAL) / BRA(Fuera del área del proyecto) / PRY(AMA, PAI, SPE)
Lophosoria quadripinnata	ARG(CHU, NEU, RNE) / BRA(PAR, RGS, SCA) / CHL(MAU, BIO, ARA, LLA, AIS, MAG, JFE)
Lophozonia obliqua ssp. valdiviana	CHL(BIO, ARA, LLA)
Lophozonia obliqua ssp. andina	CHL(MAU, BIO, ARA, LLA)
Lorentzianthus viscidus	ARG(CAT, COR, JUJ, LRI, SAL, SLU, TUC)
Lotus angustissimus	BRA(RGS) / URY(DUR, TYT)
Lotus corniculatus	ARG(BAI, CHU, COS, ERI, LPA) / BRA(PAR, RGS, SCA) / CHL(MAU, BIO, ARA, LLA, RME) / URY(MON, TAC)
Lotus ornithopodioides	URY(MON, SOR)
Lotus pedunculatus	ARG(CHU, ERI, NEU, RNE, TDF) / CHL(MAU, BIO, ARA, LLA, AIS) / URY(MON, TAC)
Lotus suaveolens	ARG(BAI, ERI, NEU) / BRA(RGS) / URY(CLA, DUR, FLA, MAL, MON, TAC, TYT)
Lotus subpinnatus	CHL(ANT, ATA, COQ, VAL, LBO, MAU, BIO, ARA, LLA, RME)
Lotus tenuis	ARG(BAI, LPA) / CHL(VAL, BIO, ARA, LLA, RME) / URY(MON, ROC, SJO)
Loudetia flammida	BRA(Fuera del área del proyecto) / PRY(AMA, CAU, CAN, CON, SPE)
Loudetiopsis chrysothryx	PRY(AMA)
Louisiella elephantipes	ARG(BAI, CHA, COS, DFE, ERI, FOR, SFE, SDE) / BRA(PAR, RGS, SCA) / PRY(CEN, CON, COA, PHA)
Loxopterygium grisebachii	ARG(JUJ, SAL, TUC)
Lucilia acutifolia	ARG(BAI, CAT, COR, COS, ERI, JUJ, LRI, MIS, SAL, SLU, TUC) / BRA(PAR, RGS, SCA) / PRY(AMA, CAU, PAI) / URY(CAS, CLA, COL, LAV, MAL, MON, PAY, RNO, RIV, ROC, TAC, TYT)
Lucilia eriophora	CHL(VAL, LBO, ARA, RME)
Lucilia linearifolia	ARG(JUJ, SAL) / BRA(PAR, RGS, SCA)
Lucilia lycopodioides	ARG(JUJ, SAL) / BRA(PAR, RGS, SCA)
Lucilia nitens	ARG(COS, MIS) / BRA(PAR, RGS, SCA) / URY(CAS, CLA, COL, DUR, MAL, MON, PAY, RNO, RIV, ROC, SJO, TAC)
Lucilia recurva	ARG(SAL)
Lucilia tomentosa	BRA(PAR)
Ludwigia bonariensis	ARG(BAI, COS, DFE, ERI, FOR, SAL, SFE, TUC) / PRY(APY, COA, GUA, PHA) / URY(ART, RNO, SAO, SJO, SOR)
Ludwigia bullata	BRA(Fuera del área del proyecto) / PRY(AMA)
Ludwigia caparosa	ARG(BAI, CHA, COS, ERI, MIS, SAL, SFE, TUC) / BRA(PAR, RGS, SCA) / PRY(GUA) / URY(ROC)
Ludwigia decurrens	ARG(CHA, COS, ERI, FOR, JUJ, MIS) / BRA(PAR, RGS, SCA) / PRY(APA, APY, BOQ, CAU, CAA, CEN, COA, GUA, MIE, PAI, PHA, SPE) / URY(ART, SAO)
Ludwigia elegans	ARG(BAI, CHA, COS, ERI, MIS, SFE) / BRA(PAR, RGS, SCA) / PRY(APA, CAU, CAA, CAN, ITA, SPE) / URY(COL, SJO)
Ludwigia erecta	BRA(Fuera del área del proyecto) / PRY(GUA)
Ludwigia filiformis	BRA(PAR)
Ludwigia grandiflora ssp. grandiflora	ARG(BAI, CAT, CHA, COR, COS, ERI, LPA, MEN, SAL, SFE) / BRA(RGS, SCA) / PRY(CEN, COA, GUA, PAI, PHA, SPE) / URY(CAS, CLA, FLO, FLA, MAL, MON, RNO, ROC, SAO, SOR, TAC)
Ludwigia grandiflora ssp. hexapetala	ARG(BAI, ERI, NEU, RNE, SFE, SLU) / BRA(RGS) / CHL(LBO, MAU, BIO, ARA, RME) / PRY(CEN, PHA)
Ludwigia hassleriana	ARG(COS, MIS) / BRA(PAR, RGS, SCA) / PRY(AMA, CAU, CAA, CAN, CEN, COA, GUA, ITA, PAI, PHA, SPE)
Ludwigia helminthorrhiza	BRA(Fuera del área del proyecto) / PRY(APY, CEN, CHO, CON, PHA)
Ludwigia hookeri	ARG(CHA, ERI, MIS) / BRA(PAR, RGS, SCA) / URY(CAS, CLA, MON)
Ludwigia irwinii	ARG(COS, MIS) / BRA(Fuera del área del proyecto) / PRY(CAA, ÑEE, PAI)
Ludwigia lagunae	ARG(BAI, CHA, COS, FOR, SAL, SFE, TUC) / BRA(Fuera del área del proyecto) / PRY(APY, CEN, COA, GUA, ÑEE, PHA, SPE)
Ludwigia laruotteana	BRA(PAR)
Ludwigia leptocarpa	ARG(CHA, COS, ERI, FOR, MIS) / BRA(RGS, SCA) / PRY(CAA, CEN, COA, GUA, PHA) / URY(CLA, ROC)
Ludwigia longifolia	ARG(BAI, CHA, COS, ERI, MIS, SFE, TUC) / BRA(PAR, RGS, SCA) / PRY(COA, ITA) / URY(CAS, LAV, MAL, MON, RIV, ROC, SJO, SOR)
Ludwigia major	ARG(CHA, COS, ERI, FOR, MIS) / BRA(PAR, RGS, SCA) / PRY(AMA, CAU, CAA, CAN, CEN, COA, MIE, ÑEE, PAI, PHA) / URY(CLA, FLO, PAY, RNO)
Ludwigia martii	ARG(COS, ERI, MIS) / BRA(PAR) / PRY(AMA, CAU, COA, ÑEE)
Ludwigia multinervia	BRA(RGS, SCA) / URY(ROC)
Ludwigia neograndiflora	ARG(CHA, COS, ERI, FOR, MIS) / BRA(RGS) / PRY(AMA, CAU, CAA, CEN, COA, GUA, ÑEE, PAI)
Ludwigia nervosa	BRA(PAR) / PRY(AMA, CAU, CAN, CEN, COA)
Ludwigia octovalvis	ARG(CHA, COS, ERI, MIS, SFE) / BRA(PAR, SCA) / CHL(TAR) / PRY(APY, AMA, CEN, COA, ÑEE, PAI, PHA)
Ludwigia peploides ssp. montevidensis	ARG(BAI, ERI, MEN, SJU) / BRA(RGS) / CHL(ATA, COQ, VAL, BIO, ARA, LLA, RME) / URY(CAS, COL, FLA, MON, ROC, SAO, SOR)
Ludwigia peploides ssp. peploides	ARG(BAI, CHA, COS, ERI, FOR, MIS, SAL, SFE, TUC) / BRA(PAR, RGS, SCA) / PRY(APY, CAU, CEN, CON, COA, GUA, ÑEE, PHA) / URY(CAS, COL, PAY, SAO, SOR)
Ludwigia peruviana	ARG(BAI, CAT, CHA, COS, ERI, JUJ, MIS, SAL, SFE, TUC) / BRA(PAR, RGS, SCA) / CHL(LBO, BIO) / PRY(APA, CAU, CAA, CEN, COA) / URY(CAS, COL, PAY)
Ludwigia pseudonarcissus	ARG(COS, ERI, MIS) / BRA(PAR) / PRY(AMA, CAA, CEN, COA, GUA, ÑEE, PAI)
Ludwigia sedoides	BRA(Fuera del área del proyecto) / PRY(APY)
Ludwigia sericea	ARG(CHA, COS, ERI, FOR, MIS) / BRA(PAR, RGS, SCA) / PRY(APA, CAU, CAA, CAN, CEN, COA, GUA, ITA, MIE, PAI) / URY(ART, SAO)
Ludwigia torulosa	BRA(PAR) / PRY(AMA)
Luehea candicans	ARG(FOR, MIS) / BRA(PAR) / PRY(APY, CAA, CAN, CEN, CON, COA, PAI, SPE)
Luehea conwentzii	BRA(PAR)
Luehea divaricata	ARG(BAI, CHA, COS, ERI, FOR, MIS, SFE) / BRA(PAR, RGS, SCA) / PRY(APA, AMA, CAU, CAA, CAN, CEN, CON, GUA, ITA, ÑEE, PAI, SPE) / URY(ART, CLA, MAL, PAY, RNO, RIV, ROC, SAO, SOR, TAC)
Luehea fiebrigii	ARG(SAL)
Luehea grandiflora	BRA(PAR) / PRY(APY, APA, AMA, CAN, CON)
Luehea microcarpa var. polymorpha	PRY(CON)
Luehea microcarpa var. microcarpa	ARG(MIS) / BRA(Fuera del área del proyecto) / PRY(AMA, CON)
Luehea paniculata	ARG(MIS) / BRA(SCA) / PRY(AMA, COA)
Luetzelburgia guaissara	BRA(PAR, SCA)
Luffa aegyptiaca	ARG(CHA, COS, FOR, JUJ, MIS, SAL, TUC) / BRA(PAR, RGS) / PRY(CEN)
Lulia nervosa	BRA(PAR, SCA)
Luma apiculata	ARG(CHU, NEU, RNE) / CHL(COQ, VAL, LBO, MAU, BIO, ARA, LLA, AIS, RME)
Luma chequen	CHL(COQ, VAL, LBO, MAU, BIO, ARA, LLA, RME)
Lunaria annua	ARG(NEU, RNE)
Lundia corymbifera	BRA(PAR, RGS)
Lundia virginalis	BRA(PAR, SCA)
Lupinus albescens	ARG(BAI, COS, ERI, MIS, SFE) / BRA(RGS) / PRY(APA) / URY(ART, COL, RIV, SJO, SOR, TAC)
Lupinus albus	CHL(BIO, ARA)
Lupinus alivillosus	ARG(TUC)
Lupinus andicola	ARG(LRI, MEN, SJU)
Lupinus angustifolius	ARG(ERI) / CHL(BIO) / URY(FLA, MAL)
Lupinus arboreus	ARG(NEU, RNE, TDF) / CHL(COQ, VAL, LBO, MAU, BIO, ARA, LLA)
Lupinus aureonitens	ARG(BAI, LPA)
Lupinus austrorientalis	ARG(CAT, JUJ)
Lupinus bracteolaris var. leptophyllus	BRA(RGS) / URY(MON, PAY, RIV, TAC, TYT)
Lupinus bracteolaris var. tenuifolius	URY(CLA, TAC)
Lupinus bracteolaris var. bracteolaris	ARG(BAI, COS, ERI) / BRA(RGS, SCA) / URY(ART, CAS, CLA, COL, FLA, LAV, MAL, MON, PAY, ROC, SJO, SOR, TAC, TYT)
Lupinus buchtienii	ARG(CAT, JUJ, LRI, SAL, TUC)
Lupinus burkartianus	ARG(CAT, TUC)
Lupinus erectifolius	ARG(JUJ, SAL)
Lupinus gibertianus var. reineckianus	ARG(CHA, COS, ERI, MIS, SFE, TUC) / BRA(RGS) / URY(COL)
Lupinus gibertianus var. gibertianus	ARG(BAI, CHA, COS, ERI, FOR, MIS, SFE, TUC) / BRA(RGS, SCA) / PRY(ITA, ÑEE) / URY(ART, CLA, COL, LAV, MAL, MON, PAY, RNO, RIV, SAO, SJO, TAC)
Lupinus gibertianus var. berroanus	ARG(CHA, COS, ERI, MIS, SFE, TUC) / URY(COL, SAO)
Lupinus grisebachianus	ARG(JUJ, SAL, TUC)
Lupinus guaraniticus	ARG(COS, MIS) / BRA(PAR, RGS, SCA) / PRY(APA)
Lupinus hieronymi	ARG(LRI)
Lupinus honoratus	ARG(CAT, COR, JUJ, TUC)
Lupinus ignobilis	ARG(JUJ, SAL, TUC)
Lupinus intortus	ARG(JUJ)
Lupinus jujuyensis	ARG(JUJ)
Lupinus lanatus	ARG(MIS) / BRA(RGS, SCA) / URY(ART, RIV)
Lupinus linearis	ARG(COS, ERI, MIS) / BRA(RGS, SCA) / PRY(ITA) / URY(ART, CAS, CLA, COL, LAV, MAL, MON, PAY, RNO, ROC, SOR, TYT)
Lupinus luteus	CHL(VAL)
Lupinus magnistipulatus	ARG(MIS) / BRA(PAR, RGS, SCA)
Lupinus microcarpus	ARG(CHU, MEN, RNE, SCR, SJU) / CHL(TAR, ANT, ATA, COQ, VAL, LBO, MAU, BIO, ARA, LLA, RME)
Lupinus multiflorus	ARG(BAI, COS, ERI, SFE) / BRA(PAR, RGS, SCA) / URY(CAS, CLA, COL, FLA, LAV, MAL, MON, PAY, RNO, SJO)
Lupinus opertospicus	ARG(JUJ)
Lupinus oreophilus	CHL(TAR, ANT)
Lupinus paraguariensis	ARG(COS, MIS) / BRA(PAR, RGS, SCA) / PRY(CAU, COA, SPE) / URY(PAY)
Lupinus paranensis	BRA(PAR, RGS, SCA)
Lupinus polyphyllus	ARG(CHU, NEU, RNE, TDF) / CHL(LLA)
Lupinus reitzii	BRA(PAR, RGS, SCA)
Lupinus rubriflorus	BRA(RGS, SCA)
Lupinus sellowianus	ARG(MIS) / BRA(PAR)
Lupinus subacaulis	ARG(JUJ, SAL) / CHL(TAR, ANT)
Lupinus subinflatus	ARG(JUJ, LRI, SAL, TUC) / CHL(TAR, ANT)
Lupinus tafiensis	ARG(TUC)
Lupinus tarapacensis	CHL(TAR)
Lupinus tomentosus	ARG(JUJ)
Lupinus tucumanensis	ARG(LRI, TUC)
Lupinus uleanus	BRA(RGS, SCA)
Lupinus ultramontanus	ARG(CAT, SAL)
Lupinus umidicola	ARG(CAT, COS, JUJ, SAL, TUC)
Lupinus werdermannianus	CHL(TAR)
Luziola bahiensis	ARG(COS, ERI, MIS) / BRA(PAR, RGS, SCA) / PRY(CAN)
Luziola brasiliensis	BRA(PAR, SCA)
Luziola fragilis	BRA(PAR)
Luziola gracillima	ARG(FOR, SAL) / PRY(PHA)
Luziola peruviana	ARG(BAI, CHA, COR, COS, ERI, FOR, JUJ, MIS, SAL, SFE, TUC) / BRA(PAR, RGS, SCA) / PRY(CAA, CAN, CEN, COA, PAI, PHA, SPE) / URY(FLA, PAY, RNO, ROC, SOR, TAC, TYT)
Luziola spruceana	BRA(Fuera del área del proyecto) / PRY(CEN, PHA)
Luziola subintegra	ARG(FOR) / BRA(Fuera del área del proyecto) / PRY(CEN, PHA)
Luzula alopecurus	ARG(SCR, TDF) / CHL(ARA, AIS, MAG)
Luzula antarctica	ARG(SCR, TDF) / CHL(MAG)
Luzula brachyphylla	ARG(CHU, NEU, SCR, TDF) / CHL(MAG)
Luzula campestris	ARG(TDF) / CHL(MAU, BIO, MAG)
Luzula chilensis	ARG(CHU, MEN, NEU, RNE, SCR) / CHL(VAL, BIO, ARA)
Luzula excelsa	ARG(BAI, CAT, CHA, CHU, COR, JUJ, LRI, MEN, NEU, SAL, SLU, TUC) / CHL(MAU, ARA, AIS, MAG)
Luzula leiboldii	ARG(MEN, NEU) / CHL(VAL, MAU, BIO, RME)
Luzula masafuerana	CHL(JFE)
Luzula mendocina	ARG(BAI, COR, MEN, SLU)
Luzula ostenii	URY(FLA, LAV, MAL)
Luzula parvula	ARG(MEN) / CHL(RME)
Luzula peruviana	ARG(JUJ, SAL, TUC)
Luzula pumila	ARG(TDF)
Luzula racemosa	ARG(CAT, CHU, COR, JUJ, LRI, MEN, NEU, RNE, SAL, SJU, SLU, SCR, TDF, TUC) / CHL(COQ, VAL, LBO, MAU, BIO, ARA, LLA, AIS, MAG, RME)
Luzula ruiz-lealii	ARG(CHU, MEN)
Luzula tristachya	CHL(COQ, VAL, BIO, ARA, LLA)
Luzula ulei	BRA(PAR, RGS, SCA)
Luzuriaga marginata	ARG(CHU, RNE, SCR, TDF) / CHL(LLA, AIS, MAG)
Luzuriaga polyphylla	CHL(MAU, BIO, ARA, LLA, AIS, MAG)
Luzuriaga radicans	ARG(CHU, RNE, SCR, TDF) / CHL(MAU, BIO, ARA, LLA, AIS)
Lycapsus tenuifolius	CHL(IDE)
Lychnis coronaria	BRA(SCA) / CHL(ARA)
Lycianthes asarifolia	ARG(CHA, FOR, JUJ, MIS, SAL, SFE, TUC) / BRA(PAR) / PRY(CEN, GUA)
Lycianthes fasciculata	ARG(CHA, JUJ, SAL, TUC)
Lycianthes lycioides	ARG(JUJ, SAL, TUC) / PRY(APA)
Lycianthes pauciflora	ARG(MIS) / BRA(PAR) / PRY(APA, AMA, CAU, CAN, CON, GUA, ITA, PAI, PHA, SPE)
Lycianthes rantonnetii	ARG(COS, MIS) / BRA(PAR, RGS, SCA) / PRY(APA, CAU, CAA, CAN, COA, GUA, ITA, MIE, PAI)
Lycium ameghinoi	ARG(CHU, MEN, NEU, RNE, SCR)
Lycium americanum	ARG(CHA, COR, COS, ERI, FOR, JUJ, LRI, SAL, SDE, SFE, TUC) / PRY(APY, PHA)
Lycium athium	ARG(FOR, SDE)
Lycium barbarum	ARG(SCR)
Lycium boerhaviaefolium	ARG(BAI, CAT, CHA, COR, COS, ERI, FOR, JUJ, LPA, LRI, MEN, NEU, SAL, SJU, SLU, SFE, SDE, TUC) / BRA(RGS) / CHL(ANT) / PRY(APY, CEN, CON, PHA) / URY(PAY, RNO)
Lycium bridgesii	CHL(ATA, COQ)
Lycium cestroides	ARG(BAI, CAT, CHA, COR, COS, JUJ, LRI, SAL, SDE, SFE, SJU, SLU, TUC) / URY(MON, SJO)
Lycium chanar	ARG(CAT, LRI, MEN, SAL, SJU)
Lycium chilense var. comberi	ARG(CHU, NEU, RNE)
Lycium chilense var. confertifolium	ARG(BAI, COR, LPA, LRI, MEN, NEU, RNE, SJU, SLU) / CHL(COQ, VAL, RME)
Lycium chilense var. descolei	ARG(BAI, CHU, MEN, RNE, SCR) / PRY(PHA)
Lycium chilense var. chilense	ARG(BAI, CAT, CHU, COR, LPA, LRI, MEN, NEU, RNE, SJU, SLU, SCR, SDE, TUC) / CHL(COQ, VAL, LBO, MAU, RME)
Lycium chilense var. minutifolium	ARG(BAI, CHU, LPA, MEN, RNE) / CHL(ATA, COQ)
Lycium chilense var. glaberrimum	ARG(MEN) / CHL(ATA, COQ, VAL)
Lycium chilense var. filifolium	ARG(BAI, CHU, COR, LPA, LRI, MEN, NEU, RNE, SDE, SJU, SLU) / CHL(ATA, COQ)
Lycium chilense var. vergarae	ARG(CAT, JUJ, LRI, MEN, SJU) / CHL(TAR, ATA, COQ)
Lycium ciliatum	ARG(BAI, CAT, CHA, COR, COS, ERI, JUJ, LPA, LRI, MEN, SAL, SDE, SFE, SJU, SLU, TUC)
Lycium ciliatum x cestroides	ARG(COR)
Lycium ciliatum x elongatum	ARG(COR)
Lycium cuneatum	ARG(CHA, COS, FOR, JUJ, SAL, SFE) / PRY(APY, AMA, PHA)
Lycium cyathiforme	ARG(JUJ, SAL)
Lycium deserti	CHL(ANT, ATA)
Lycium distichum	CHL(TAR)
Lycium elongatum	ARG(CAT, COR, LRI, MEN, SDE, SJU, SLU, TUC)
Lycium elongatum x cestroides	ARG(CAT, COR)
Lycium fuscum	ARG(CAT, LRI, MEN, SJU)
Lycium gilliesianum	ARG(BAI, CAT, CHA, CHU, COR, LPA, LRI, MEN, NEU, RNE, SAL, SCR, SLU)
Lycium glomeratum	ARG(MIS) / BRA(PAR) / PRY(APY, APA, CEN, PHA)
Lycium humile	ARG(CAT, JUJ, SAL) / CHL(TAR, ANT, ATA)
Lycium infaustum	ARG(BAI, CAT, COR, ERI, LPA, LRI, MEN, SAL, SDE, SFE, SJU, SLU, TUC)
Lycium leiostemum	CHL(TAR, ANT)
Lycium minutifolium	CHL(ANT, ATA, COQ)
Lycium morongii	ARG(CHA, COR, COS, ERI, FOR, MIS, SAL, SDE, SFE, TUC) / PRY(APY, CEN, CON, ÑEE, PAI, PHA)
Lycium nodosum	ARG(CHA, COR, COS, ERI, FOR, JUJ, TUC) / PRY(APY, PHA)
Lycium pubitubum	ARG(SCR)
Lycium rachidocladum	CHL(ATA, COQ)
Lycium repens	ARG(CHU, SCR)
Lycium schreiteri	ARG(CAT, LRI, SJU, TUC)
Lycium stenophyllum	CHL(TAR, ANT, ATA, COQ)
Lycium tenuispinosum var. friesii	ARG(CAT, COR, JUJ, LRI, MEN, SAL, SDE, SJU, TUC)
Lycium tenuispinosum var. tenuispinosum	ARG(BAI, CHU, COR, JUJ, LPA, LRI, MEN, NEU, RNE, SAL, SJU, SLU, SFE, SDE) / PRY(APY)
Lycium tenuispinosum var. calycinum	ARG(CAT, JUJ, LRI, SAL, SJU, TUC) / CHL(BIO)
Lycium vimineum	ARG(BAI, ERI, SFE) / URY(DUR)
Lycopodiella caroliniana var. paradoxa	BRA(PAR, SCA) / PRY(CAU)
Lycopodiella geometra	ARG(COS) / BRA(PAR, RGS, SCA) / PRY(CAU)
Lycopodiella longipes	ARG(COS, MIS) / BRA(PAR, RGS, SCA) / PRY(APA, APY, CAU, CAN) / URY(MON)
Lycopodiella pendulina	PRY(AMA)
Lycopodiella tupiana	BRA(PAR, RGS, SCA) / PRY(CAU, CAN) / URY(CAS, COL, MAL, MON, ROC)
Lycopodium clavatum	ARG(COR, JUJ, MIS, SAL, TUC) / BRA(PAR, RGS, SCA) / PRY(CAU)
Lycopsis arvensis	ARG(COR, LPA, MEN, NEU, RNE)
Lycopus europaeus	CHL(LLA)
Lygodium venustum	ARG(FOR, MIS) / BRA(RGS) / PRY(PAI)
Lygodium volubile	ARG(MIS) / BRA(PAR, RGS, SCA) / PRY(AMA, CAA, CAN, COA, PAI)
Lyroglossa euglossa	BRA(PAR)
Lyroglossa grisebachii	BRA(PAR)
Lysimachia sertulata	ARG(NEU, RNE) / CHL(MAU, BIO, ARA, LLA)
Lythrum hyssopifolium	ARG(BAI, COS, DFE, ERI, LPA, NEU, RNE, SFE, SJU) / BRA(RGS, SCA) / CHL(TAR, ATA, COQ, VAL, LBO, MAU, BIO, ARA, LLA, RME, JFE) / URY(CAS, COL, FLA, MAL, MON)
Lythrum junceum	BRA(PAR)
Lythrum maritimum	ARG(BAI, CAT, CHA, COR, COS, ERI, JUJ, SAL, SFE, SJU, SLU, TUC) / BRA(RGS, SCA) / CHL(TAR, ATA, VAL, JFE) / URY(CLA, MON)
Lythrum portula	CHL(ARA, LLA)
Lythrum salicaria	ARG(CHU) / CHL(LLA, RME)
Lytocaryum hoehnei	BRA(PAR)
Lytoneuron crenulans	ARG(JUJ, SAL) / BRA(PAR, RGS, SCA)
Lytoneuron lomariaceum	ARG(MIS) / BRA(PAR, RGS, SCA) / PRY(APA, AMA, CAU, CAN, COA, SPE) / URY(RIV)
