Zameioscirpus atacamensis	ARG(CAT, JUJ, LRI, SAL, SJU) / CHL(ATA, COQ)
Zameioscirpus gaimardiodes	ARG(NEU, SJU) / CHL(COQ)
Zameioscirpus muticus	ARG(CAT, JUJ, LRI, SAL) / CHL(TAR, ANT)
Zannichellia palustris	ARG(BAI, CHA, CHU, COR, JUJ, LPA, MEN, RNE, SAL, SJU, SCR, SFE, SDE, TDF, TUC) / CHL(ANT, ATA, COQ, VAL, LBO, MAU, MAG, RME) / URY(ROC)
Zantedeschia aethiopica	ARG(BAI, SAL) / BRA(PAR, RGS) / CHL(VAL, LLA, RME, JFE) / URY(MON)
Zanthoxylum armatum	ARG(COR)
Zanthoxylum caribaeum	ARG(COS, FOR, MIS) / BRA(PAR, RGS, SCA) / PRY(APA, AMA, CAU, CAA, CAN, CEN, CON, COA, GUA, ITA, PAI, SPE)
Zanthoxylum coco	ARG(CAT, CHA, COR, JUJ, LRI, SAL, SLU, TUC) / PRY(PAI)
Zanthoxylum fagara	ARG(BAI, CHA, COS, ERI, FOR, JUJ, MIS, SAL, SFE) / BRA(PAR, RGS, SCA) / PRY(APA, APY, AMA, CAU, CAA, CAN, CEN, CON, COA, GUA, ITA, MIE, ÑEE, PAI, PHA, SPE) / URY(ART, CLA, COL, LAV, MAL, RNO, RIV, ROC, SJO, SOR, TAC, TYT)
Zanthoxylum kleinii	BRA(PAR, RGS, SCA)
Zanthoxylum monogynum	BRA(PAR)
Zanthoxylum obscurum	BRA(PAR)
Zanthoxylum petiolare	ARG(CHA, COS, FOR, JUJ, MIS, SAL, SFE, TUC) / BRA(PAR, RGS, SCA) / PRY(APY, APA, AMA, CAU, CAA, CAN, CEN, CON, COA, GUA, ITA, MIE, ÑEE, PAI, PHA, SPE)
Zanthoxylum rhoifolium	ARG(BAI, CHA, COS, ERI, FOR, JUJ, MIS, SAL, SFE, TUC) / BRA(PAR, RGS, SCA) / PRY(APA, AMA, CAU, CAA, CAN, CEN, CON, COA, GUA, ITA, MIE, PAI, SPE) / URY(CAS, COL, DUR, FLA, LAV, MAL, ROC, SJO, TAC)
Zanthoxylum riedelianum	ARG(COS, MIS) / BRA(PAR) / PRY(APA, CAA, CAN, CEN, CON, COA, GUA, MIE, PAI, SPE)
Zanthoxylum rigidum	ARG(COS) / PRY(APY, AMA, CON, COA, ÑEE, PAI, PHA)
Zanthoxylum tingoassuiba	BRA(PAR)
Zapoteca formosa	ARG(JUJ, SAL, SDE, TUC) / BRA(Fuera del área del proyecto) / PRY(APY, AMA, CON, PHA)
Zapoteca portoricensis ssp. flavida	ARG(MIS) / BRA(Fuera del área del proyecto)
Zephyra compacta	CHL(ATA, COQ)
Zephyra elegans	CHL(TAR, ANT, ATA, COQ)
Zephyranthes americana	ARG(BAI, COS, ERI, MIS) / BRA(RGS) / URY(ART, CAS, CLA, MAL, MON, RIV, ROC, SAO, SJO, SOR, TAC, TYT)
Zephyranthes amoena	BRA(PAR)
Zephyranthes andina	ARG(JUJ, SAL)
Zephyranthes candida	ARG(BAI, COR, ERI, MIS, SFE) / URY(CAS, MON, SAO, SJO, SOR)
Zephyranthes capivarina	BRA(PAR)
Zephyranthes carinata	ARG(FOR, MIS, TUC) / BRA(Fuera del área del proyecto)
Zephyranthes diluta	ARG(SJU)
Zephyranthes filifolia	ARG(BAI, CAT, COR, COS, LPA, LRI, MEN, MIS, NEU, RNE, SJU, SLU, SFE)
Zephyranthes flavissima	ARG(COS, ERI, MIS) / BRA(PAR, RGS, SCA)
Zephyranthes gratissima	BRA(PAR)
Zephyranthes lagesiana	BRA(SCA)
Zephyranthes longistyla	ARG(COR, SDE, SLU)
Zephyranthes mesochloa	ARG(BAI, CAT, COS, ERI, FOR, JUJ, LRI, MIS, TUC) / BRA(SCA) / PRY(APY, CAN, CEN, COA, SPE) / URY(ART, RIV)
Zephyranthes microstigma	BRA(RGS)
Zephyranthes minima	ARG(BAI, COS, ERI, SFE) / BRA(RGS) / URY(ART, CAS, DUR, FLA, MON, PAY, SJO)
Zephyranthes paranensis	BRA(PAR)
Zephyranthes seubertii	ARG(CHA, COS, ERI, FOR, MIS, SFE) / BRA(RGS) / PRY(PAI) / URY(SAO)
Zephyranthes tucumanensis	ARG(TUC)
Zephyranthes uruguaianica	BRA(RGS)
Zeyheria montana	BRA(PAR)
Zeyheria tuberculosa	BRA(PAR) / PRY(APY)
Zinnia peruviana	ARG(CAT, CHA, COR, ERI, FOR, JUJ, LPA, LRI, MEN, SAL, SDE, SJU, SLU, TUC) / PRY(APY, CEN)
Zizaniopsis bonariensis	ARG(BAI, COS, ERI, SFE) / BRA(RGS) / URY(CLA, MON, ROC, SJO)
Zizaniopsis microstachya	BRA(PAR, RGS, SCA)
Zizaniopsis villanensis	ARG(CHA, COS, SFE)
Zollernia ilicifolia	BRA(PAR, RGS, SCA)
Zollernia splendens	BRA(PAR)
Zootrophion atropurpureum	BRA(PAR, SCA)
Zornia burkartii	ARG(COS, MIS) / BRA(PAR, RGS) / PRY(CAU)
Zornia contorta	ARG(CAT, JUJ, SAL, TUC) / URY(ART, CAS, CLA, SAO, TAC)
Zornia crinita	ARG(COS, FOR, SAL) / BRA(RGS) / PRY(APY, AMA, CAN, CEN, CON, SPE)
Zornia cryptantha	ARG(CHA, COS, ERI, FOR, MIS, SFE) / BRA(PAR, RGS, SCA) / PRY(AMA, COA) / URY(CLA, RIV, TAC)
Zornia curvata	BRA(PAR, RGS)
Zornia fimbriata	PRY(CAN)
Zornia glabra	BRA(PAR, RGS)
Zornia latifolia	ARG(CAT, CHA, COR, COS, ERI, FOR, SAL, SFE, SDE, TUC) / BRA(PAR, RGS, SCA) / PRY(APY, AMA, BOQ, CEN, CON, COA, GUA, ÑEE, PAI, PHA, SPE) / URY(ART, CLA, PAY, RIV, SAO)
Zornia multinervosa	ARG(CHA, COS, ERI, FOR) / BRA(RGS) / PRY(MIE, ÑEE) / URY(ART, CLA, SAO)
Zornia orbiculata	ARG(COS, ERI, MIS) / BRA(RGS) / PRY(PAI) / URY(ART, DUR, PAY, RNO, SAO)
Zornia pardina	ARG(COS, FOR, MIS, SFE) / BRA(PAR, RGS, SCA) / PRY(AMA, CAU, CEN) / URY(ART, CLA, LAV, SAO)
Zornia ramboiana	BRA(PAR, RGS)
Zornia reticulata	ARG(CHA, COR, COS, FOR, JUJ, MIS, SAL) / BRA(PAR, RGS, SCA) / PRY(APY, AMA, CAN, COA, GUA, SPE)
Zornia sericea	ARG(COS, ERI, MIS) / BRA(RGS) / PRY(APY, BOQ, CEN, COA, PAI) / URY(RIV)
Zornia trachycarpa	ARG(CHA, COR, COS, ERI, FOR, MIS, SDE, SFE, TUC) / BRA(RGS) / PRY(MIE) / URY(ART, CLA, COL, CLA, PAY, RNO, RIV, SAO, SJO, TAC)
Zuccagnia punctata	ARG(CAT, LRI, MEN, SAL, SJU, SLU, TUC)
Zuloagocardamum jujuyensis	ARG(JUJ)
Zygia cataractae	ARG(COS, MIS, SFE) / BRA(Fuera del área del proyecto) / PRY(CEN)
Zygia latifolia var. glabrata	BRA(PAR) / PRY(APA)
Zygia morongii	ARG(CHA, COS, FOR, MIS) / BRA(Fuera del área del proyecto) / PRY(CEN, ÑEE, PHA)
Zygia pithecolobioides	ARG(CHA, COS) / BRA(Fuera del área del proyecto) / PRY(CEN, CON, PHA)
Zygopetalum brachypetalum	BRA(PAR)
Zygopetalum crinitum	BRA(PAR, SCA)
Zygopetalum mackayi	BRA(PAR, RGS, SCA)
Zygopetalum maculatum	BRA(PAR)
Zygopetalum maxillare	ARG(COS, FOR, MIS) / BRA(PAR, RGS, SCA) / PRY(APA)
Zygophlebia longipilosa	BRA(PAR, RGS, SCA)
Zygostates alleniana	ARG(CHA, COS, FOR, MIS) / BRA(PAR, RGS, SCA) / PRY(Desconocida)
Zygostates cornuta	BRA(PAR)
Zygostates dasyrhiza	BRA(PAR, RGS, SCA)
Zygostates lunata	BRA(PAR, SCA)
Zygostates multiflora	BRA(PAR)
Zygostates papillosa	BRA(PAR, RGS, SCA)
Zygostates rotundiglossa	BRA(PAR)
Zygostigma australe	ARG(BAI, CHA, COR, COS, ERI, FOR, MIS, SAL, SFE, TUC) / BRA(PAR, RGS, SCA) / PRY(AMA) / URY(COL, FLA, LAV, MAL, MON, RIV)
