Pabstia jugosa	BRA(PAR, RGS, SCA)
Pabstia viridis	BRA(SCA)
Pabstiella alligatorifera	BRA(PAR, RGS, SCA)
Pabstiella arcuata	BRA(PAR)
Pabstiella aveniformis	ARG(MIS) / BRA(PAR, RGS, SCA)
Pabstiella bacillaris	BRA(PAR)
Pabstiella bicolor	BRA(PAR, RGS, SCA)
Pabstiella bradei	BRA(PAR)
Pabstiella calcarata	BRA(PAR, SCA)
Pabstiella campestris	PRY(AMA)
Pabstiella carinifera	BRA(PAR, SCA)
Pabstiella catharinensis	BRA(SCA)
Pabstiella curti-bradei	BRA(PAR)
Pabstiella dryadum	BRA(PAR, RGS, SCA)
Pabstiella hians	BRA(PAR)
Pabstiella hypnicola	BRA(PAR, RGS, SCA)
Pabstiella leptotifolia	BRA(PAR, RGS)
Pabstiella leucopyramis	BRA(SCA)
Pabstiella matinhensis	ARG(MIS) / BRA(PAR, RGS, SCA)
Pabstiella mirabilis	BRA(PAR, RGS, SCA)
Pabstiella miragliae	BRA(SCA)
Pabstiella mouraeoides var. riograndensis	BRA(RGS)
Pabstiella mouraeoides var. mouraeoides	BRA(PAR, RGS, SCA)
Pabstiella nummularia	BRA(SCA)
Pabstiella ochracea	
Pabstiella parvifolia	BRA(SCA)
Pabstiella pellifeloides	BRA(PAR)
Pabstiella piraquarensis	BRA(PAR)
Pabstiella pleurothalloides	BRA(PAR)
Pabstiella podoglossa	BRA(PAR, RGS)
Pabstiella pristeoglossa	BRA(PAR)
Pabstiella punctatifolia	BRA(PAR, SCA)
Pabstiella recurviloba	BRA(PAR, RGS)
Pabstiella seriata	BRA(PAR, RGS, SCA)
Pabstiella sordida	BRA(PAR, RGS, SCA)
Pabstiella sparsiflora	BRA(RGS)
Pabstiella stictophylla	BRA(PAR, SCA)
Pabstiella tenera	BRA(RGS)
Pabstiella tricolor	BRA(PAR)
Pabstiella trifida	BRA(PAR, SCA)
Pabstiella tripterantha	ARG(MIS) / BRA(PAR)
Pabstiella uniflora	BRA(PAR, SCA)
Pabstiella vellozoana	BRA(PAR, RGS)
Pabstiella wackettii	BRA(PAR)
Pachygenium arechavaletae	URY(MON)
Pachygenium bonariensis	ARG(BAI, CAT, CHA, COR, COS, ERI, FOR, JUJ, LRI, MIS, SAL, SFE, TUC) / BRA(RGS, SCA) / PRY(CEN, GUA, PAI) / URY(MAL, MON, ROC, SJO, TAC)
Pachygenium burgeri	BRA(RGS)
Pachygenium hysteranthum	BRA(PAR) / PRY(AMA)
Pachygenium itatiaiae	BRA(RGS)
Pachygenium laminatum	BRA(PAR)
Pachygenium paraguayensis	PRY(CAU, CEN, PAI)
Pachygenium sceptrum	BRA(PAR)
Pachygenium schmidtianum	PRY(GUA)
Pachygenium tenuior	BRA(PAR, SCA)
Pachylaena atriplicifolia	ARG(CAT, LRI, MEN, NEU, SAL, SJU) / CHL(ATA, COQ, VAL, LBO, MAU, RME)
Pachyrhizus ahipa	ARG(JUJ)
Pachystroma longifolium	BRA(RGS, SCA)
Pacourina edulis	ARG(CHA, FOR, SFE) / PRY(APY, CEN, CON, COA, ÑEE, PAI, PHA, SPE)
Paederia brasiliensis	ARG(JUJ, SAL, TUC) / BRA(Fuera del área del proyecto) / PRY(AMA)
Paepalanthus albo-vaginatus var. albobracteatus	BRA(PAR, SCA)
Paepalanthus albo-vaginatus var. albo-vaginatus	BRA(PAR, SCA)
Paepalanthus albo-vaginatus var. fuscobracteatus	BRA(PAR)
Paepalanthus balansae var. densiflorus	BRA(PAR)
Paepalanthus balansae var. balansae	BRA(Fuera del área del proyecto) / PRY(AMA, CAU, GUA, SPE)
Paepalanthus bellus	BRA(PAR)
Paepalanthus bryoides	BRA(SCA)
Paepalanthus caldensis	BRA(PAR, RGS, SCA)
Paepalanthus catharinae var. hatschbachii	BRA(PAR, RGS, SCA)
Paepalanthus catharinae var. catharinae	BRA(PAR, RGS, SCA)
Paepalanthus decorus	BRA(RGS)
Paepalanthus henriquei	BRA(RGS, SCA)
Paepalanthus kleinii	BRA(SCA)
Paepalanthus planifolius	BRA(PAR, RGS, SCA) / PRY(CAU)
Paepalanthus pruinosus	BRA(PAR)
Paepalanthus tessmannii	BRA(PAR)
Paesia glandulosa	BRA(PAR, RGS, SCA)
Palaua concinna	CHL(ANT)
Palaua dissecta	CHL(TAR, ANT)
Palaua inconspicua	CHL(ANT)
Palaua modesta	CHL(ANT)
Palhinhaea camporum	ARG(MIS) / BRA(PAR) / PRY(AMA, CAU, CAN)
Palhinhaea cernua	ARG(COS, ERI, MIS, SAL) / BRA(PAR, RGS) / PRY(CAA, CAN, COA, GUA) / URY(MAL, RIV, TAC)
Palicourea australis	BRA(PAR, SCA)
Palicourea crocea	ARG(CHA, COS, FOR, MIS) / BRA(PAR) / PRY(APA, AMA, CAU, CAA, CAN, CEN, COA, GUA, ITA, MIE, PAI, PHA, SPE)
Palicourea macrobotrys	ARG(MIS) / BRA(PAR) / PRY(AMA, CAN)
Palicourea marcgravii	BRA(PAR)
Palicourea rigida	BRA(PAR) / PRY(AMA, CAN, CON, SPE)
Panicum antidotale	ARG(JUJ)
Panicum aquaticum	BRA(PAR, RGS, SCA)
Panicum bergii var. bergii	ARG(BAI, CHA, COR, COS, ERI, FOR, JUJ, LPA, MIS, SLU, SFE, SDE, TUC) / BRA(RGS) / PRY(APY, BOQ, CEN, CON, MIE, ÑEE, PAI, PHA) / URY(CAS, CLA, FLO, MAL, PAY, ROC, SJO, SOR, TAC)
Panicum bergii var. pilosissimum	ARG(COS, MIS) / BRA(RGS)
Panicum bresolini	BRA(SCA)
Panicum campestre	BRA(PAR)
Panicum capillare	ARG(BAI, DFE, ERI, JUJ, LPA, NEU, RNE, SLU, SFE) / CHL(COQ, VAL, MAU, BIO, ARA, LLA, RME) / URY(MON)
Panicum cervicatum	BRA(Fuera del área del proyecto) / PRY(AMA)
Panicum chasiae	ARG(COS, ERI, SFE) / BRA(RGS) / URY(MAL, RIV, SAO, SOR, TAC)
Panicum chloroleucum	ARG(CAT, JUJ, LRI, SAL, TUC)
Panicum condensatum	BRA(SCA)
Panicum dichotomiflorum	ARG(BAI, CHA, COS, ERI, FOR, LPA, MIS, SFE) / BRA(PAR, RGS, SCA) / CHL(LBO, MAU, BIO, RME) / PRY(APY, APA, AMA, CEN, COA, GUA, ITA, ÑEE, PAI, PHA, SPE) / URY(ART, MON, PAY, SAO)
Panicum exiguum	BRA(Fuera del área del proyecto) / PRY(AMA, CON)
Panicum glabripes	ARG(COS, ERI, SFE) / BRA(PAR, RGS, SCA) / URY(PAY, RNO, RIV)
Panicum gouinii	ARG(BAI, COS, ERI, SFE) / BRA(PAR, RGS, SCA) / URY(ROC)
Panicum hirsutum	ARG(CHA)
Panicum leptachne	BRA(PAR)
Panicum longipedicellatum	BRA(PAR, SCA)
Panicum longissimum	PRY(PAI)
Panicum magnispicula	BRA(SCA)
Panicum miliaceum	ARG(BAI, COR, COS, DFE, ERI, LPA, LRI, MEN, SAL, SFE, TUC) / BRA(RGS, SCA) / URY(CLA, COL, MON)
Panicum millegrana	ARG(COS, MIS) / BRA(PAR, RGS, SCA) / PRY(APA, AMA, CAU, CAA, CEN, COA, GUA, MIE, PAI, SPE)
Panicum olyroides var. hirsutum	ARG(COS, MIS) / BRA(PAR, RGS, SCA) / PRY(AMA, CAU, COA) / URY(RIV)
Panicum olyroides var. olyroides	ARG(COS, MIS) / BRA(PAR, RGS, SCA) / PRY(APA, AMA, CAU, CEN, CON, GUA, MIE, PAI)
Panicum pedersenii	ARG(COS) / BRA(RGS) / PRY(CEN, COA)
Panicum peladoense	ARG(COR, COS, JUJ, MIS, SAL) / BRA(PAR, RGS, SCA) / PRY(AMA, CON, GUA, PAI) / URY(RIV, TAC)
Panicum quadriglume	ARG(MIS) / BRA(Fuera del área del proyecto) / PRY(APY, AMA, CEN, CON, COA, PAI)
Panicum racemosum	ARG(BAI, ERI) / BRA(RGS, SCA) / CHL(BIO, ARA, LLA) / URY(COL, MON, ROC, SJO)
Panicum repens	ARG(COS, ERI, MIS) / BRA(PAR, SCA)
Panicum rude	BRA(PAR, RGS, SCA)
Panicum rupestre	BRA(Fuera del área del proyecto)
Panicum sellowii	ARG(COS, MIS) / BRA(PAR, RGS) / PRY(APA, CAU, CAN, CEN, CON, COA, ITA, PAI, SPE) / URY(TYT)
Panicum stramineum	ARG(CAT, COR, FOR, JUJ, LRI, SAL) / PRY(APY, CON, COA, PHA)
Panicum trichanthum	ARG(CHA, COS, ERI, FOR, JUJ, MIS, SAL, SFE) / BRA(PAR, RGS, SCA) / PRY(APY, CEN, CON, COA, GUA, PAI, PHA, SPE) / URY(ART, PAY, SAO)
Panicum trichoides	ARG(JUJ, SAL)
Panicum tricholaenoides var. tricholaenoides	ARG(BAI, CHA, COS, ERI, FOR, MIS, SFE) / BRA(PAR, RGS) / PRY(APA, AMA, PHA, SPE) / URY(ART, DUR, PAY, SAO)
Panicum tricholaenoides var. flavomarginatum	PRY(CAU, CAA, CEN, PAI, PHA)
Panicum urvilleanum	ARG(BAI, CAT, CHU, COR, ERI, LPA, LRI, MEN, NEU, RNE, SAL, SJU, SLU, SFE, TUC) / CHL(BIO, ARA, LLA)
Panmorphia adenochila	BRA(PAR, RGS, SCA)
Panmorphia brevipes	BRA(PAR)
Panmorphia ciliolata	BRA(PAR)
Panmorphia corticicola	BRA(PAR, RGS, SCA)
Panmorphia limbata	ARG(MIS) / BRA(SCA)
Panmorphia microblephara	BRA(PAR)
Panmorphia microgemma	BRA(PAR)
Panmorphia paranaensis	BRA(PAR, RGS, SCA)
Panmorphia rudolfii	BRA(RGS)
Panphalea araucariophila	BRA(RGS, SCA)
Panphalea bupleurifolia	ARG(BAI, COS, ERI) / BRA(RGS) / URY(CAS, CLA, CLA, FLA, LAV, MAL, MON, PAY, SAO, SJO, SJO, TAC)
Panphalea cardaminifolia	BRA(RGS, SCA) / URY(ART, MON)
Panphalea commersonii	BRA(PAR, RGS) / URY(CAS, CLA, FLA, MAL, MON, PAY, RIV, SAO, SJO)
Panphalea heterophylla	ARG(BAI, COS, ERI, MIS) / BRA(RGS) / URY(ART, CAS, CLA, COL, CLA, FLO, FLA, LAV, MAL, MON, PAY, RNO, RIV, ROC, SAO, SJO, SJO, TAC, TYT)
Panphalea maxima	BRA(RGS, SCA) / URY(CAS, CLA, FLA, LAV, MON, PAY, TYT)
Panphalea missionum	ARG(COS, MIS) / BRA(RGS) / PRY(COA, ITA)
Panphalea ramboi	BRA(RGS)
Panphalea smithii	BRA(PAR, RGS, SCA)
Pantacantha ameghinoi	ARG(CHU, MEN, NEU, RNE)
Papaver dubium	ARG(BAI, MEN) / CHL(MAG) / URY(CAS, MON)
Papaver hybridum	ARG(BAI, LPA) / CHL(VAL, RME)
Papaver nudicaule	ARG(TDF)
Papaver rhoeas	ARG(BAI, LPA, MEN, NEU, RNE) / CHL(LBO, LLA, RME) / URY(CAS)
Papaver somniferum	ARG(BAI, COR, COS, ERI, LPA, NEU, RNE, TDF) / CHL(COQ, MAU, BIO, LLA, RME, JFE) / URY(CAS, MON, PAY)
Pappophorum caespitosum	ARG(BAI, CAT, CHA, COR, ERI, JUJ, LPA, LRI, MEN, RNE, SAL, SDE, SFE, SJU, SLU, TUC) / PRY(APY)
Pappophorum hassleri	PRY(CAU, CAN, SPE)
Pappophorum krapovickasii	ARG(CAT, COR, COS, FOR, LPA, LRI, MEN, SAL, SJU, TUC) / PRY(APY)
Pappophorum macrospermum	ARG(COS) / BRA(RGS) / URY(RNO, RIV)
Pappophorum pappiferum	ARG(BAI, CAT, CHA, COR, COS, DFE, ERI, FOR, JUJ, LPA, LRI, MEN, SAL, SJU, SLU, SFE, SDE, TUC) / PRY(APY, CEN, PHA) / URY(MON)
Pappophorum phillippianum	ARG(BAI, CAT, CHA, COR, COS, ERI, FOR, JUJ, LPA, LRI, MEN, RNE, SAL, SJU, SLU, SFE, SDE, TUC)
Pappophorum vaginatum	ARG(BAI, CAT, CHA, COR, COS, ERI, LPA, LRI, MEN, NEU, RNE, SAL, SJU, SLU, SFE, SDE, TUC) / PRY(APY, CON) / URY(MON, PAY)
Pappostipa ameghinoi	ARG(CHU, MEN, NEU, SCR)
Pappostipa arenicola	ARG(SCR)
Pappostipa atacamensis	ARG(CAT) / CHL(ANT, ATA, COQ, RME)
Pappostipa barrancaensis	ARG(LPA, MEN, NEU, RNE)
Pappostipa braun-blanqueti	ARG(MEN)
Pappostipa choconensis	ARG(NEU)
Pappostipa chrysophylla var. chrysophylla	ARG(CHU, LPA, LRI, MEN, NEU, RNE, SAL, SJU, SCR, TDF) / CHL(TAR, ANT, ATA, COQ, VAL, LBO, MAU, MAG, RME)
Pappostipa chrysophylla var. crispula	ARG(MEN)
Pappostipa chubutensis	ARG(CHU, MEN, NEU, SJU, SCR)
Pappostipa colloncurensis	ARG(NEU)
Pappostipa frigida var. frigida	ARG(CAT, JUJ, LRI, SAL, SJU) / CHL(TAR, ANT, ATA, COQ, MAU, RME)
Pappostipa frigida var. parvispicula	ARG(CAT, LRI, SJU)
Pappostipa frigida var. longifolia	ARG(LRI)
Pappostipa hieronymusii	ARG(CAT, LRI, SAL, SJU)
Pappostipa humilis var. humilis	ARG(CHU, LPA, MEN, NEU, RNE, SCR, TDF) / CHL(AIS, MAG)
Pappostipa humilis var. ruiziana	ARG(LPA, MEN, SJU)
Pappostipa humilis var. decrescens	ARG(CHU, LPA, MEN, NEU, RNE, SCR)
Pappostipa ibarii f. pallescens	ARG(MEN)
Pappostipa ibarii	ARG(CHU, MEN, NEU, SCR) / CHL(MAG)
Pappostipa jucunda	ARG(MEN)
Pappostipa kieslingii	ARG(LRI, SJU)
Pappostipa maeviae	ARG(NEU)
Pappostipa malalhuensis	ARG(CHU, MEN)
Pappostipa mapuche	ARG(NEU)
Pappostipa marqueziana	ARG(SJU)
Pappostipa nana	ARG(SCR)
Pappostipa nicorae	ARG(CAT, MEN, SJU)
Pappostipa parodiana	ARG(MEN, NEU, RNE)
Pappostipa ruiz-lealii	ARG(CAT, MEN)
Pappostipa semperiana	ARG(LPA, MEN, SJU)
Pappostipa sorianoi	ARG(CHU, SCR)
Pappostipa speciosa	ARG(BAI, CHU, LPA, MEN, NEU, RNE, SJU, SCR) / CHL(TAR, ANT, ATA, COQ, VAL, MAU, BIO, RME)
Pappostipa vaginata	ARG(CAT, JUJ, LPA, LRI, MEN, NEU, SAL, SJU, SLU) / CHL(TAR, ANT, COQ, VAL, RME)
Pappostipa vatroensis	ARG(CHU, LPA, MEN, NEU, RNE, SCR)
Pappostipa zulmae	ARG(LPA, NEU)
Paradisanthus bahiensis	BRA(PAR, SCA)
Paradisanthus mosenii	BRA(PAR, SCA)
Paramyrciaria ciliolata	ARG(SAL) / BRA(PAR, RGS, SCA) / PRY(CAN, SPE)
Paramyrciaria delicatula var. argentinensis	ARG(COS, MIS) / BRA(PAR) / PRY(CAU, ITA, PAI)
Paramyrciaria delicatula var. delicatula	BRA(PAR, RGS, SCA) / PRY(AMA, CAU, CAN, COA, PAI)
Paramyrciaria glazioviana	BRA(SCA)
Paramyrciaria tapiraguayensis	PRY(CEN, COA, PAI, SPE)
Paranephelius asperifolius	ARG(SAL)
Parapholis incurva	ARG(BAI, CHU, ERI, LPA, SLU, SCR, SFE) / CHL(COQ, VAL, BIO) / URY(MON, SJO)
Parapholis strigosa	CHL(BIO, ARA, LLA)
Parapiptadenia excelsa	ARG(CAT, JUJ, LRI, SAL, TUC) / BRA(PAR) / PRY(CEN, COA)
Parapiptadenia rigida	ARG(COS, FOR, MIS) / BRA(PAR, RGS, SCA) / PRY(APY, APA, AMA, CAU, CAN, CEN, CON, COA, GUA, ITA, PAI) / URY(ART, CLA, MON, RIV, ROC, SAO)
Parapolystichum effusum	ARG(MIS) / BRA(PAR, RGS, SCA) / PRY(APA, CAU, CAN, COA, ITA, PAI, SPE)
Parasenegalia visco	ARG(BAI, CAT, COR, ERI, JUJ, LPA, LRI, MEN, MIS, SAL, SJU, SLU, SDE, TUC) / CHL(TAR, ANT)
Parastrephia lucida	ARG(CAT, JUJ, SAL, TUC) / CHL(TAR, ANT)
Parastrephia quadrangularis	ARG(CAT, JUJ, LRI, SAL, SJU, TUC) / CHL(TAR, ANT)
Parastrephia teretiuscula	CHL(ANT)
Parentucellia latifolia	CHL(VAL, LBO, MAU, BIO, ARA, RME)
Parentucellia viscosa	ARG(NEU, RNE) / BRA(RGS) / CHL(MAU, BIO, ARA, LLA, RME) / URY(CAS, COL, FLO, MAL, MON, SJO, SOR)
Parietaria debilis	ARG(BAI, CAT, CHA, CHU, COR, COS, DFE, ERI, FOR, JUJ, LPA, LRI, MEN, MIS, RNE, SAL, SDE, SFE, SJU, SLU, TUC) / BRA(PAR, RGS, SCA) / CHL(TAR, ANT, ATA, COQ, VAL, LBO, RME, JFE) / PRY(APY, APA, CAA, PAI) / URY(CAS, FLA, LAV, PAY, ROC, SAO, SJO, SOR)
Parietaria judaica	ARG(DFE, ERI, SFE) / CHL(VAL, RME) / URY(MON)
Parinari obtusifolia	BRA(Fuera del área del proyecto) / PRY(Desconocida)
Parkinsonia aculeata	ARG(BAI, CAT, CHA, COS, ERI, FOR, LPA, SAL, SDE, SFE) / BRA(RGS) / PRY(APY, CEN, COA, PHA) / URY(ART, CAS, CLA, DUR, FLA, MON, PAY, RNO, SAO, TAC)
Parodia alacriportana	BRA(SCA)
Parodia allosiphon	BRA(RGS) / URY(RIV)
Parodia aureicentra	ARG(SAL)
Parodia buiningii	BRA(RGS) / URY(ART, RIV, SAO)
Parodia carambeiensis	BRA(PAR)
Parodia chrysacanthion	ARG(JUJ)
Parodia claviceps	BRA(RGS)
Parodia concinna	BRA(RGS) / URY(CAS, CLA, COL, LAV, MAL, MON, TYT)
Parodia crassigiba	BRA(RGS)
Parodia graessneri	BRA(RGS)
Parodia haselbergii	BRA(RGS)
Parodia herteri	BRA(RGS) / URY(RIV, TAC)
Parodia horstii	BRA(RGS)
Parodia leninghausii	BRA(RGS)
Parodia linkii	ARG(COS, MIS) / BRA(PAR, RGS, SCA) / PRY(ITA, PAI) / URY(ART, CLA, RIV, SAO, TAC)
Parodia maassii	ARG(JUJ)
Parodia magnifica	BRA(RGS)
Parodia mammulosa	ARG(ERI) / URY(ART, CLA, DUR, LAV, MAL, MON, PAY, RIV, SAO, TAC, TYT)
Parodia microsperma ssp. microsperma	ARG(CAT, JUJ, LRI, SAL, SDE, SJU, TUC)
Parodia microsperma ssp. horrida	ARG(SAL)
Parodia mueller-melchersii	BRA(RGS) / URY(MON, RIV, TAC)
Parodia nigrispina	PRY(COA, GUA)
Parodia nivosa	ARG(SAL)
Parodia notorauschii	URY(RIV)
Parodia ottonis	ARG(COS, ERI, MIS) / BRA(PAR, RGS, SCA) / PRY(PAI) / URY(ART, CAS, CLA, COL, DUR, FLO, FLA, LAV, MAL, MON, PAY, RNO, RIV, ROC, SAO, SJO, SOR, TAC, TYT)
Parodia oxicostata	BRA(RGS)
Parodia penicillata	ARG(SAL)
Parodia rechensis	BRA(RGS)
Parodia rudibuenekeri	BRA(RGS)
Parodia schumanniana	ARG(MIS) / BRA(RGS) / PRY(GUA, PAI)
Parodia scopa	BRA(RGS) / URY(CLA, LAV, MAL, ROC, TYT)
Parodia stockingeri	BRA(RGS)
Parodia stuemeri	ARG(JUJ, SAL)
Parodia submammulosa ssp. minor	ARG(CAT)
Parodia submammulosa ssp. submammulosa	ARG(BAI, COR, LPA, MEN, RNE, SLU)
Parodia tabularis	URY(MAL)
Parodia tenuicylindrica	BRA(RGS)
Parodia turecekiana	ARG(COS, ERI) / URY(RNO)
Parodia wedermanniana	BRA(RGS) / URY(DUR, RIV, TAC)
Parodianthus capillaris	ARG(COR)
Parodianthus ilicifolius	ARG(COR, LRI, SLU)
Parodiodendron marginivillosum	ARG(JUJ, SAL)
Parodiodoxa chionophila	ARG(CAT, JUJ, LRI, SAL, TUC)
Parodiolyra micrantha	ARG(MIS) / BRA(PAR, RGS, SCA) / PRY(APA, AMA, CAN, PAI)
Parodiophyllochloa cordovensis	ARG(COS, JUJ, MIS, SAL, TUC) / BRA(PAR, SCA)
Parodiophyllochloa missiona	ARG(BAI, COS, ERI, MIS) / BRA(PAR, RGS, SCA) / PRY(APA, CAU, ITA) / URY(MAL, TAC)
Parodiophyllochloa ovulifera	ARG(COS, JUJ, MIS, SAL, TUC) / BRA(PAR, RGS, SCA) / PRY(APA, CEN, COA, ITA, MIE, PAI, SPE) / URY(CLA, LAV, MAL, ROC, TAC)
Parodiophyllochloa pantricha	ARG(MIS) / BRA(PAR, RGS, SCA) / PRY(AMA, CAU, CAA, CON, COA, GUA, ÑEE)
Parodiophyllochloa rhizogona	ARG(MIS) / BRA(PAR, RGS, SCA)
Paronychia brasiliana var. brasiliana	ARG(BAI, COR, COS, ERI, LPA, MIS, SAL, SFE) / BRA(RGS) / URY(MON)
Paronychia brasiliana var. pubescens	ARG(BAI, COS, ERI)
Paronychia cabrerae	ARG(CAT, JUJ, TUC)
Paronychia camphorosmoides	BRA(PAR, SCA)
Paronychia chilensis var. mutica	CHL(COQ, VAL, BIO)
Paronychia chilensis ssp. chilensis	ARG(BAI, CAT, CHU, COR, ERI, LPA, LRI, RNE, SCR, TUC) / BRA(RGS) / CHL(ATA, COQ, VAL, LBO, MAU, BIO, RME)
Paronychia chilensis ssp. subandina	CHL(COQ)
Paronychia communis var. communis	ARG(CAT, CHA, COR, COS, ERI, JUJ, LRI, MIS, SAL, SJU, TUC) / BRA(PAR, RGS, SCA) / PRY(COA, PAI) / URY(ART, RNO, RIV, SJO, TAC)
Paronychia communis f. subglabra	ARG(CHA, MIS) / PRY(SPE)
Paronychia communis var. pungentifolia	BRA(RGS, SCA)
Paronychia communis var. chicligastensis	ARG(TUC)
Paronychia coquimbensis var. appressa	CHL(COQ)
Paronychia coquimbensis var. coquimbensis	CHL(COQ, VAL)
Paronychia hieronymi var. hieronymi	ARG(JUJ, SAL, TUC)
Paronychia hieronymi var. jujuyensis	ARG(JUJ)
Paronychia johnstonii var. scabrida	CHL(ANT)
Paronychia johnstonii var. johnstonii	CHL(ANT)
Paronychia microphylla	CHL(TAR)
Paronychia muschleri	ARG(SAL)
Paronychia paranensis	BRA(PAR)
Paronychia revoluta	BRA(RGS)
Paronychia setigera ssp. argillicola	ARG(COS, ERI)
Paronychia setigera ssp. setigera	ARG(BAI, CHU, COR, JUJ, LPA, MEN, MIS, RNE, SAL, SJU, SLU, SCR) / BRA(RGS) / CHL(VAL) / URY(MAL)
Paronychia setigera var. longiseta	ARG(BAI) / BRA(RGS) / URY(ART)
Paronychia setigera var. subglabra	ARG(COR, MEN)
Paronychia setigera ssp. cordobensis	ARG(CAT, COR, COS, ERI, MEN, MIS, SLU, SFE, SDE)
Parthenium cineraceum	PRY(APY)
Parthenium hysterophorus	ARG(BAI, CAT, CHA, COR, COS, ERI, FOR, JUJ, LPA, LRI, MEN, NEU, SAL, SJU, SLU, SFE, SDE, TUC) / BRA(PAR) / PRY(APY, AMA, PHA) / URY(MON, RNO, SAO)
Parthenocissus quinquefolia	ARG(DFE, LPA)
Parthenocissus tricuspidata	ARG(BAI, DFE)
Pascalia glauca	ARG(BAI, CAT, CHA, CHU, COR, COS, ERI, FOR, JUJ, LPA, LRI, MEN, MIS, NEU, RNE, SAL, SJU, SLU, SFE, SDE) / CHL(ATA) / PRY(PHA) / URY(COL, MON, RNO, SJO)
Pascalia subvaginata	ARG(CHA, COS, ERI, FOR, SFE) / PRY(CEN, COA, PHA)
Pasithea caerulea	CHL(ANT, ATA, COQ, VAL, LBO, MAU, BIO, ARA, LLA, RME)
Paspalum acuminatum	ARG(CHA, COS, ERI, FOR, JUJ, MIS, SFE, TUC) / BRA(PAR, RGS, SCA) / PRY(AMA, CEN, CON, COA, ITA)
Paspalum almum	ARG(CHA, COS, ERI, FOR, MIS, SFE) / BRA(RGS, SCA) / PRY(APY, CEN, COA, MIE, ÑEE, PAI, PHA) / URY(ART, PAY)
Paspalum ammodes	BRA(PAR) / PRY(AMA, CAU, CAN)
Paspalum approximatum	BRA(PAR) / PRY(AMA, CAN)
Paspalum arenarium	BRA(PAR, RGS, SCA)
Paspalum arundinellum	ARG(CHA, COS, MIS) / PRY(APA, APY, CAU, CEN, COA, GUA, ÑEE, PAI, PHA, SPE)
Paspalum atratum	BRA(Fuera del área del proyecto) / PRY(AMA, CON, SPE)
Paspalum bertonii	ARG(MIS) / BRA(PAR) / PRY(APA, CAU, CAN, ITA, MIE)
Paspalum buckleyanum	ARG(CHA, COS, DFE, ERI, FOR, JUJ, SAL, SFE, SDE) / PRY(APY, PHA)
Paspalum candidum	ARG(JUJ, SAL) / CHL(VAL)
Paspalum carinatum	BRA(PAR, SCA)
Paspalum ceresia	ARG(JUJ, SAL, TUC)
Paspalum chacoense	ARG(FOR) / PRY(APY, BOQ, CON, GUA)
Paspalum chaseanum	ARG(FOR) / PRY(APY)
Paspalum chilense	CHL(BIO, ARA, LLA)
Paspalum cinerascens	BRA(PAR) / PRY(AMA, SPE)
Paspalum commune	ARG(JUJ, SAL, SDE, TUC)
Paspalum compressifolium	ARG(COS, MIS) / BRA(PAR, RGS, SCA) / PRY(AMA, CAU, CEN, CON, MIE)
Paspalum conduplicatum	BRA(PAR, RGS, SCA)
Paspalum conjugatum	ARG(CHA, COS, ERI, FOR, JUJ, MIS, SAL, SDE, SFE, TUC) / BRA(PAR, RGS, SCA) / PRY(APA, AMA, CAU, CAA, CAN, CEN, CON, COA, GUA, MIE, PAI, SPE)
Paspalum conspersum	ARG(CHA, COS, FOR, MIS, SFE) / BRA(PAR, RGS, SCA) / PRY(APA, APY, AMA, BOQ, CAN, CEN, COA, ÑEE, PHA)
Paspalum corcovadense	BRA(PAR, RGS, SCA)
Paspalum cordatum	BRA(PAR)
Paspalum crispatum	PRY(AMA)
Paspalum cromyorrhizon	ARG(COS, ERI, MIS) / BRA(RGS) / URY(CLA, DUR, MON, RNO, SAO, SOR)
Paspalum dasypleurum	ARG(NEU, SLU) / CHL(LBO, MAU, BIO, ARA, LLA, RME, JFE)
Paspalum dasytrichum	BRA(PAR, SCA)
Paspalum decumbens	BRA(SCA)
Paspalum dedeccae	ARG(COS, MIS) / BRA(PAR) / PRY(APA, AMA, CAU, CAN, GUA)
Paspalum denticulatum	ARG(BAI, CAT, CHA, COR, COS, DFE, ERI, FOR, JUJ, MIS, SAL, SFE, SDE, TUC) / BRA(RGS, SCA) / PRY(APY, BOQ, CAN, CEN, CHO, PHA) / URY(CAS, COL, MON, PAY, SAO, SOR)
Paspalum dilatatum ssp. dilatatum	ARG(BAI, CAT, CHA, COR, COS, DFE, ERI, JUJ, LPA, MEN, MIS, SAL, SDE, SFE, SJU, SLU, TUC) / BRA(PAR, RGS, SCA) / CHL(COQ, VAL, LBO, MAU, BIO, ARA, RME, IPA) / PRY(PAI) / URY(ART, COL, MAL, MON)
Paspalum dilatatum ssp. flavescens	ARG(BAI, COS) / BRA(RGS, SCA) / URY(MAL, MON)
Paspalum distichum	ARG(BAI, CAT, CHA, COR, COS, DFE, ERI, FOR, JUJ, LPA, LRI, MEN, MIS, RNE, SAL, SJU, SLU, SFE, SDE, TUC) / BRA(PAR, RGS, SCA) / CHL(ANT, VAL, BIO, ARA, JFE) / PRY(APY, BOQ, CEN, CHO, COA, ITA, PHA) / URY(MON)
Paspalum durifolium	ARG(COS, SFE) / BRA(RGS) / PRY(APA, CAU, CEN, COA, GUA, MIE, PAI) / URY(TAC)
Paspalum ekmanianum	ARG(JUJ)
Paspalum ellipticum	ARG(COS) / BRA(PAR, RGS, SCA) / PRY(GUA)
Paspalum equitans	ARG(COS, MIS) / BRA(PAR, RGS) / PRY(AMA, CAU, CON, GUA, MIE, SPE) / URY(CAS)
Paspalum erianthoides	ARG(COS, MIS) / BRA(PAR, SCA) / PRY(AMA, CEN, CON, GUA, PAI)
Paspalum erianthum	BRA(PAR) / PRY(AMA, CON) / URY(ART, MON, PAY)
Paspalum eucomum	BRA(PAR)
Paspalum exaltatum	ARG(BAI, CHA, COR, COS, ERI, SLU, SFE) / BRA(PAR, RGS, SCA) / PRY(CAU, CAA, COA, PAI) / URY(CAS, CLA, FLO, FLA, MAL, MON, RNO, SJO, SOR)
Paspalum falcatum	ARG(CHA, MIS, SFE) / BRA(PAR, RGS) / PRY(CAA, ITA) / URY(TAC)
Paspalum fasciculatum	ARG(CHA, COS, ERI, FOR, SFE) / BRA(Fuera del área del proyecto) / PRY(APY, CEN, ÑEE, PHA) / URY(MON)
Paspalum filifolium	BRA(PAR, SCA)
Paspalum flaccidum	BRA(PAR, SCA) / PRY(AMA, CAU, CON)
Paspalum flavum	
Paspalum foliiforme	BRA(Fuera del área del proyecto) / PRY(AMA, PHA)
Paspalum gardnerianum	BRA(Fuera del área del proyecto) / PRY(AMA, CON)
Paspalum glabrinode	ARG(CHA, MIS) / BRA(PAR) / PRY(ITA)
Paspalum glaucescens	ARG(COS, FOR, MIS) / BRA(PAR, RGS, SCA) / PRY(APA, AMA, CAU, CAN, CON, COA, GUA, ITA, MIE, PAI, SPE) / URY(RIV, SJO)
Paspalum gracielae	ARG(SAL)
Paspalum guenoarum var. guenoarum	ARG(CHA, COS, ERI, MIS, SFE, TUC) / BRA(PAR, RGS, SCA) / PRY(APA, AMA, CAU, CEN, CON, COA, GUA, MIE, PAI, SPE) / URY(TAC)
Paspalum guenoarum var. rojasii	ARG(CHA, COS, MIS) / BRA(PAR, RGS, SCA) / PRY(AMA, CAU, CEN)
Paspalum haumanii	ARG(BAI, CHA, COS, ERI, MIS, SFE) / BRA(PAR, RGS, SCA) / PRY(APA, AMA, COA, SPE) / URY(FLA, SOR)
Paspalum humboldtianum	ARG(CAT, COR, JUJ, LRI, SAL, SLU, TUC)
Paspalum hyalinum	BRA(PAR) / PRY(AMA)
Paspalum inaequivalve	ARG(BAI, CHA, COS, ERI, FOR, JUJ, MIS, SAL, SFE, TUC) / BRA(PAR, RGS, SCA) / PRY(APA, CAU, CEN, COA, GUA, ITA, PAI, PHA) / URY(PAY)
Paspalum indecorum	ARG(COS, FOR, MIS) / BRA(RGS, SCA) / PRY(GUA) / URY(SAO)
Paspalum intermedium	ARG(BAI, CHA, COS, DFE, ERI, FOR, MIS, SAL, SFE, TUC) / BRA(PAR, RGS, SCA) / PRY(AMA, CAU, CAA, CAN, CEN, CON, COA, GUA, ITA, MIE, PAI, PHA, SPE) / URY(ART)
Paspalum ionanthum	ARG(COS, ERI) / BRA(RGS) / PRY(APY, BOQ, CAU, CAN, CEN, CON, COA, MIE, PAI) / URY(RIV, ROC, TAC)
Paspalum jesuiticum	ARG(MIS) / BRA(PAR, RGS, SCA)
Paspalum juergensii	ARG(COS, MIS) / BRA(PAR, RGS, SCA) / URY(TYT)
Paspalum lachneum	BRA(PAR) / PRY(AMA)
Paspalum lepton	ARG(BAI, CHA, COR, COS, ERI, FOR, SFE) / BRA(RGS, SCA) / PRY(CEN, CON, COA, GUA, MIE, SPE) / URY(CAS, MAL, MON, ROC, SJO, TAC)
Paspalum lilloi	ARG(MIS) / BRA(PAR) / PRY(APA, COA)
Paspalum limbatum	ARG(COS) / PRY(AMA, GUA, SPE)
Paspalum lineare	ARG(CHA) / BRA(PAR) / PRY(AMA, CAN, CON)
Paspalum macranthecium	BRA(Fuera del área del proyecto) / PRY(AMA)
Paspalum maculosum	ARG(COS, MIS) / BRA(PAR, RGS, SCA) / PRY(AMA, CAU, CEN, COA, GUA, MIE, PAI, SPE) / URY(MON, RIV, TAC)
Paspalum malacophyllum	ARG(CAT, CHA, COR, FOR, JUJ, LRI, SAL, SJU, SLU, SDE, TUC) / BRA(PAR) / PRY(APY, AMA, CAU, CEN, CHO, CON, COA, GUA, NAS, PAI, SPE)
Paspalum mandiocanum var. mandiocanum	ARG(MIS, TUC) / BRA(PAR, RGS, SCA) / PRY(APA, CAN, GUA) / URY(MAL)
Paspalum mandiocanum var. subaequiglume	ARG(COS, MIS, TUC) / BRA(PAR, RGS, SCA) / PRY(APA, CAU, CAA, CAN, CEN, COA, GUA, ITA, PAI, SPE)
Paspalum minus	ARG(BAI, COS, ERI) / BRA(PAR, RGS, SCA) / CHL(LLA) / PRY(CEN, COA, PAI) / URY(CAS, MON)
Paspalum modestum	ARG(CHA, COS, ERI, SFE) / BRA(RGS) / PRY(CEN, COA, PAI, PHA) / URY(CLA, RIV)
Paspalum multicaule	PRY(AMA)
Paspalum notatum var. notatum	ARG(BAI, CAT, CHA, COR, COS, DFE, ERI, FOR, JUJ, LPA, MEN, MIS, SAL, SDE, SFE, SLU, TUC) / BRA(PAR, RGS, SCA) / PRY(APY, AMA, BOQ, CAU, CAA, CEN, CON, COA, GUA, ITA, MIE, ÑEE, PAI, PHA) / URY(MAL, MON)
Paspalum notatum var. saurae	ARG(BAI, COS, DFE, ERI, LRI, MIS, SFE) / BRA(PAR, RGS) / PRY(CAA, CEN, COA, ITA, MIE) / URY(MON)
Paspalum nutans	BRA(PAR, SCA)
Paspalum orbiculatum	ARG(COS, ERI, MIS) / BRA(RGS) / PRY(CAA, CEN, COA, ITA, PAI)
Paspalum ovale	ARG(COS, MIS) / BRA(PAR, RGS) / PRY(GUA, ITA, MIE, PAI)
Paspalum palustre	ARG(CHA, COS, FOR) / PRY(CEN, PHA)
Paspalum paniculatum	ARG(CHA, COS, MIS, SAL) / BRA(PAR, RGS, SCA) / PRY(APA, AMA, CAN, CEN, CON, COA, GUA, ITA, MIE, PAI) / URY(ART, RIV)
Paspalum pauciciliatum	ARG(COS, ERI, MIS, SAL, SFE) / BRA(PAR, RGS, SCA) / PRY(APA, AMA, CAU, GUA, MIE, PAI) / URY(ART, SAO)
Paspalum paucifolium	ARG(COS, ERI, MIS) / BRA(RGS) / PRY(AMA, CEN, CON, GUA, PAI) / URY(ART)
Paspalum pectinatum	BRA(PAR, SCA) / PRY(CAN, PAI)
Paspalum pilosum	BRA(PAR)
Paspalum planum	PRY(CAU)
Paspalum plenum	ARG(CHA, COS, FOR, MIS, SAL) / BRA(Fuera del área del proyecto) / PRY(AMA, CAN, CEN, CON, COA, ÑEE, PHA)
Paspalum plicatulum	ARG(BAI, CHA, COR, COS, ERI, FOR, JUJ, LRI, MIS, SAL, SLU, SFE, SDE, TUC) / BRA(PAR, RGS, SCA) / PRY(APA, APY, AMA, CAU, CEN, CON, COA, GUA, ITA, MIE, ÑEE, PAI, PHA, SPE) / URY(MAL, MON, TAC)
Paspalum polyphyllum	ARG(CHA, COS, ERI, MIS, SAL) / BRA(PAR, RGS, SCA) / PRY(APA, AMA, CAU, CAN, CEN, CON, COA, GUA, PAI, SPE) / URY(ART, CLA, PAY, RIV, TAC)
Paspalum procurrens	ARG(SAL)
Paspalum pumilum	ARG(BAI, COS) / BRA(PAR, RGS, SCA) / PRY(CEN, COA) / URY(CAS, MAL, MON)
Paspalum pygmaeum	ARG(CAT, JUJ, SAL, TUC)
Paspalum quadrifarium	ARG(BAI, CHA, COR, COS, ERI, FOR, LPA, MIS, SLU, SFE) / BRA(RGS, SCA) / PRY(CAU, COA, ITA, MIE) / URY(ART, MAL, MON, SJO)
Paspalum quarinii	ARG(CHA, COS, MIS) / BRA(RGS, SCA) / PRY(AMA, CAA, COA, GUA, ITA, MIE, PAI)
Paspalum ramboi	BRA(PAR, RGS, SCA)
Paspalum rawitscheri	BRA(PAR, RGS, SCA)
Paspalum redondense	BRA(PAR)
Paspalum regnellii	ARG(ERI, MIS) / BRA(PAR, SCA) / PRY(APA, CAA, CAN, GUA, ITA, PAI)
Paspalum remotum	ARG(JUJ, SAL, TUC)
Paspalum repandum	BRA(PAR)
Paspalum repens	ARG(BAI, CHA, COS, DFE, ERI, FOR, SFE) / BRA(PAR, RGS) / PRY(APY, AMA, BOQ, CEN, CON, COA, PAI, PHA) / URY(COL, SJO)
Paspalum rufum	ARG(CHA, COS, ERI, FOR, MIS, SAL, SFE) / BRA(RGS) / PRY(CAU, CEN, COA, GUA, ITA, ÑEE, PAI, PHA, SPE) / URY(FLA, PAY, SOR)
Paspalum scrobiculatum	BRA(PAR)
Paspalum simplex	ARG(BAI, CHA, COS, ERI, FOR, JUJ, SAL, SDE, SFE) / BRA(Fuera del área del proyecto) / PRY(APA, APY, BOQ, CAU, CEN, CHO, COA, ITA, MIE, ÑEE, PAI, PHA) / URY(RIV)
Paspalum stagnophilum	ARG(FOR, MIS) / BRA(Fuera del área del proyecto) / PRY(APY, CEN, CON, SPE)
Paspalum stellatum	ARG(CHA, COS, ERI, FOR, MIS) / BRA(PAR, RGS, SCA) / PRY(APY, AMA, CAU, CAA, CEN, CON, COA, GUA, ITA, MIE, PAI) / URY(ART, SAO)
Paspalum telmatum	BRA(Fuera del área del proyecto) / PRY(AMA, CAN)
Paspalum umbrosum	ARG(COS, MIS) / BRA(PAR, SCA) / PRY(APA, CAU, CAA, CEN, COA, GUA, ITA, MIE, PAI, SPE)
Paspalum unispicatum	ARG(BAI, CAT, CHA, COR, COS, ERI, FOR, JUJ, LRI, SAL, SDE, SFE, SLU, TUC) / PRY(APY, BOQ, CON, GUA, PHA) / URY(PAY)
Paspalum urvillei	ARG(BAI, CAT, CHA, COR, COS, DFE, ERI, FOR, JUJ, LPA, LRI, MEN, MIS, SAL, SDE, SFE, SJU, SLU, TUC) / BRA(PAR, RGS, SCA) / CHL(COQ, MAU, BIO, ARA, LLA) / PRY(APA, AMA, CAU, CAA, CAN, CEN, CON, COA, GUA, ITA, MIE, ÑEE, PAI, SPE) / URY(RIV, SAO)
Paspalum usteri	ARG(MIS) / BRA(Fuera del área del proyecto) / PRY(GUA, SPE)
Paspalum vaginatum	ARG(BAI, CAT, CHA, COR, COS, DFE, ERI, FOR, JUJ, LPA, MEN, MIS, RNE, SAL, SJU, SLU, SFE, TUC) / BRA(PAR, RGS, SCA) / CHL(TAR, ANT, ATA, COQ, VAL, MAU, LLA, RME) / PRY(CEN, COA) / URY(MON, SJO, SOR)
Paspalum virgatum	ARG(JUJ, SAL) / BRA(PAR) / PRY(APY, AMA, CEN, CON, PHA)
Paspalum volcanensis	ARG(JUJ)
Paspalum wrightii	ARG(CHA, COS, FOR, SFE) / BRA(Fuera del área del proyecto) / PRY(APY, ÑEE, PHA)
Passiflora actinia	BRA(PAR, RGS, SCA)
Passiflora alata	ARG(MIS) / BRA(PAR, RGS, SCA) / PRY(APA, CAU, CEN, COA)
Passiflora amethystina	ARG(COS, MIS) / BRA(PAR, RGS, SCA) / PRY(APA, APY, CAA, CAN, GUA, ÑEE, PHA, SPE)
Passiflora caerulea	ARG(BAI, CAT, CHA, COR, COS, DFE, ERI, FOR, JUJ, LPA, LRI, MEN, MIS, SAL, SDE, SFE, SJU, SLU, TUC) / BRA(PAR, RGS, SCA) / CHL(BIO, RME) / PRY(APY, BOQ, CAU, CEN, COA, GUA, ITA, MIE, ÑEE, PAI, PHA) / URY(ART, CAS, COL, LAV, MAL, MON, RIV, ROC, SJO, TAC)
Passiflora campanulata	BRA(PAR, SCA)
Passiflora capsularis	ARG(MIS) / BRA(PAR, RGS, SCA) / PRY(APA, AMA, CAA, CEN, CON, COA, GUA, ITA, PAI, SPE)
Passiflora catharinensis	BRA(PAR, SCA)
Passiflora cervii	BRA(PAR, RGS, SCA)
Passiflora chrysophylla	ARG(CAT, CHA, COR, COS, ERI, FOR, JUJ, MIS, SAL, SFE, SDE, TUC) / PRY(APY, APA, AMA, CAU, CAN, CEN, CON, COA, ITA, MIE, ÑEE, PAI, PHA, SPE) / URY(MON, RIV, SAO, TAC)
Passiflora cincinnata	ARG(CHA, COR, FOR, JUJ, SAL) / BRA(Fuera del área del proyecto) / PRY(APY, AMA, BOQ, CEN, CHO, CON, COA, NAS, PAI, PHA, SPE)
Passiflora edulis	ARG(COS, MIS, SAL) / BRA(PAR, RGS, SCA) / PRY(APA, AMA, CAU, CAN, CEN, GUA, ITA, MIE, PAI)
Passiflora eichleriana	BRA(PAR, RGS, SCA) / PRY(CON)
Passiflora elegans	ARG(COS, ERI, MIS) / BRA(RGS, SCA) / URY(SAO)
Passiflora foetida var. foetida	ARG(BAI, CAT, CHA, COR, COS, FOR, JUJ, LRI, MIS, SAL, SDE, SFE, SJU, SLU, TUC) / BRA(PAR, RGS, SCA) / CHL(TAR, LLA) / PRY(APA, APY, AMA, BOQ, CAU, CAA, CAN, CEN, CHO, CON, COA, GUA, ITA, MIE, ÑEE, NAS, PAI, PHA, SPE) / URY(RIV)
Passiflora foetida var. fluminensis	BRA(SCA)
Passiflora giberti	ARG(CHA, COS, ERI, FOR, MIS, SAL) / BRA(PAR) / PRY(APY, CEN, CON, COA, ÑEE, PAI, PHA)
Passiflora haematostigma	BRA(PAR, SCA)
Passiflora jilekii	BRA(PAR, SCA)
Passiflora lepidota	BRA(PAR) / PRY(AMA)
Passiflora loefgrenii	BRA(PAR, SCA)
Passiflora longilobis	BRA(PAR)
Passiflora mendoncaei	BRA(PAR, SCA)
Passiflora miersii	BRA(PAR)
Passiflora misera	ARG(BAI, CHA, COS, ERI, FOR, MIS, SAL, SFE) / BRA(PAR, RGS, SCA) / PRY(APY, AMA, CAU, CEN, CON, COA, GUA, ITA, MIE, ÑEE, PAI, PHA) / URY(SAO)
Passiflora mooreana	ARG(BAI, CHA, COR, FOR, SAL, SDE, SFE, TUC) / PRY(APY, PHA)
Passiflora morifolia	ARG(BAI, CHA, COR, COS, FOR, JUJ, MIS, SAL, SDE, TUC) / BRA(PAR, RGS) / PRY(AMA, CAU, CAA, CAN, GUA, ITA, PAI)
Passiflora oerstedii	PRY(AMA, CAN)
Passiflora organensis	BRA(PAR, RGS, SCA)
Passiflora palmatisecta	ARG(CAT, CHA, COR, FOR, LRI, SAL, SDE, TUC) / PRY(APY, PHA)
Passiflora pinnatistipula	CHL(COQ, VAL, BIO)
Passiflora pohlii	BRA(Fuera del área del proyecto) / PRY(AMA, CON)
Passiflora reitzii	BRA(SCA)
Passiflora rotundifolia	PRY(CAN)
Passiflora setulosa	BRA(PAR)
Passiflora suberosa ssp. litoralis 	ARG(CAT, CHA, COR, COS, ERI, FOR, JUJ, LRI, MIS, SAL, SFE, TUC) / BRA(PAR, RGS, SCA) / PRY(APY, APA, AMA, CAU, CAA, CEN, CON, COA, GUA, MIE, ÑEE, PAI, PHA)
Passiflora tenuifila	ARG(CAT, CHA, COS, JUJ, MIS, SAL, TUC) / BRA(PAR, RGS, SCA) / PRY(APA, CAA, CEN, COA, GUA, ITA, PAI, PHA, SPE)
Passiflora tranversalis	BRA(PAR, RGS, SCA)
Passiflora tricuspis	ARG(MIS) / BRA(PAR, RGS, SCA) / PRY(APY, AMA, CAN, CON, SPE)
Passiflora truncata	BRA(PAR, SCA)
Passiflora tucumanensis	ARG(CAT, CHA, COR, JUJ, LRI, MIS, SAL, SDE, TUC) / PRY(APY, PAI)
Passiflora umbilicata	ARG(CAT, JUJ, LRI, SAL, TUC)
Passiflora urnaefolia	ARG(COS, MIS, SAL, TUC) / BRA(PAR, RGS, SCA) / PRY(PAI)
Passiflora urubiciensis	BRA(RGS, SCA)
Passiflora villosa	BRA(PAR, SCA)
Pastinaca sativa	ARG(BAI, CHU, COR, LPA, LRI, MEN, NEU, RNE, SAL, SJU, SLU, SFE, SDE) / CHL(MAU, BIO, ARA, LLA, AIS, RME) / URY(CAS, MON)
Patosia clandestina	ARG(CAT, JUJ, MEN, NEU, SAL, SJU, TUC) / CHL(ANT, ATA, COQ, VAL, MAU, BIO, ARA, RME)
Paullinia carpopodea	BRA(PAR, SCA)
Paullinia cristata	BRA(PAR, SCA)
Paullinia elegans	ARG(CHA, COS, ERI, FOR, MIS, SFE) / BRA(PAR, RGS, SCA) / PRY(APA, AMA, CAU, CAA, CAN, CEN, COA, GUA, ITA, MIE, ÑEE, PAI, PHA, SPE) / URY(ART, PAY, SAO, SOR)
Paullinia meliifolia	ARG(MIS) / BRA(PAR, RGS, SCA) / PRY(APA, CAU, CAA, GUA, ITA)
Paullinia pinnata	ARG(CHA, COS, FOR, SFE) / BRA(Fuera del área del proyecto) / PRY(APY, APA, CAN, CEN, CON, GUA, MIE, ÑEE, PAI, PHA, SPE)
Paullinia rhomboidea	BRA(PAR)
Paullinia seminuda	BRA(PAR, SCA)
Paullinia spicata	BRA(PAR) / PRY(AMA, SPE)
Paullinia trigonia	BRA(PAR, RGS, SCA)
Pausandra morisiana	BRA(PAR, RGS, SCA)
Pavonia angustipetala	ARG(MIS) / BRA(PAR, RGS, SCA)
Pavonia apiculata	ARG(FOR) / BRA(Fuera del área del proyecto) / PRY(CON)
Pavonia argentina	ARG(CAT, COR, FOR, JUJ, LRI, SAL, SJU, SLU, SDE, TUC) / PRY(APY)
Pavonia aspera	PRY(APA)
Pavonia aurelii	PRY(AMA)
Pavonia aurigloba	ARG(BAI, CAT, COR, COS, ERI, SLU) / BRA(RGS) / URY(CLA, COL, MAL, MON, RIV, SJO, TAC)
Pavonia balansae	BRA(Fuera del área del proyecto) / PRY(APY, CON, PAI)
Pavonia belophylla	BRA(PAR, RGS) / PRY(AMA, CAU, CAN)
Pavonia betonicaefolia	ARG(BAI, CHA, COS, ERI, FOR, MIS, SFE) / BRA(RGS) / PRY(APY, PHA) / URY(CAS, CLA, MON, PAY, SJO, TAC)
Pavonia biflora	BRA(PAR)
Pavonia bullulata	ARG(COS) / BRA(SCA) / PRY(CAU, COA)
Pavonia cancellata	BRA(Fuera del área del proyecto) / PRY(AMA, CAN, CON, SPE)
Pavonia communis	ARG(COS, MIS) / BRA(PAR, RGS, SCA) / PRY(AMA, CAU, CAA, CAN, GUA, PAI) / URY(RIV, TAC)
Pavonia commutata	BRA(PAR, RGS, SCA)
Pavonia cryptica	ARG(COR, COS, ERI, SFE) / BRA(RGS) / URY(COL)
Pavonia cymbalaria	ARG(BAI, COR) / URY(MAL, TYT)
Pavonia distinguenda	ARG(COS, ERI, MIS) / BRA(PAR, RGS, SCA) / URY(CAS, RIV, SJO)
Pavonia dusenii	BRA(PAR, RGS, SCA)
Pavonia eurychlamys	ARG(CAT, JUJ, SAL, TUC)
Pavonia exasperata	BRA(RGS)
Pavonia flavispina	ARG(MIS) / BRA(RGS, SCA)
Pavonia formosa	ARG(SAL)
Pavonia friesii	BRA(RGS, SCA) / URY(CLA, MON, TAC)
Pavonia fruticosa	BRA(PAR) / PRY(CAN)
Pavonia glechomoides	ARG(BAI, CAT, COR, COS, ERI, JUJ, SAL, SLU, TUC) / BRA(RGS) / URY(CAS, CLA, COL, FLA, LAV, MAL, MON, SJO, TAC)
Pavonia glutinosa	ARG(BAI, COS, MIS) / BRA(RGS) / URY(SJO)
Pavonia gracilis	BRA(Fuera del área del proyecto) / PRY(AMA)
Pavonia guerkeana	ARG(COS, MIS) / BRA(PAR, RGS, SCA)
Pavonia hassleriana	PRY(CEN, COA, PAI)
Pavonia hastata	ARG(BAI, CHA, COS, DFE, ERI, FOR, JUJ, MIS, SAL, SFE) / BRA(PAR, RGS) / PRY(CAU, CAA, CAN, COA, GUA, MIE, ÑEE, PAI, SPE) / URY(CLA, COL, MAL, MON, PAY, ROC, SAO, SJO, TAC)
Pavonia hatschbacii	BRA(PAR) / URY(MON)
Pavonia hexaphylla	BRA(Fuera del área del proyecto) / PRY(AMA, CEN, COA)
Pavonia hieronymi	ARG(CAT, COS, FOR, JUJ, LRI, SAL, TUC) / BRA(Fuera del área del proyecto) / PRY(APY, BOQ, CEN, CON, COA, ÑEE, PHA, SPE)
Pavonia hoehnei	BRA(Fuera del área del proyecto) / URY(SJO)
Pavonia horrida	BRA(RGS, SCA)
Pavonia inmaculata	BRA(Fuera del área del proyecto) / PRY(APY)
Pavonia kleinii	BRA(RGS, SCA)
Pavonia lanata	BRA(PAR, RGS, SCA)
Pavonia laxifolia	ARG(MIS) / BRA(PAR)
Pavonia mattogrossensis	BRA(Fuera del área del proyecto) / PRY(CON)
Pavonia missionum	ARG(COS, MIS) / BRA(PAR, RGS, SCA) / PRY(APA, GUA)
Pavonia nana	BRA(RGS, SCA) / URY(DUR, RIV, SAO, TAC)
Pavonia narcissi	ARG(CHA, COS, MIS, SFE) / PRY(CAA, CEN, COA, GUA, MIE, PAI)
Pavonia neei	ARG(FOR) / PRY(PHA)
Pavonia nemoralis	BRA(PAR, RGS, SCA) / PRY(CAU, GUA)
Pavonia opulifolia	ARG(COS, FOR) / BRA(PAR) / PRY(APY, CEN, COA)
Pavonia orientalis	BRA(RGS) / URY(LAV, MAL, ROC, SJO)
Pavonia pabstii	ARG(FOR) / BRA(SCA)
Pavonia patuliloba	ARG(COS, ERI, FOR, SFE) / PRY(APY, CEN, CON, ÑEE)
Pavonia platyloba	BRA(Fuera del área del proyecto) / PRY(APY, CON)
Pavonia psilophylla	ARG(MIS) / BRA(RGS, SCA)
Pavonia pulchra	PRY(APA, AMA, CAU, CAN)
Pavonia ramboi	BRA(RGS)
Pavonia reitzii	BRA(SCA)
Pavonia renifolia	BRA(RGS, SCA)
Pavonia restiaria	ARG(COS, MIS) / BRA(PAR) / PRY(APA)
Pavonia reticulata	BRA(PAR, RGS, SCA) / URY(TAC)
Pavonia revoluta	ARG(BAI, COR, ERI, LRI, SAL, SJU, SLU) / URY(MON)
Pavonia rhodantha	BRA(Fuera del área del proyecto) / PRY(AMA, CAN)
Pavonia rojasii	PRY(AMA)
Pavonia rosengurtii	BRA(RGS) / URY(CLA, ROC, SJO)
Pavonia rubra	ARG(COS, MIS)
Pavonia rupestris	PRY(APY, CEN, COA, PHA)
Pavonia sagittata	BRA(PAR, RGS)
Pavonia salmonea	BRA(RGS, SCA)
Pavonia sapucayensis	ARG(CHA, COS, ERI, FOR) / PRY(GUA, PAI)
Pavonia schiedeana	BRA(PAR, RGS, SCA) / PRY(CAN)
Pavonia schininii	PRY(APA)
Pavonia schrankii	BRA(PAR, SCA)
Pavonia secreta	BRA(RGS)
Pavonia sepium ssp. sepium	ARG(BAI, CAT, CHA, COS, ERI, FOR, JUJ, MIS, SAL, SFE, TUC) / BRA(PAR, RGS, SCA) / PRY(APA, AMA, CAA, CAN, CEN, COA, GUA, ITA, MIE, PAI, SPE) / URY(FLO, FLA, MAL, MON, TYT)
Pavonia sidifolia	ARG(CHA, COS, MIS) / BRA(PAR) / PRY(APY, AMA, CAN, CEN, CON, COA, PAI, PHA, SPE)
Pavonia stenopetala	BRA(PAR, RGS, SCA)
Pavonia subrotunda	ARG(COS, MIS) / BRA(RGS) / PRY(CAA, CEN, ITA, SPE)
Pavonia vannii	PRY(APY, COA)
Pavonia vitifolia	ARG(CHA, COS, FOR, MIS, SFE) / BRA(PAR) / PRY(APY, AMA, CAU, CON, GUA, ÑEE, PAI, SPE)
Pavonia xanthogloea	ARG(BAI, COS, ERI, MIS) / BRA(RGS) / PRY(APA) / URY(COL, TAC)
Pecluma barituensis	ARG(JUJ, SAL)
Pecluma camptophyllaria var. lachnifera	PRY(CAN)
Pecluma chnoophora	BRA(PAR, RGS, SCA) / PRY(COA)
Pecluma choquetangensis	ARG(JUJ)
Pecluma filicula	ARG(COS, JUJ, MIS, SAL) / BRA(PAR, RGS) / PRY(APA, CAA, CAN, PAI) / URY(MAL, ROC)
Pecluma oranensis	ARG(JUJ, SAL)
Pecluma paradiseae	BRA(PAR, RGS, SCA)
Pecluma pectinatiformis	ARG(COS, JUJ, MIS, SAL) / BRA(PAR, RGS, SCA) / PRY(APA)
Pecluma plumula	ARG(JUJ, SAL)
Pecluma recurvata	BRA(PAR, RGS, SCA) / PRY(COA, GUA, PAI)
Pecluma robusta	ARG(COS, MIS) / BRA(PAR, RGS, SCA) / PRY(CAN, SPE)
Pecluma sicca	ARG(COS, MIS) / BRA(PAR, RGS, SCA) / PRY(APA, CAN, GUA) / URY(CLA, RIV)
Pecluma singeri	ARG(MIS) / BRA(PAR, RGS, SCA) / PRY(APA, GUA)
Pecluma truncorum	ARG(MIS) / BRA(PAR, RGS, SCA)
Pecluma venturii	ARG(JUJ, MIS, SAL, TUC) / PRY(CAA, COA, PAI)
Pectis guaranitica	PRY(APY)
Pectis odorata	ARG(CAT, CHA, COR, COS, FOR, JUJ, LRI, SAL, SJU, SLU, SDE) / BRA(Fuera del área del proyecto) / PRY(APY, CON, PHA)
Pectis sessiliflora	ARG(CAT, COR, JUJ, LRI, SAL, SDE, TUC)
Pectis substriata	BRA(Fuera del área del proyecto) / PRY(AMA, CON)
Pectocarya anomala	CHL(TAR)
Pectocarya boliviana	ARG(JUJ, LRI, SAL)
Pectocarya dimorpha	CHL(ANT, ATA, COQ)
Pectocarya linearis	ARG(BAI, CHU, LPA, MEN, NEU, RNE, SCR, TDF) / CHL(ANT, COQ, VAL, LBO, MAU, BIO, AIS, RME)
Pectocarya pusilla	CHL(VAL, LBO)
Pedersenia hassleriana	PRY(AMA, COA)
Pedersenia macrophylla	PRY(APY, AMA, PHA)
Peixotoa catarinensis	BRA(SCA)
Peixotoa floribunda	PRY(APY)
Peixotoa jussieuana	BRA(PAR, SCA)
Peixotoa parviflora	BRA(PAR)
Peixotoa reticulata	BRA(PAR) / PRY(APY, AMA, CAU, CAN, CON, COA, PAI, SPE)
Pelexia albicans	PRY(CAU)
Pelexia collocaliae	PRY(AMA)
Pelexia ekmanii	ARG(CHA, COS, MIS) / BRA(RGS) / PRY(AMA, CEN)
Pelexia gracilis	BRA(RGS)
Pelexia incurvidens	BRA(RGS)
Pelexia laxa	ARG(MIS)
Pelexia lindmaniana	ARG(CHA) / BRA(PAR, RGS)
Pelexia lindmanii	ARG(CHA, COS, ERI, MIS) / BRA(PAR, RGS) / PRY(SPE)
Pelexia loefgrenii	BRA(SCA)
Pelexia macropoda	BRA(PAR, RGS, SCA)
Pelexia novofriburgensis	ARG(JUJ, MIS, TUC) / BRA(PAR, RGS, SCA)
Pelexia oestrifera	BRA(PAR, RGS)
Pelexia orobanchoides	BRA(PAR)
Pelexia orthosepala	BRA(PAR)
Pelexia ovatifolia	ARG(SAL, TUC)
Pelexia paludosa	ARG(CHA, COS)
Pelexia polyantha	BRA(SCA)
Pelexia pterygantha	BRA(PAR, RGS, SCA)
Pelexia robusta	BRA(PAR)
Pelexia tamanduensis	BRA(PAR)
Pelexia ventricosa	PRY(CAU, CAN)
Pelexia viridis	BRA(PAR)
Pellaea myrtillifolia	CHL(COQ, VAL, LBO, RME)
Pellaea ovata	ARG(CAT, COR, JUJ, LRI, SAL, TUC)
Pellaea sagittata	ARG(SAL)
Pellaea ternifolia ssp. weddelliana	ARG(SAL)
Pellaea ternifolia	ARG(BAI, CAT, CHA, COR, JUJ, LPA, LRI, MEN, SAL, SJU, SLU, SDE, TUC) / CHL(TAR, ANT, VAL, LBO, BIO, ARA, LLA)
Pelletiera verna	ARG(BAI, CHU, COR, MIS, RNE) / CHL(VAL, LBO, BIO, LLA, RME) / URY(CAS, MON, SOR)
Peltaea edouardii	BRA(PAR, RGS, SCA) / PRY(APA, AMA, CAU, CON, SPE)
Peltaea lasiantha	BRA(PAR)
Peltaea obsita	BRA(PAR) / PRY(AMA, CAN)
Peltaea polymorpha	BRA(PAR, SCA) / PRY(APA)
Peltaea speciosa	BRA(PAR)
Peltastes macrocalyx	PRY(AMA)
Peltastes peltatus	ARG(MIS, SAL) / BRA(PAR, RGS, SCA) / PRY(APA, CAU, ITA)
Peltophorum dubium	ARG(CHA, COS, ERI, FOR, MIS, SFE) / BRA(PAR, RGS, SCA) / PRY(APA, AMA, CAU, CAA, CAN, COA, GUA, ITA, ÑEE, PAI) / URY(ART, MON, RNO, SAO)
Peltophyllum luteum	ARG(COS, MIS) / BRA(Fuera del área del proyecto) / PRY(APA, CAA)
Pennellia boliviensis	ARG(COR, JUJ, SAL, TUC)
Pennellia brachycarpa	ARG(JUJ)
Pennellia lechleri	ARG(CHU, NEU, RNE) / CHL(LBO, BIO, ARA, RME)
Pennellia parvifolia	ARG(CHU, NEU) / CHL(LBO, MAU, BIO, RME)
Peperomia aceroana	ARG(CHA, COS, FOR, JUJ, MIS, SAL, SFE) / PRY(APY, ÑEE, PHA)
Peperomia alata	BRA(PAR, SCA) / PRY(APA)
Peperomia aldrinii	ARG(SAL)
Peperomia arifolia	ARG(MIS) / BRA(PAR, SCA) / PRY(CAN)
Peperomia armondii	ARG(MIS) / BRA(PAR, SCA)
Peperomia armstrongii	ARG(JUJ, SAL)
Peperomia augescens	BRA(PAR)
Peperomia balansana	ARG(COS, FOR, MIS) / BRA(RGS, SCA) / PRY(APA, CAA, GUA)
Peperomia barbarana	ARG(CHA, COS, FOR, MIS) / BRA(PAR) / PRY(APA, CAA, CAN, GUA, MIE)
Peperomia berteroana	CHL(JFE)
Peperomia blanda var. langsdorffii	BRA(RGS)
Peperomia brasiliensis	BRA(SCA)
Peperomia calophylla	BRA(PAR)
Peperomia castelosensis	BRA(RGS, SCA)
Peperomia catharinae	ARG(BAI, ERI, MIS, SFE) / BRA(PAR, RGS, SCA) / URY(CLA, LAV, MAL, RIV, ROC, TYT)
Peperomia caulibarbis	BRA(PAR, RGS, SCA)
Peperomia circinnata var. circinnata	ARG(COS, FOR, MIS, SAL) / BRA(PAR, RGS, SCA) / PRY(APA, CAA, CAN, GUA)
Peperomia circinnata var. orbicularis	BRA(SCA)
Peperomia clivicola	BRA(PAR, SCA)
Peperomia collinsii	ARG(JUJ, SAL, TUC)
Peperomia comarapana f. comarapana	ARG(BAI, CHA, COS, ERI, JUJ, SFE) / PRY(APY, BOQ) / URY(ART, PAY, RNO)
Peperomia coquimbensis	CHL(COQ)
Peperomia corcovadensis f. latifolia	BRA(SCA)
Peperomia corcovadensis f. longifolia	BRA(PAR, SCA)
Peperomia corcovadensis f. corcovadensis	ARG(MIS) / BRA(PAR, RGS, SCA)
Peperomia cordigera	BRA(PAR)
Peperomia crinicaulis	BRA(PAR)
Peperomia crystallina	ARG(JUJ, TUC) / BRA(RGS, SCA)
Peperomia dahlstedtii	BRA(PAR)
Peperomia delicatula	ARG(MIS, SAL) / BRA(PAR, RGS, SCA)
Peperomia diaphanoides	ARG(MIS) / BRA(PAR, RGS)
Peperomia doellii	CHL(ANT, ATA)
Peperomia duartei	BRA(PAR)
Peperomia elongata	BRA(PAR, SCA)
Peperomia emarginella	BRA(PAR)
Peperomia fernandeziana	CHL(COQ, VAL, LLA, JFE)
Peperomia galioides	BRA(PAR, RGS, SCA)
Peperomia glabella var. glabella	BRA(PAR, RGS, SCA)
Peperomia glabella var. nervulosa	BRA(PAR, SCA)
Peperomia glabella var. nigropunctata	BRA(SCA)
Peperomia glaziouii	BRA(PAR, SCA)
Peperomia gracilicaulis	BRA(PAR)
Peperomia hadrostachya	ARG(JUJ, SAL)
Peperomia hernandiifolia	BRA(PAR)
Peperomia hilariana	BRA(PAR, RGS, SCA)
Peperomia hispidula var. sellowiana	ARG(MIS) / BRA(PAR, RGS, SCA) / URY(TAC)
Peperomia hispidula var. hispidula	BRA(PAR) / URY(TAC)
Peperomia hispiduliformis	ARG(CAT, JUJ, SAL, TUC)
Peperomia ibiramana	BRA(PAR, SCA)
Peperomia inaequalilimba	ARG(JUJ, SAL, TUC)
Peperomia increscens	ARG(CAT, CHA, COR, COS, ERI, FOR, JUJ, MIS, SAL, SFE, TUC) / BRA(PAR, RGS, SCA) / PRY(APY, BOQ, COA, GUA, ÑEE, PHA) / URY(RIV)
Peperomia lorentzii	ARG(CAT, JUJ, SAL, TUC)
Peperomia loxensis	BRA(SCA)
Peperomia lyman-smithii var. macrophylla	BRA(RGS)
Peperomia lyman-smithii var. lyman-smithii	BRA(RGS, SCA)
Peperomia macrostachya	BRA(PAR)
Peperomia margaritifera	CHL(JFE)
Peperomia martiana	ARG(MIS) / BRA(PAR, SCA) / PRY(APA)
Peperomia megapotamica	BRA(RGS, SCA)
Peperomia morungavana	BRA(PAR)
Peperomia nitida	ARG(COS, MIS) / BRA(PAR)
Peperomia nudifolia	BRA(SCA)
Peperomia nummularioides	CHL(COQ, LLA, AIS)
Peperomia obtusifolia	BRA(PAR)
Peperomia ouabianae	BRA(PAR)
Peperomia parvifolia	ARG(JUJ, SAL, TUC)
Peperomia pellucida var. argentina	ARG(SAL)
Peperomia pellucida var. pellucida	BRA(PAR) / PRY(AMA, CAA)
Peperomia pereskiifolia	BRA(PAR, RGS, SCA) / PRY(CAN) / URY(ROC)
Peperomia perlongicaulis	BRA(PAR)
Peperomia peruviana	ARG(CAT, JUJ, LRI, SAL, TUC)
Peperomia pseudobcordata	BRA(SCA)
Peperomia pseudoestrellensis	BRA(PAR, SCA)
Peperomia psilostachya var. angustifolia	BRA(PAR) / PRY(CAN)
Peperomia psilostachya var. psilostachya	ARG(COS, MIS) / BRA(PAR, RGS) / PRY(CAN, GUA, PAI) / URY(CLA, RIV)
Peperomia ramboi	BRA(RGS, SCA)
Peperomia renifolia	BRA(PAR, SCA)
Peperomia retivenulosa	BRA(PAR)
Peperomia rizzinii	BRA(PAR)
Peperomia rotundifolia f. obcordata	BRA(PAR, SCA)
Peperomia rotundifolia f. rotundifolia	ARG(MIS) / BRA(PAR, RGS, SCA) / PRY(CAN)
Peperomia rubricaulis	ARG(MIS) / BRA(PAR) / PRY(CAN)
Peperomia rupestris var. rupestris	BRA(PAR, SCA)
Peperomia rupestris var. cordifolia	BRA(PAR)
Peperomia santaelisae	ARG(BAI, CHA, COR, ERI, FOR, JUJ, SAL, SDE, TUC) / PRY(PHA)
Peperomia schenkiana	BRA(SCA)
Peperomia schwackei	BRA(PAR, SCA)
Peperomia skottsbergii	CHL(JFE)
Peperomia subemarginata	BRA(PAR)
Peperomia subretusa	BRA(PAR, RGS)
Peperomia tenella	BRA(SCA)
Peperomia tetraphylla var. valantoides	BRA(SCA)
Peperomia tetraphylla var. americana	BRA(RGS, SCA)
Peperomia tetraphylla var. tetraphylla	ARG(CAT, JUJ, MIS, SAL, TUC) / BRA(PAR, RGS, SCA) / PRY(APA, CAA) / URY(CLA, MAL, RIV, ROC, TYT)
Peperomia tetraphylla var. tenera	BRA(PAR, RGS, SCA)
Peperomia theodori	ARG(JUJ, SAL, TUC)
Peperomia tominana	ARG(CAT, JUJ, SAL, TUC)
Peperomia transparens	BRA(SCA)
Peperomia trinervis var. minor	BRA(RGS)
Peperomia trineura	BRA(PAR, RGS, SCA)
Peperomia trineuroides	ARG(MIS) / BRA(PAR, RGS, SCA) / PRY(PHA) / URY(CLA, RIV, ROC, TAC, TYT)
Peperomia urocarpa	ARG(COS, MIS) / BRA(PAR, RGS, SCA) / PRY(CAA, CAN, MIE)
Peperomia velloziana	BRA(PAR)
Peplonia axillaris	BRA(PAR, RGS, SCA)
Peplonia hatschbachii	BRA(PAR, SCA)
Pera ferruginea	BRA(SCA)
Pera glabrata	BRA(PAR, RGS, SCA)
Pera obovata	BRA(PAR, SCA)
Peregrina linearifolia	ARG(MIS) / BRA(PAR) / PRY(AMA, CAU, CAN, SPE)
Pereskia aculeata	ARG(COS, ERI, MIS) / BRA(PAR, SCA) / PRY(APA, CAU, CAA, CAN, CEN, GUA, ITA, PAI)
Pereskia nemorosa	ARG(COS, ERI, MIS) / BRA(RGS) / PRY(APY, APA, AMA, CEN, COA, PAI, SPE) / URY(ART)
Pereskia sacharosa	ARG(CAT, CHA, FOR, JUJ, SAL, TUC) / PRY(APY)
Perezia atacamensis	ARG(CAT, JUJ, LRI, SAL, SJU) / CHL(TAR, ANT, ATA, COQ)
Perezia bellidifolia	ARG(CHU, NEU, RNE)
Perezia burkartii	ARG(JUJ)
Perezia calophylla	ARG(NEU, RNE) / CHL(LLA)
Perezia capito	ARG(NEU) / CHL(MAU, BIO)
Perezia carthamoides	ARG(MEN, SJU) / CHL(COQ, VAL, LBO, MAU, RME)
Perezia catharinensis	BRA(RGS, SCA)
Perezia ciliosa	ARG(JUJ, TUC) / CHL(TAR, ANT)
Perezia delicata	ARG(NEU, RNE)
Perezia dentata	ARG(JUJ, SAL)
Perezia eryngioides	BRA(SCA)
Perezia fonkii	ARG(CHU, NEU, RNE) / CHL(ARA, LLA)
Perezia kingii	ARG(COS, ERI, LPA) / URY(CAS, FLA, MON, SOR)
Perezia lactucoides	ARG(CHU, NEU, RNE, SCR, TDF) / CHL(ARA, LLA, AIS, MAG)
Perezia linearis	ARG(CHU, NEU, RNE, SCR) / CHL(LBO, MAU, BIO, ARA, AIS, MAG)
Perezia lyrata	ARG(NEU, RNE) / CHL(LBO, MAU, BIO, ARA, LLA)
Perezia magellanica	ARG(SCR, TDF) / CHL(LLA, AIS, MAG)
Perezia megalantha	ARG(SCR) / CHL(MAG)
Perezia multiflora ssp. sonchifolia	ARG(BAI, COS, LPA, RNE) / BRA(RGS, SCA) / URY(CAS, DUR, LAV, MAL, MON, RNO, TAC)
Perezia multiflora ssp. multiflora	ARG(CAT, COR, JUJ, MEN, SAL, SJU, SLU, TUC) / CHL(TAR)
Perezia nutans	ARG(NEU) / CHL(VAL, LBO, MAU, BIO, ARA, RME)
Perezia pedicularidifolia	ARG(CHU, NEU, RNE) / CHL(MAU, BIO, ARA, LLA, AIS)
Perezia pilifera	ARG(CHU, MEN, NEU, RNE, SJU, SCR, TDF) / CHL(COQ, VAL, LBO, MAU, BIO, ARA, AIS, MAG, RME)
Perezia pinnatifida	ARG(CAT, JUJ, SAL, TUC) / CHL(TAR)
Perezia poeppigii	CHL(COQ, VAL, LBO, MAU, RME)
Perezia prenanthoides	ARG(CHU, NEU, RNE) / CHL(BIO, ARA, LLA)
Perezia pungens	ARG(CAT, JUJ, LRI, MEN, SAL, SJU, SLU, TUC) / CHL(TAR, ANT, ATA)
Perezia recurvata ssp. beckii	ARG(BAI, CHU, MEN, NEU, RNE, SCR) / CHL(MAU)
Perezia recurvata ssp. recurvata	ARG(BAI, CHU, MEN, NEU, RNE, SCR, SJU, TDF) / CHL(LBO, MAU, BIO, ARA, LLA, AIS, MAG, RME)
Perezia recurvata ssp. triceps	ARG(NEU, RNE) / CHL(ARA)
Perezia spathulata	ARG(NEU) / CHL(BIO, ARA, LLA)
Perezia squarrosa ssp. cubataensis	BRA(PAR, RGS)
Perezia squarrosa ssp. squarrosa	ARG(COS, MIS) / BRA(PAR, RGS, SCA) / PRY(CAU, GUA, PAI) / URY(CAS, MAL)
Perezia volcanensis	ARG(JUJ)
Periandra mediterranea	BRA(PAR)
Perianthomega vellozoi	BRA(Fuera del área del proyecto) / PRY(APY, CEN, CON)
Peritassa campestris	BRA(PAR) / PRY(APA, AMA, CAU, CAN, CON, MIE, SPE)
Peritassa hatschbachii	BRA(PAR, RGS, SCA)
Perityle emoryi	CHL(TAR, ANT, ATA, COQ)
Pernettya prostrata	ARG(JUJ, SAL)
Persea alba	BRA(PAR, SCA)
Persea americana	ARG(SAL)
Persea lingue	ARG(CHU) / CHL(VAL, LBO, MAU, BIO, ARA, LLA, RME)
Persea pyrifolia	BRA(PAR, SCA)
Persea venosa	ARG(COS) / BRA(PAR, RGS, SCA)
Persea willdenovii	BRA(PAR, SCA)
Petalostelma robertii	ARG(FOR, SAL) / BRA(Fuera del área del proyecto) / PRY(APY)
Petalostelma sarcostemma	ARG(JUJ, SAL, TUC)
Petiveria alliacea var. alliacea	ARG(CHA, COS, ERI, FOR, JUJ, MIS, SAL, SDE, SFE, TUC) / BRA(PAR, RGS, SCA) / PRY(APA, APY, BOQ, CAU, CAA, CAN, CEN, COA, GUA, ÑEE, PAI, PHA) / URY(ART, SAO)
Petiveria alliacea var. tetrandra	ARG(COS, MIS) / BRA(PAR, RGS) / PRY(COA, PAI, PHA)
Petrea volubilis	ARG(JUJ) / BRA(PAR, SCA) / PRY(AMA)
Petroravenia eseptata	ARG(JUJ, SAL)
Petroravenia friesii	ARG(SAL) / CHL(TAR, ANT)
Petroravenia werdermannii	ARG(JUJ, LRI, SAL, SJU) / CHL(ATA)
Petrorhagia dubia	CHL(VAL, LBO, MAU, BIO, ARA, MAG)
Petrorhagia nanteuilii	ARG(BAI, LPA, NEU, RNE)
Petrorhagia prolifera	CHL(BIO)
Petroselinum crispum	ARG(COS, LPA, SCR) / BRA(SCA) / CHL(JFE)
Petunia altiplana	BRA(RGS, SCA)
Petunia axillaris ssp. subandina	ARG(CAT, COR, JUJ, LPA, LRI, MEN, SAL, SDE, SJU, SLU, TUC)
Petunia axillaris ssp. parodii	ARG(BAI, CHA, COR, COS, ERI, FOR, SFE) / BRA(RGS) / PRY(APY) / URY(ART, COL, DUR, FLO, PAY, RNO, SAO, SOR, TAC)
Petunia axillaris ssp. axillaris	ARG(BAI, CAT, LPA) / BRA(RGS) / URY(CAS, CLA, COL, DUR, FLO, FLA, LAV, MAL, MON, PAY, ROC, SJO, SOR, TYT)
Petunia bajeensis	BRA(RGS)
Petunia bonjardinensis	BRA(RGS, SCA)
Petunia exserta	BRA(RGS)
Petunia inflata	ARG(CHA, COS, ERI, FOR, MIS, SFE) / BRA(RGS, SCA) / PRY(CEN, COA, ITA, ÑEE)
Petunia integrifolia ssp. integrifolia	ARG(COS, ERI) / BRA(PAR, RGS, SCA) / PRY(APY, COA) / URY(RNO, ROC)
Petunia integrifolia ssp. depauperata	BRA(RGS, SCA) / URY(ROC)
Petunia interior	ARG(MIS) / BRA(RGS, SCA)
Petunia littoralis	BRA(SCA)
Petunia occidentalis	ARG(JUJ, SAL, TUC)
Petunia patagonica	ARG(CHU, SCR)
Petunia reitzii	BRA(SCA)
Petunia riograndensis	BRA(RGS)
Petunia saxicola	BRA(SCA)
Petunia scheideana	ARG(MIS) / BRA(PAR, SCA)
Petunia secreta	BRA(RGS)
Peumus boldus	CHL(COQ, VAL, LBO, MAU, BIO, ARA, LLA)
Pfaffia denudata	BRA(PAR)
Pfaffia fruticulosa var. diffusa	PRY(APY, AMA, CON, SPE)
Pfaffia fruticulosa	PRY(APY)
Pfaffia glabrata	ARG(MIS, SAL) / BRA(PAR, SCA) / PRY(AMA, CEN)
Pfaffia gleasonii	ARG(MIS) / PRY(AMA, GUA, PAI)
Pfaffia glomerata	ARG(BAI, CAT, COS, ERI, FOR, JUJ, MIS, SAL, SFE, SDE, TUC) / BRA(SCA) / PRY(APA, APY, BOQ, CAA, CAN, CEN, CON, COA, GUA, ÑEE, PAI, PHA, SPE) / URY(SJO)
Pfaffia gnaphaloides	ARG(BAI, CAT, CHA, COR, COS, ERI, JUJ, LPA, MIS, SAL, SLU, SFE, SDE, TUC) / BRA(PAR, RGS, SCA) / PRY(AMA, CAU, ÑEE) / URY(ART, LAV, MAL, MON, SJO, TAC)
Pfaffia helichrysoides	ARG(MIS) / PRY(AMA, CAU, GUA)
Pfaffia jubata	BRA(PAR)
Pfaffia ninae	URY(ART)
Pfaffia nudicaulis	PRY(AMA)
Pfaffia tuberosa f. tuberosa	ARG(BAI, CHA, COS, ERI, FOR, MIS, SFE) / BRA(PAR, RGS, SCA) / PRY(APA, AMA, CAU, CAA, CAN, CEN, CON, COA, GUA, ITA, MIE, ÑEE, PAI, PHA, SPE) / URY(MAL, TAC)
Pfaffia tuberosa f. rubella	ARG(COS, ERI) / URY(ART, SAO)
Pfeiffera ianthothele	ARG(CAT, JUJ, SAL, TUC)
Phacelia artemisioides	ARG(BAI, CAT, CHU, COR, ERI, LPA, LRI, MEN, NEU, RNE, SAL, SCR, SDE, SFE, SJU, SLU, TUC) / URY(MAL, MON, SJO)
Phacelia brachyantha	ARG(CAT, CHU, JUJ, LRI, MEN, NEU, SAL, SJU, SCR, TDF, TUC) / CHL(COQ, VAL, LBO, MAG, RME)
Phacelia cumingii	ARG(CAT, CHU, LRI, MEN, NEU, SAL, SCR, SJU) / CHL(TAR, ANT, ATA, COQ, VAL, LBO, RME)
Phacelia nana	ARG(CAT, CHU, JUJ, LRI, MEN, SAL, TUC) / CHL(TAR, ANT)
Phacelia pinnatifida	ARG(CAT, COR, JUJ, LRI, NEU, SAL, SCR, SDE, SJU, SLU, TUC) / CHL(TAR, ANT, ATA, COQ)
Phacelia sanzinii	ARG(CAT, LRI, MEN, SJU)
Phacelia secunda var. pinnata	ARG(CAT, CHU, COR, JUJ, LRI, MEN, NEU, RNE, SAL, SCR, SJU, TUC) / CHL(MAU, MAG)
Phacelia secunda var. secunda	ARG(CAT, CHU, COR, JUJ, LRI, MEN, NEU, RNE, SAL, SCR, SJU, TDF, TUC) / CHL(TAR, COQ, VAL, LBO, MAU, BIO, ARA, LLA, AIS, MAG, RME)
Phacelia setigera var. humahuaquense	ARG(CAT, JUJ, LRI, SAL, SJU, TUC)
Phacelia setigera var. setigera	ARG(CAT, CHU, JUJ, LRI, MEN, NEU, SAL, SJU, SDE) / CHL(TAR, ANT, ATA)
Phacelia sinuata	ARG(CHU, LPA, LRI, MEN, NEU, RNE, SAL, SJU) / CHL(COQ)
Phaeostemma hatschbachii	BRA(PAR)
Phaeostemma kelleri	ARG(MIS) / BRA(Fuera del área del proyecto)
Phalaris amethystina	CHL(COQ, VAL, LBO, MAU, BIO, ARA, RME, JFE)
Phalaris angusta	ARG(BAI, CAT, CHA, CHU, COR, COS, DFE, ERI, JUJ, LPA, LRI, MIS, RNE, SLU, SFE, SDE, TUC) / BRA(PAR, RGS, SCA) / CHL(VAL, BIO, ARA, LLA, JFE) / PRY(GUA, ITA, PHA) / URY(MAL)
Phalaris aquatica	ARG(BAI, COR, COS, ERI, LPA, SFE) / BRA(RGS) / CHL(TAR, COQ, VAL, LBO, BIO, ARA, RME) / URY(MON)
Phalaris arundinacea	ARG(BAI) / CHL(ARA, MAG) / URY(MON)
Phalaris canariensis	ARG(BAI, COR, DFE, ERI, LPA, SCR, SFE, TDF, TUC) / BRA(PAR, RGS, SCA) / CHL(ANT, ATA, VAL, MAU, BIO, ARA, LLA, MAG, RME) / URY(MON)
Phalaris caroliniana	CHL(VAL)
Phalaris coerulescens	ARG(BAI, ERI) / CHL(BIO) / URY(COL)
Phalaris minor	ARG(BAI, ERI, SFE) / CHL(COQ, BIO)
Phalaris paradoxa	ARG(BAI, COS, ERI, SFE) / CHL(LBO) / URY(MON)
Phalaris platensis	ARG(BAI, ERI, LPA, SFE) / URY(MAL)
Pharus lappulaceus	ARG(CHA, COS, FOR, JUJ, MIS, SAL, SFE, TUC) / BRA(PAR, RGS, SCA) / PRY(APA, CAA, CAN, ÑEE, PAI) / URY(ART, ROC)
Pharus latifolius	BRA(PAR, SCA)
Phaseolus augusti	ARG(JUJ, SAL, TUC)
Phaseolus lunatus var. sylvester	ARG(CHA, JUJ, MIS, SAL)
Phaseolus vulgaris var. aborigineus	ARG(CAT, COR, JUJ, SAL, SLU, TUC)
Phemeranthus punae	ARG(CAT, JUJ, TUC)
Phenax laevigatus	ARG(CAT, COR, JUJ, SAL, TUC)
Phenax sonneratii	ARG(MIS) / BRA(PAR, RGS, SCA) / PRY(APA, CAA)
Philesia magellanica	ARG(SCR, TDF) / CHL(LLA, AIS, MAG)
Philibertia affinis	ARG(SAL)
Philibertia barbata	ARG(JUJ, SAL, TUC)
Philibertia bicornuta	ARG(JUJ, SAL, TUC)
Philibertia boliviana	ARG(CAT, SAL, TUC)
Philibertia boliviensis	ARG(SAL)
Philibertia campanulata	ARG(JUJ, TUC)
Philibertia candolleana	ARG(BAI, CAT, CHU, LPA, LRI, MEN, NEU, RNE, SCR, SJU, SLU, TUC) / CHL(RME)
Philibertia castillonii	ARG(JUJ)
Philibertia cionophora	ARG(JUJ, TUC)
Philibertia coalita	ARG(CAT, TUC)
Philibertia discolor	ARG(SAL)
Philibertia gilliesii	ARG(BAI, CAT, CHA, CHU, COR, COS, ERI, FOR, JUJ, LRI, MEN, RNE, SAL, SDE, SJU, SLU, TUC)
Philibertia latiflora	ARG(CAT, JUJ, SAL, TUC)
Philibertia longistyla	ARG(SAL)
Philibertia lysimachioides	ARG(JUJ, SAL)
Philibertia micrantha	ARG(JUJ, SAL)
Philibertia mitophora	ARG(TUC)
Philibertia multiflora	ARG(SAL)
Philibertia nivea	ARG(CAT, SAL, TUC)
Philibertia parviflora	ARG(CAT, JUJ, SAL)
Philibertia picta	ARG(CAT, JUJ, LRI, SAL, TUC)
Philibertia solanoides	CHL(TAR, ANT)
Philibertia speciosa	ARG(JUJ, SAL, TUC)
Philibertia stipitata	ARG(CAT, JUJ, SAL, TUC)
Philibertia suberecta	ARG(JUJ, TUC)
Philibertia subnivea	ARG(SAL)
Philibertia tomentosa	ARG(CAT, COR, JUJ, LRI, SAL, SDE, SLU, TUC)
Philibertia tubata	ARG(CAT, TUC)
Philibertia tucumanensis	ARG(TUC)
Philibertia volcanensis	ARG(JUJ)
Philippiella patagonica	ARG(NEU, SCR) / CHL(MAG)
Philodendron appendiculatum	BRA(PAR, RGS, SCA)
Philodendron bipinnatifidum	ARG(COS, MIS) / BRA(PAR, RGS, SCA) / PRY(APA, AMA, CAU, CAA, CAN, CEN, COA, GUA, PAI)
Philodendron corcovadense	BRA(PAR, SCA)
Philodendron cordatum	BRA(PAR, SCA)
Philodendron crassinervium	BRA(PAR, SCA)
Philodendron imbe	ARG(MIS) / BRA(RGS, SCA)
Philodendron loefgrenii	BRA(PAR, SCA)
Philodendron lundii	BRA(Desconocida)
Philodendron martianum	BRA(PAR, SCA)
Philodendron meridionale	BRA(PAR, SCA)
Philodendron missionum	ARG(MIS) / BRA(RGS, SCA) / PRY(AMA)
Philodendron obliquifolium	BRA(PAR)
Philodendron propinquum	BRA(PAR, SCA)
Philodendron renauxii	BRA(SCA)
Philodendron rheophyticum	BRA(PAR)
Philodendron tweedianum	ARG(CHA, COS, ERI) / BRA(PAR) / PRY(APY, AMA, CAU, CEN, COA, GUA, ITA, ÑEE, PAI, SPE) / URY(COL, MON, RNO)
Philodendron undulatum	ARG(COS, ERI, MIS) / BRA(Fuera del área del proyecto) / PRY(AMA, CAU, CEN, CON, COA, GUA, PAI, SPE)
Philyra brasiliensis	ARG(COS, FOR, MIS) / BRA(Fuera del área del proyecto) / PRY(CEN, COA, ÑEE, PAI)
Phippsia wilczekii	ARG(MEN)
Phlebodium areolatum	ARG(CAT, COR, JUJ, MIS, SAL, TUC) / BRA(PAR, SCA) / PRY(COA)
Phlebodium aureum	ARG(COS, JUJ)
Phlebodium decumanum	BRA(Fuera del área del proyecto) / PRY(AMA, CAN, CON)
Phlebolobium maclovianum	ARG(TDF)
Phlegmariurus acerosus	ARG(MIS) / BRA(PAR, SCA)
Phlegmariurus heterocarpon	ARG(MIS) / BRA(PAR, RGS, SCA)
Phlegmariurus mandiocanus	ARG(MIS, SAL, TUC) / BRA(PAR, RGS, SCA) / PRY(CAN)
Phlegmariurus phylicifolius	ARG(JUJ, SAL, TUC)
Phlegmariurus reflexus	ARG(JUJ, SAL) / BRA(PAR, RGS, SCA)
Phlegmariurus saururus	ARG(BAI, CAT, COR, JUJ, SAL, SLU, TUC)
Phlegmariurus sotae	ARG(JUJ, SAL, TUC)
Phleum alpinum	ARG(CHU, MEN, NEU, RNE, SJU, SCR, SFE, TDF, TUC) / CHL(COQ, VAL, MAU, BIO, ARA, LLA, AIS, MAG, RME)
Phleum pratense	ARG(BAI, CHU, DFE, NEU, RNE, SCR, TDF) / BRA(RGS) / CHL(MAU, BIO, ARA, LLA, MAG, RME)
Phoenix canariensis	ARG(BAI, LPA, SDE)
Phoradendron affine	ARG(CHA) / BRA(SCA) / PRY(GUA, SPE)
Phoradendron argentinum	ARG(CAT, CHA, COR, COS, FOR, JUJ, LRI, SAL, SFE, SDE, TUC) / BRA(RGS) / PRY(APY, CEN, CON, PHA) / URY(RNO)
Phoradendron bathyoryctum	ARG(CAT, CHA, COR, COS, FOR, JUJ, LRI, SAL, SJU, SFE, SDE, TUC) / BRA(PAR, RGS, SCA) / PRY(APY, CEN, GUA, ÑEE, PAI, PHA)
Phoradendron berteroanum	BRA(PAR, RGS)
Phoradendron chrysocladon	BRA(PAR)
Phoradendron congestum	BRA(SCA)
Phoradendron coriaceum	ARG(MIS) / BRA(PAR, RGS)
Phoradendron craspedophyllum	BRA(PAR, RGS, SCA)
Phoradendron crassifolium	BRA(PAR, RGS, SCA) / PRY(AMA, CAU, CAN, CEN, COA, GUA, PAI)
Phoradendron dipterum	ARG(CAT, COS, MIS) / BRA(PAR, RGS) / PRY(APY, CEN, PAI)
Phoradendron ensifolium	BRA(PAR, RGS, SCA)
Phoradendron falcifrons	ARG(COS, ERI, MIS, SAL, TUC) / BRA(PAR, RGS) / PRY(APY, GUA, PAI) / URY(LAV, TAC)
Phoradendron habrostachyum	BRA(RGS)
Phoradendron hexastichum	BRA(SCA)
Phoradendron holoxanthum	BRA(RGS)
Phoradendron inaequidentatum	BRA(RGS)
Phoradendron interruptum	ARG(SAL) / BRA(PAR, SCA)
Phoradendron liga	ARG(CAT, CHA, COR, COS, ERI, FOR, JUJ, LRI, MIS, SAL, SDE, SFE, SJU, SLU, TUC) / BRA(PAR, RGS) / PRY(APY, CEN, CHO, MIE, ÑEE, PAI, PHA, SPE)
Phoradendron lindemanii	BRA(PAR)
Phoradendron linearifolium	BRA(PAR, RGS, SCA) / PRY(APY)
Phoradendron mucronatum	ARG(COS, JUJ, SAL, SDE) / BRA(PAR) / PRY(AMA, CAU, CEN, COA, PAI, PHA, SPE)
Phoradendron nitidum	BRA(RGS)
Phoradendron obtusissimum	ARG(CHA, COS, FOR, SFE, TUC) / BRA(PAR) / PRY(APY, CEN, COA, GUA, PAI, PHA)
Phoradendron pachyneuron	BRA(PAR)
Phoradendron paraguari	ARG(CHA, COR) / BRA(RGS) / PRY(CEN, GUA, PAI)
Phoradendron pellucidulum	BRA(PAR, SCA) / PRY(CEN)
Phoradendron perrottetii	BRA(PAR, SCA)
Phoradendron piperoides	ARG(CHA, COS, MIS) / BRA(PAR, RGS, SCA) / PRY(AMA, CAU, CAN, CEN, COA, GUA, ITA, PAI)
Phoradendron platycaulon	BRA(PAR, SCA)
Phoradendron quadrangulare	ARG(SDE) / BRA(PAR, RGS, SCA) / PRY(APY, BOQ, CAU, CEN, CHO, GUA, PHA)
Phoradendron reductum	ARG(COR, COS, ERI, MIS, SAL, SLU, TUC) / BRA(PAR, RGS, SCA) / PRY(APY, COA, GUA) / URY(RNO)
Phoradendron rusbyi	ARG(JUJ)
Phoradendron tucumanensis	ARG(CAT, JUJ, SAL, TUC)
Phoradendron undulatum	BRA(PAR, RGS, SCA)
Phragmites australis	ARG(BAI, CAT, CHU, COR, DFE, ERI, JUJ, LPA, LRI, MEN, NEU, RNE, SAL, SJU, SLU, TUC) / CHL(ANT, ATA, COQ, VAL, MAU, BIO, ARA, LLA, RME) / URY(SJO)
Phycella angustifolia	CHL(RME)
Phycella australis	CHL(LBO, MAU, BIO)
Phycella cyrtanthoides	CHL(COQ, VAL, LBO, MAU, BIO, ARA, RME)
Phycella gayana	CHL(RME)
Phycella herbertiana	ARG(CAT, LRI, MEN, NEU, SJU) / CHL(VAL, LBO, MAU, RME)
Phycella scarlatina	CHL(COQ, RME)
Phyla betulifolia	BRA(Fuera del área del proyecto) / PRY(APY, BOQ, CON, ÑEE)
Phyla nodiflora var. minor	ARG(BAI, CAT, CHA, CHU, COR, COS, ERI, FOR, JUJ, LPA, LRI, MEN, NEU, RNE, SAL, SJU, SLU, SFE, SDE, TUC) / BRA(RGS) / CHL(TAR, ANT, ATA, COQ, VAL, LBO, MAU, BIO, ARA, LLA, RME) / PRY(APY, BOQ, ÑEE, NAS, PHA) / URY(ART, LAV, MON, ROC, SJO)
Phyla nodiflora var. nodiflora	ARG(CHA, COR, COS, ERI, FOR, JUJ, LPA, MEN, SAL, SJU, SFE, SDE, TUC) / BRA(Fuera del área del proyecto) / CHL(TAR, ATA) / PRY(PHA) / URY(ROC)
Phyla nodiflora var. reptans	ARG(CHA, COS, DFE, ERI, FOR, JUJ, SAL, SFE, SDE) / BRA(RGS) / CHL(TAR, ANT, ATA, COQ, VAL) / PRY(APY, BOQ, CEN, CON, PHA) / URY(ROC)
Phyllachne uliginosa	ARG(TDF) / CHL(AIS, MAG)
Phyllanthus acuminatus	ARG(JUJ, SAL) / BRA(Fuera del área del proyecto) / PRY(AMA)
Phyllanthus amarus	BRA(SCA)
Phyllanthus caroliniensis ssp. guianensis	ARG(COS, ERI, MIS) / BRA(RGS, SCA) / PRY(COA)
Phyllanthus chacoensis	ARG(CHA, COS, FOR, SFE) / PRY(APY, CEN, CON, PHA)
Phyllanthus claussenii	BRA(PAR)
Phyllanthus fluitans	ARG(CHA, FOR) / PRY(ÑEE, PHA)
Phyllanthus fraternus	BRA(SCA)
Phyllanthus glaziovii	BRA(PAR)
Phyllanthus lindbergii	BRA(PAR, SCA) / PRY(CAU)
Phyllanthus niruri	ARG(BAI, CHA, COR, COS, ERI, JUJ, MIS, SAL, SFE, TUC) / BRA(PAR, RGS, SCA) / PRY(CAA, CAN, COA, GUA, ITA, ÑEE, PAI)
Phyllanthus orbiculatus	BRA(PAR) / PRY(AMA, CEN, COA, GUA, PAI)
Phyllanthus perpusillus	BRA(SCA)
Phyllanthus pseudoguyanensis	URY(RIV)
Phyllanthus pulcherrimus	URY(RNO)
Phyllanthus ramillosus	ARG(CAT, COR, MIS, SAL, SLU, SDE, TUC) / BRA(PAR, RGS, SCA) / PRY(CAU) / URY(ROC)
Phyllanthus riedelianus	BRA(PAR, SCA)
Phyllanthus sellowianus	ARG(BAI, CHA, COS, ERI, MIS, SFE, TUC) / BRA(PAR, RGS, SCA) / PRY(CON, ITA) / URY(DUR, FLA, MON, PAY, ROC, SAO, SOR, TYT)
Phyllanthus stipulatus	ARG(CHA, COS, ERI, FOR, MIS) / BRA(RGS, SCA) / PRY(CAU, CEN, COA, GUA, ÑEE, PAI)
Phyllanthus subemarginatus	BRA(PAR, SCA)
Phyllanthus tenellus	ARG(COS, MIS, TUC) / BRA(PAR, RGS, SCA) / PRY(CEN, COA) / URY(CAS, MON)
Phyllanthus urinaria	BRA(PAR, RGS, SCA)
Phyllitis scolopendrium	ARG(TDF)
Phylloscirpus acaulis	ARG(CAT, CHU, MEN, NEU, SAL, SCR, SJU, TUC) / CHL(TAR, ANT, ATA, COQ, MAU, BIO, ARA, RME)
Phylloscirpus boliviensis	CHL(TAR)
Phylloscirpus deserticola	ARG(CAT, JUJ, LRI, MEN, NEU, SAL, SJU, SCR, TUC) / CHL(TAR, ANT, ATA, COQ, RME)
Phyllostylon rhamnoides	ARG(CHA, COS, FOR, JUJ, SAL, SFE, TUC) / BRA(Fuera del área del proyecto) / PRY(APY, BOQ, CEN, CON, ÑEE, PAI, PHA)
Phymatidium aquinoi	BRA(PAR, RGS, SCA)
Phymatidium delicatulum var. delicatulum	ARG(MIS) / BRA(PAR, RGS, SCA) / PRY(APA)
Phymatidium delicatulum var. curvicepalum	BRA(PAR, SCA)
Phymatidium falcifolium	BRA(PAR, SCA)
Phymatidium hysteranthum	BRA(PAR)
Phymatidium microphyllum var. herteri	BRA(PAR, RGS, SCA)
Phymatidium microphyllum var. microphyllum	BRA(PAR)
Physalis angulata	ARG(CHA, COR, COS, ERI, FOR, JUJ, MIS, SAL, SFE, TUC) / BRA(PAR, RGS) / PRY(APY, BOQ, PHA, SPE) / URY(RIV)
Physalis cordata	BRA(PAR)
Physalis lagascae	ARG(JUJ) / BRA(Fuera del área del proyecto)
Physalis nicandroides	PRY(PAI)
Physalis peruviana	CHL(COQ, VAL, LBO, RME, JFE)
Physalis pruinosa var. argentina	ARG(CAT, CHA, COR, FOR, JUJ, LRI, SAL, SDE, TUC) / PRY(APY)
Physalis pubescens var. hygrophila	ARG(CHA, COS, ERI, FOR, JUJ, LRI, MIS, SAL, TUC) / BRA(PAR, RGS, SCA) / PRY(APY, APA)
Physalis pubescens var. pubescens	ARG(CHA, COS, FOR, JUJ, MIS, SAL, SFE, TUC) / BRA(PAR, RGS, SCA) / PRY(APY, APA, CAN, CEN, GUA, PHA) / URY(ART, RNO, SAO, SOR, TYT)
Physalis subilsiana	ARG(SAL) / PRY(APY, PHA)
Physalis victoriana	ARG(JUJ)
Physalis viscosa	ARG(BAI, CAT, CHA, COR, COS, ERI, FOR, JUJ, LPA, LRI, MEN, MIS, NEU, RNE, SAL, SDE, SFE, SJU, SLU, TUC) / BRA(RGS) / CHL(ATA, COQ, VAL, BIO, ARA, RME) / PRY(APY, BOQ, CEN, COA, PHA, SPE) / URY(CAS, COL, MON, PAY, RNO, ROC, SJO, SOR)
Physaria crassistigma	ARG(MEN)
Physaria lateralis	ARG(COR, LRI, MEN, NEU, SJU, SLU)
Physaria mendocina	ARG(BAI, CHU, COR, LPA, MEN, NEU, RNE, SLU) / URY(PAY)
Physaria okanensis	ARG(CAT)
Physaria pygmaea	ARG(CAT, JUJ, LRI, TUC)
Physaria urbaniana	ARG(CAT, JUJ, LRI, MEN, SAL, TUC)
Phytolacca americana	ARG(BAI, DFE) / URY(CLA, TYT)
Phytolacca bogotensis	ARG(CAT, JUJ, MIS, SAL, TUC) / BRA(SCA) / CHL(BIO, ARA, LLA) / PRY(APA, ITA)
Phytolacca chilensis	CHL(VAL, LBO, RME)
Phytolacca dioica	ARG(BAI, CHA, COS, DFE, ERI, FOR, MIS, SAL, SFE, SLU, TUC) / BRA(PAR, RGS, SCA) / PRY(AMA, CAU, CAN, CEN, COA, GUA, PAI) / URY(MON)
Phytolacca rivinoides	ARG(SAL) / BRA(Fuera del área del proyecto)
Phytolacca tetramera	ARG(BAI)
Phytolacca thyrsiflora	ARG(MIS) / BRA(PAR, RGS, SCA) / PRY(AMA, CAA, CAN, ITA)
Picradeniopsis multiflora	ARG(CAT, JUJ, LRI, MEN, SAL, SJU, SLU, TUC) / CHL(TAR, ANT) / URY(TAC)
Picramnia camboita	BRA(PAR)
Picramnia excelsa	BRA(PAR, RGS, SCA)
Picramnia parvifolia	ARG(COS, MIS) / BRA(PAR, RGS, SCA) / PRY(CAA, GUA, PAI)
Picramnia ramiflora	BRA(PAR, RGS, SCA)
Picramnia sellowii	ARG(CHA, COS, FOR, MIS) / BRA(PAR, RGS) / PRY(APY, APA, AMA, CAU, CAA, CEN, CON, COA, GUA, ITA, MIE, ÑEE, PAI, PHA, SPE) / URY(ART)
Picrasma crenata	ARG(MIS) / BRA(PAR, RGS, SCA) / PRY(APA)
Picrosia cabreriana	ARG(CHA, COS, MIS) / BRA(PAR, SCA) / PRY(AMA)
Picrosia longifolia	ARG(BAI, CAT, CHA, COR, COS, DFE, ERI, FOR, JUJ, LPA, LRI, MEN, MIS, NEU, RNE, SAL, SCR, SDE, SFE, SJU, SLU, TUC) / BRA(RGS, SCA) / CHL(TAR) / PRY(APY, BOQ, CEN, CHO, ÑEE, PHA, SPE) / URY(MON)
Pilea aparadensis	BRA(RGS, SCA)
Pilea elegans	CHL(BIO, ARA, LLA)
Pilea elliptica	CHL(BIO, ARA, LLA, AIS)
Pilea flammula	BRA(RGS, SCA)
Pilea hyalina	ARG(CAT, JUJ, MIS, SAL, TUC) / BRA(Fuera del área del proyecto) / CHL(LBO)
Pilea hydra	BRA(RGS, SCA)
Pilea jujuyensis	ARG(JUJ, SAL)
Pilea microphylla	ARG(COS, FOR, MIS) / BRA(PAR)
Pilea pubescens	ARG(MIS) / BRA(PAR, RGS, SCA) / PRY(APA)
Pilgerodendron uviferum	ARG(CHU, NEU, RNE, SCR, TDF) / CHL(LLA, AIS, MAG)
Pilocarpus pauciflorus	BRA(PAR, SCA)
Pilocarpus pennatifolius	ARG(CHA, COS, FOR, MIS) / BRA(PAR, RGS, SCA) / PRY(APA, AMA, CAU, CAA, CAN, CEN, CON, COA, GUA, ITA, ÑEE, PAI, PHA, SPE)
Pilosocereus machrisii	BRA(Fuera del área del proyecto) / PRY(AMA, CON)
Pilostyles berteroi	ARG(BAI, CHU, JUJ, MEN, NEU, SJU, SCR) / CHL(ANT, ATA, COQ, VAL, BIO, RME)
Pilostyles blanchetii	ARG(ERI) / BRA(Fuera del área del proyecto) / URY(SAO)
Pilostyles calliandrae	BRA(Fuera del área del proyecto) / URY(ART)
Pilostyles stawiarskii	BRA(PAR)
Pilostyles ulei	BRA(SCA)
Pilularia americana	ARG(BAI, COR, ERI, NEU, RNE, SFE) / BRA(RGS) / CHL(COQ, VAL, MAU, BIO, ARA, LLA, RME) / URY(CAS)
Pimenta pseudocaryophyllus var. hoehnei	BRA(SCA)
Pimenta pseudocaryophyllus var. pseudocaryophyllus	BRA(PAR, SCA)
Pimpinella anisum	ARG(COR, MEN) / BRA(SCA)
Pinguicula antarctica	ARG(CHU, NEU, RNE, SCR, TDF) / CHL(ARA, LLA, AIS, MAG)
Pinguicula chilensis	ARG(NEU, RNE) / CHL(MAU, BIO, ARA, LLA)
Pintoa chilensis	CHL(ATA)
Pinus contorta	ARG(NEU, RNE)
Pinus elliottii	ARG(COR)
Pinus halepensis	ARG(COR)
Pinus patula	ARG(COR)
Pinus ponderosa	ARG(NEU, RNE)
Pinus radiata	ARG(NEU, RNE) / CHL(VAL)
Piper aduncum var. aduncum	ARG(JUJ, MIS, SAL) / BRA(PAR, RGS, SCA) / PRY(APA, CAA, CAN, CEN, COA, GUA, ITA, PAI, SPE)
Piper alnoides	BRA(SCA)
Piper amalago	ARG(CHA, COS, FOR, JUJ, MIS, SAL) / BRA(PAR, RGS, SCA) / PRY(APA, AMA, CAU, CAA, CAN, CEN, CON, COA, GUA, ITA, ÑEE, PAI, SPE)
Piper amplum	BRA(PAR, SCA)
Piper arboreum var. latifolium	BRA(PAR, SCA)
Piper arboreum var. hirtellum	BRA(PAR)
Piper arboreum var. arboreum	BRA(PAR, RGS, SCA) / PRY(CAN, COA)
Piper arboreum var. falcifolium	BRA(SCA)
Piper asperilimbum	PRY(CAN)
Piper caldense	BRA(PAR, SCA)
Piper cernuum	BRA(PAR, SCA)
Piper crassinervium	BRA(PAR, SCA)
Piper dilatatum	BRA(PAR, RGS, SCA) / PRY(AMA)
Piper diospyrifolium	BRA(SCA)
Piper fluminense	BRA(PAR, RGS, SCA)
Piper fuligineum	BRA(PAR) / PRY(AMA)
Piper glabratum	BRA(PAR) / PRY(CAN)
Piper hatschbachii	BRA(PAR)
Piper hemmendorffii	BRA(PAR)
Piper hieronymi var. hieronymi	ARG(COS, JUJ, MIS, SAL, TUC)
Piper hispidum	BRA(PAR, SCA) / PRY(CAA, CAN)
Piper kleinii	BRA(SCA)
Piper laevigatum	PRY(PAI)
Piper lepturum	BRA(PAR, SCA)
Piper lhotzkyanum	BRA(PAR, SCA)
Piper macedoi	BRA(PAR)
Piper malacophyllum	BRA(PAR, SCA) / PRY(CAN)
Piper mapirense	ARG(JUJ, MIS, SAL) / PRY(CAU, CAN)
Piper mikanianum var. mikanianum	ARG(MIS) / BRA(PAR, RGS, SCA) / PRY(APA, CAA, GUA) / URY(TAC)
Piper mikanianum var. pilosius	BRA(Fuera del área del proyecto) / PRY(APA, GUA)
Piper miquelianum	ARG(MIS) / BRA(PAR, RGS, SCA) / PRY(APA, CAU, CAN)
Piper mollicomum	BRA(PAR, RGS, SCA) / PRY(CAN)
Piper mosenii	BRA(PAR, SCA)
Piper regnellii	ARG(COS, MIS) / BRA(PAR, SCA) / PRY(CAA, CAN, CEN, COA, MIE, PAI, SPE)
Piper reitzii	BRA(PAR, SCA)
Piper richardiifolium	BRA(PAR, SCA)
Piper rivinoides f. rivinoides	BRA(SCA)
Piper rivinoides f. magnifolium	BRA(SCA)
Piper solmsianum var. solmisianum	BRA(PAR, RGS, SCA)
Piper solmsianum var. hilarianum	BRA(PAR, SCA)
Piper subcinereum	BRA(PAR, RGS, SCA)
Piper tucumanum	ARG(JUJ, SAL, TUC)
Piper ulei	BRA(SCA)
Piper umbellatum	BRA(PAR, RGS, SCA)
Piper viminifolium	BRA(PAR, SCA)
Piper xylosteoides	BRA(PAR, RGS, SCA)
Piptadenia affinis	BRA(SCA)
Piptadenia gonoacantha var. gonoacantha	BRA(PAR, SCA) / PRY(CON)
Piptadenia gonoacantha var. inermis	BRA(PAR, SCA)
Piptadenia paniculata var. aculeata	BRA(SCA)
Piptadenia paniculata var. paniculata	BRA(PAR, SCA)
Piptadenia viridiflora	ARG(JUJ, SAL) / BRA(Fuera del área del proyecto)
Piptadeniopsis lomentifera	PRY(APY, PHA)
Piptatherum miliaceum	ARG(BAI, DFE, LPA) / CHL(VAL, MAG, RME)
Piptocarpha angustifolia	ARG(MIS) / BRA(PAR, RGS, SCA)
Piptocarpha axillaris	BRA(PAR, RGS, SCA)
Piptocarpha densifolia	BRA(PAR, SCA)
Piptocarpha isotrichia	BRA(SCA)
Piptocarpha leprosa	BRA(PAR)
Piptocarpha macropoda ssp. crassifolia	BRA(PAR)
Piptocarpha notata	BRA(RGS, SCA)
Piptocarpha oblonga ssp. oblonga	BRA(PAR, SCA)
Piptocarpha oblonga ssp. lepidota	BRA(PAR, RGS, SCA)
Piptocarpha organensis	BRA(SCA)
Piptocarpha quadrangularis	BRA(PAR, SCA)
Piptocarpha ramboi	BRA(RGS, SCA)
Piptocarpha regnellii	BRA(PAR, SCA)
Piptocarpha sellowii var. sellowii	ARG(COS, MIS) / BRA(PAR, RGS, SCA) / PRY(APA, AMA, CAU, CAA, GUA, PAI)
Piptocarpha tomentosa	BRA(RGS, SCA)
Piptochaetium alpinum	BRA(PAR, RGS, SCA)
Piptochaetium angolense	CHL(COQ, VAL, ARA)
Piptochaetium bicolor	ARG(BAI, ERI, SFE) / BRA(RGS) / CHL(VAL, MAU, BIO, ARA, LLA, RME, JFE) / URY(CAS, FLA, LAV, MAL, MON, SJO)
Piptochaetium brachyspermum	ARG(BAI)
Piptochaetium burkartianum	ARG(COS)
Piptochaetium cabrerae	ARG(BAI)
Piptochaetium calvescens	ARG(BAI) / URY(MON)
Piptochaetium confusum	ARG(ERI) / URY(ART, CLA, COL, LAV, MAL, MON, PAY, RNO, RIV, SJO, SOR, TAC)
Piptochaetium cucullatum	URY(PAY, SAO)
Piptochaetium depressum	CHL(VAL, LBO, MAU, BIO, ARA, RME)
Piptochaetium fuscum	CHL(VAL, LBO, MAU, BIO, ARA, RME)
Piptochaetium hackelii	ARG(BAI, LPA) / URY(MAL, MON)
Piptochaetium hirtum	CHL(VAL, RME)
Piptochaetium indutum	ARG(JUJ, SAL)
Piptochaetium jubatum	URY(CAS, MON, RIV)
Piptochaetium lasianthum	ARG(BAI, COR, COS, ERI, MIS, SFE) / BRA(RGS, SCA) / URY(ART, CLA, FLO, FLA, LAV, MAL, RNO, SAO, SOR, TAC, TYT)
Piptochaetium lejopodum	ARG(BAI) / URY(LAV, MAL)
Piptochaetium medium	ARG(BAI, COR, ERI, LPA, MIS, SLU) / BRA(RGS) / URY(FLA)
Piptochaetium montevidense	ARG(BAI, CHA, COR, COS, DFE, ERI, JUJ, LPA, MIS, SAL, SLU, SFE) / BRA(PAR, RGS, SCA) / PRY(CAA, COA, GUA, ITA, MIE, PAI) / URY(ART, CAS, CLA, COL, DUR, FLO, FLA, LAV, MAL, MON, PAY, RNO, SAO, SJO, SOR)
Piptochaetium napostaense	ARG(BAI, CAT, CHU, COR, LPA, MEN, RNE, SLU, TUC)
Piptochaetium palustre	BRA(SCA)
Piptochaetium panicoides	ARG(BAI, COR, ERI, JUJ, NEU, SAL, TUC) / BRA(RGS) / CHL(COQ, LBO, MAU, BIO, ARA, LLA) / URY(CAS, COL, MAL, MON, RNO, SJO)
Piptochaetium ruprechtianum	ARG(BAI, MIS, SLU) / BRA(PAR, RGS, SCA) / URY(ART, DUR, LAV, MAL, MON, RIV, SOR)
Piptochaetium stipoides var. stipoides	ARG(BAI, CAT, CHA, COR, COS, ERI, JUJ, MIS, RNE, SLU, SFE) / BRA(RGS, SCA) / CHL(COQ, VAL, MAU, BIO, ARA, RME) / URY(CAS, CLA, COL, FLO, FLA, LAV, MAL, MON, PAY, RNO, SAO, SOR, TAC)
Piptochaetium stipoides var. echinulatum	ARG(BAI, LPA, SLU) / BRA(RGS) / URY(SAO)
Piptochaetium uruguense	ARG(CHA, COS, ERI, MIS, SAL, SFE) / BRA(RGS, SCA) / PRY(GUA, MIE) / URY(CLA, FLO, FLA, PAY, RIV, ROC, TAC, TYT)
Piriqueta cistoides	ARG(FOR, MIS) / BRA(PAR) / PRY(APY, AMA, CAA, CAN, CON, PHA, SPE)
Piriqueta grandifolia	ARG(FOR, SAL) / BRA(Fuera del área del proyecto) / PRY(APY)
Piriqueta morongii	ARG(COS) / BRA(Fuera del área del proyecto) / PRY(APY, AMA, CEN, CON, COA, GUA, ÑEE, PAI, PHA, SPE)
Piriqueta nitida	BRA(Fuera del área del proyecto) / PRY(AMA, CAN, SPE)
Piriqueta ochroleuca	PRY(COA, PAI)
Piriqueta racemosa	BRA(Fuera del área del proyecto) / PRY(CON)
Piriqueta rosea	BRA(Fuera del área del proyecto) / PRY(AMA, CON, SPE)
Piriqueta sidifolia	BRA(RGS)
Piriqueta suborbicularis	ARG(COS, MIS) / BRA(RGS) / PRY(CAU, GUA, ITA, PAI) / URY(CLA)
Piriqueta subsessilis	PRY(CAU, CAN, SPE)
Piriqueta tamberlikii	BRA(Fuera del área del proyecto) / PRY(AMA)
Piriqueta taubatensis	ARG(COS, MIS) / BRA(PAR, RGS, SCA) / PRY(CAA, MIE, PAI) / URY(RIV)
Pisonia aculeata	ARG(CHA, COS, FOR, MIS, SAL, SFE) / BRA(PAR, RGS, SCA) / PRY(APA, APY, CAA, CAN, COA, GUA, ÑEE, PAI, PHA)
Pisonia ambigua	BRA(PAR, RGS, SCA) / PRY(AMA)
Pisonia hassleriana	PRY(APY, CON)
Pisonia zapallo var. zapallo	ARG(CHA, COS, FOR, JUJ, MIS, SAL, SFE, TUC) / PRY(APA, APY, AMA, CAA, CON, PHA)
Pisonia zapallo var. guaranitica	ARG(CHA, COS, FOR, JUJ, SAL, SFE) / PRY(CEN)
Pisoniella arborescens var. glabrata	ARG(CAT, JUJ, LRI, SAL, TUC)
Pistia stratiotes	ARG(BAI, CHA, COS, ERI, FOR, JUJ, MIS, SAL, SFE, TUC) / BRA(PAR, RGS, SCA) / CHL(VAL) / PRY(APY, BOQ, CEN, CHO, COA, GUA, ÑEE, PAI, PHA) / URY(CLA, MON)
Pitavia punctata	CHL(MAU, BIO)
Pitcairnia chiriguana	ARG(SAL)
Pitcairnia flammea var. floccosa	BRA(PAR, SCA)
Pitcairnia flammea var. glabrior	BRA(PAR, SCA)
Pitcairnia oranensis	ARG(SAL)
Pitcairnia paraguayensis	PRY(AMA)
Pitcairnia saltensis	ARG(SAL)
Pitraea cuneato-ovata	ARG(CAT, CHA, CHU, COR, FOR, JUJ, LPA, LRI, MEN, SAL, SJU, SLU, SFE, SDE, TUC) / CHL(TAR, ANT, ATA, COQ, VAL, RME)
Pityrogramma calomelanos var. calomelanos	ARG(BAI, COR, COS, JUJ, MIS, SAL, SFE, SDE, TUC) / BRA(PAR, RGS, SCA) / PRY(AMA, CAA, CAN, CEN, COA, ÑEE, PAI, SPE) / URY(ART, RIV)
Pityrogramma calomelanos var. austroamericana	ARG(CAT, COR, JUJ, SAL, TUC) / PRY(CAN)
Pityrogramma ebenea var. aurata	ARG(COR) / BRA(Fuera del área del proyecto)
Pityrogramma trifoliata	ARG(BAI, CAT, CHA, COR, COS, DFE, ERI, FOR, JUJ, LPA, LRI, MIS, SAL, SLU, SFE, SDE, TUC) / BRA(PAR) / CHL(TAR) / PRY(APY, CAA, CAN, COA, GUA, PAI, PHA) / URY(PAY)
Placea amoena	CHL(COQ, RME)
Placea arzae	CHL(VAL, LBO, RME)
Placea davidii	CHL(RME)
Placea lutea	CHL(VAL)
Placea ornata	CHL(VAL, RME)
Plagiobothrys armeriifolius	CHL(LBO)
Plagiobothrys calandrinioides	ARG(CHU, NEU, RNE, SCR, SJU, TDF) / CHL(VAL, RME)
Plagiobothrys collinus	CHL(COQ)
Plagiobothrys congestus	ARG(JUJ, SAL, TUC)
Plagiobothrys corymbosus	ARG(CHU, NEU, RNE, TDF) / CHL(ARA)
Plagiobothrys foliosus	CHL(BIO, ARA)
Plagiobothrys fulvus	CHL(COQ, VAL, LBO, MAU, BIO, ARA, LLA, RME)
Plagiobothrys germainii	CHL(ARA)
Plagiobothrys gracilis	CHL(COQ, MAU, BIO, RME)
Plagiobothrys myosotoides	CHL(COQ, VAL, LBO, BIO, RME)
Plagiobothrys oppositifolius	CHL(ARA)
Plagiobothrys pedicellaris	CHL(BIO, ARA)
Plagiobothrys polycaulis	CHL(MAU, BIO, ARA, LLA, RME)
Plagiobothrys pratensis	CHL(BIO, ARA, LLA)
Plagiobothrys procumbens	ARG(NEU) / CHL(COQ, VAL, LBO, MAU, BIO, RME)
Plagiobothrys pulchellus	CHL(BIO, ARA)
Plagiobothrys uliginosus	CHL(BIO, ARA)
Plagiobothrys verrucosus	ARG(CHU, MEN, NEU, RNE, SCR) / CHL(VAL, LBO, MAU, RME)
Plagiocheilus tanacetoides	ARG(BAI, CHA, COR, COS, DFE, ERI, FOR, MIS, SFE) / PRY(PHA)
Plantago arenaria	ARG(BAI, LPA)
Plantago argentina	ARG(CAT, COR, JUJ, SAL, SLU, TUC)
Plantago australis ssp. pretoana	BRA(PAR, SCA)
Plantago australis ssp. cumingiana	ARG(CHU, MEN, NEU, RNE, SCR) / CHL(VAL, BIO, ARA, LLA, AIS, MAG)
Plantago australis ssp. australis	ARG(BAI, CAT, CHA, CHU, COR, COS, ERI, FOR, JUJ, LPA, LRI, MEN, MIS, NEU, RNE, SAL, SJU, SLU, SCR, SFE, TUC) / BRA(PAR, RGS, SCA) / CHL(TAR, LLA, MAG, JFE) / PRY(CAA, CEN, GUA, MIE) / URY(CAS, COL, LAV, MAL, MON, ROC)
Plantago barbata ssp. muscoides	ARG(TDF) / CHL(MAG)
Plantago barbata ssp. barbata	ARG(CHU, MEN, NEU, RNE, SCR, SJU) / CHL(ATA, COQ, VAL, LBO, MAU, BIO, ARA, LLA, AIS, MAG, RME)
Plantago barbata ssp. austroandina	ARG(CHU, MEN, SCR, TDF) / CHL(AIS, MAG)
Plantago barbata ssp. gigantea	ARG(CHU, SCR)
Plantago barbata ssp. monanthos	ARG(SCR, TDF) / CHL(MAG, RME)
Plantago berroi	ARG(BAI) / URY(ART, COL, FLA, MAL, MON, SOR)
Plantago bismarckii	ARG(BAI)
Plantago brasiliensis	ARG(CHU, COR, COS, ERI, LRI, NEU, RNE, SLU) / BRA(RGS, SCA) / CHL(LBO, MAU, BIO, ARA, LLA, RME) / URY(ART, CAS, COL, MAL, MON, RIV, SAO)
Plantago buchtienii	ARG(CAT, SAL, TUC)
Plantago catharinea	BRA(PAR, RGS, SCA)
Plantago commersoniana	BRA(PAR, RGS, SCA) / PRY(CAU) / URY(MON)
Plantago coronopus	BRA(RGS) / CHL(COQ, LBO, BIO) / URY(MON)
Plantago correae	ARG(SCR, TDF)
Plantago corvensis	BRA(SCA)
Plantago densa	ARG(COR, SLU)
Plantago dielsiana	ARG(BAI) / URY(CAS, MON, ROC)
Plantago fernandezia	CHL(JFE)
Plantago firma	CHL(COQ, VAL, LBO, MAU, BIO, ARA, LLA, RME, JFE)
Plantago grandiflora	ARG(MEN, NEU) / CHL(VAL, LBO, MAU, BIO, RME)
Plantago guilleminiana	BRA(PAR, RGS, SCA)
Plantago heterophylla	ARG(BAI, COR, COS, DFE, ERI, LPA) / PRY(COA) / URY(PAY)
Plantago hispidula	CHL(TAR, ANT, ATA, COQ, VAL, LBO, BIO, RME)
Plantago johnstonii	CHL(ANT)
Plantago jujuyensis	ARG(JUJ)
Plantago lanceolata	ARG(BAI, CHU, COR, DFE, ERI, JUJ, LPA, LRI, MEN, NEU, RNE, SAL, SJU, SCR, TDF) / BRA(PAR, RGS) / CHL(ANT, ATA, COQ, VAL, LBO, MAU, BIO, ARA, LLA, AIS, MAG, RME, JFE, IPA) / URY(CAS, MON, PAY, RNO, ROC)
Plantago limensis	CHL(TAR)
Plantago litorea	CHL(TAR, ANT, ATA, COQ, VAL)
Plantago lundborgii	CHL(IDE)
Plantago major	ARG(BAI, CHA, COR, DFE, ERI, JUJ, LPA, MEN, MIS, NEU, RNE, SAL, SCR, SFE, TDF) / BRA(PAR, RGS, SCA) / CHL(TAR, ANT, COQ, VAL, MAU, BIO, ARA, LLA, AIS, MAG, RME, JFE, IPA) / URY(CAS, MON)
Plantago maritima	ARG(CHU, MEN, NEU, RNE, SCR, TDF) / CHL(MAG)
Plantago moorei	ARG(TDF)
Plantago myosuros ssp. myosuros	ARG(BAI, CHA, CHU, COR, COS, ERI, FOR, JUJ, LPA, MEN, MIS, RNE, SAL, SCR, SDE, SFE, SJU, SLU, TUC) / BRA(RGS) / PRY(CAU, CEN, COA, MIE, ÑEE, PHA, SPE) / URY(ART, CAS, COL, DUR, FLA, MAL, MON, ROC)
Plantago orbignyana ssp. pseudomollior	ARG(JUJ, SAL)
Plantago orbignyana ssp. niederleinii	ARG(CAT, JUJ, LRI, SAL, TUC)
Plantago orbignyana ssp. orbignyana	ARG(JUJ, SAL)
Plantago pachyneura	ARG(MEN) / CHL(ANT, ATA, COQ, VAL, LBO, BIO, RME)
Plantago patagonica	ARG(BAI, CHU, COR, LPA, MEN, NEU, RNE, SCR, SFE, SLU)
Plantago penantha	ARG(BAI, COS, ERI) / BRA(RGS) / URY(ART, CAS, FLA, LAV, SJO)
Plantago pulvinata	ARG(SCR) / CHL(AIS)
Plantago rahniana	BRA(SCA)
Plantago rancaguae	CHL(ANT, ATA, COQ, VAL, LBO, RME)
Plantago sempervivoides	ARG(MEN, SCR) / CHL(MAG)
Plantago sericea ssp. sericans	ARG(CAT, JUJ, LRI, SAL, TUC) / CHL(TAR)
Plantago sericea var. lanuginosa	ARG(CAT, JUJ, SAL, TUC)
Plantago sericea ssp. araucana	CHL(MAU, BIO)
Plantago tandilensis	ARG(BAI)
Plantago tehuelcha	ARG(CHU, NEU, SCR) / CHL(MAG)
Plantago tomentosa ssp. napiformis	ARG(CHA, COS, FOR, MIS, SFE) / BRA(RGS) / PRY(CEN, COA, GUA, MIE, SPE)
Plantago tomentosa ssp. tomentosa	ARG(BAI, CAT, CHA, COR, COS, ERI, FOR, JUJ, LRI, MEN, MIS, SAL, SDE, SFE, SJU, SLU, TUC) / BRA(PAR, RGS, SCA) / PRY(APY, BOQ, CAU, CAA, CAN, CEN, COA, GUA, ÑEE, PAI, PHA, SPE) / URY(CAS, COL, FLA, LAV, MAL, MON, RNO, SJO, SOR)
Plantago truncata	CHL(VAL, LBO, MAU, BIO, ARA, RME)
Plantago tubulosa	ARG(JUJ, LRI, SAL, TUC) / CHL(TAR, ANT)
Plantago turficola	BRA(RGS, SCA)
Plantago uniglumis	ARG(CHU, MEN, NEU, RNE, SCR, SJU) / CHL(COQ, VAL, MAU, BIO, AIS, MAG, RME)
Plantago ventanensis	ARG(BAI)
Plantago venturii	ARG(CAT, TUC)
Plantago weddelliana	ARG(SAL)
Plathymenia reticulata	BRA(PAR) / PRY(AMA, CON)
Platycyamus regnelli	BRA(PAR)
Platymiscium floribundum var. floribundum	BRA(PAR, SCA)
Platymiscium floribundum var. latifolium	BRA(PAR)
Platypodium elegans	BRA(PAR) / PRY(APY, AMA, CAN, CON, SPE)
Platyrhiza quadricolor	BRA(RGS, SCA)
Platystele oxyglossa	BRA(SCA)
Platythelys paranaensis	BRA(PAR, SCA)
Platythelys platensis	ARG(BAI, ERI) / PRY(PAI)
Platythelys schlechteriana	BRA(PAR, SCA)
Plazia cheiranthifolia	CHL(COQ)
Plazia daphnoides	ARG(JUJ, MEN, SAL, SJU) / CHL(TAR)
Plectocephalus tweediei	ARG(BAI, CHA, COS, ERI, FOR, MIS, SFE) / BRA(RGS) / PRY(GUA) / URY(ART, CLA, FLA, RNO, RIV, SAO, SJO, TAC)
Plectrocarpa rougesii	ARG(CAT, LRI, SAL, TUC)
Plectrocarpa tetracantha	ARG(CAT, COR, JUJ, LRI, MEN, SDE, SJU, SLU)
Pleiochiton ebracteatum	BRA(PAR, SCA)
Pleiochiton glaziovianum	BRA(PAR, SCA)
Plenckia integerrima	ARG(CAT, JUJ, SAL, TUC)
Plenckia microcarpa	BRA(Fuera del área del proyecto) / PRY(PAI)
Plenckia populnea	BRA(PAR) / PRY(COA, PAI, SPE)
Pleocarphus revolutus	CHL(ATA, COQ, VAL)
Pleopeltis astrolepis	BRA(PAR, SCA)
Pleopeltis bryopoda	ARG(JUJ, SAL, TUC)
Pleopeltis hirsutissima	ARG(MIS, TUC) / BRA(PAR, RGS, SCA) / PRY(APA, CAU, CAN, COA) / URY(LAV, RIV)
Pleopeltis lepidopteris	BRA(PAR, RGS, SCA) / PRY(PAI, SPE) / URY(CLA, LAV, MAL, RIV, ROC)
Pleopeltis macrocarpa	ARG(BAI, CAT, JUJ, MIS, SAL, TUC) / BRA(PAR, SCA) / CHL(ANT, BIO, ARA, LLA, JFE) / URY(MAL)
Pleopeltis minima	ARG(BAI, CAT, CHA, COR, COS, ERI, FOR, JUJ, LRI, MIS, SAL, SFE, TUC) / BRA(PAR, RGS, SCA) / PRY(AMA, CAU, CAN, CEN, COA, GUA, PAI) / URY(ART, RIV, SAO)
Pleopeltis pinnatifida	ARG(BAI, CAT, COR, JUJ, LPA, LRI, MEN, SAL, SDE, SJU, SLU, TUC)
Pleopeltis pleopeltidis	ARG(JUJ, SAL) / BRA(PAR, RGS, SCA)
Pleopeltis pleopeltifolia	ARG(COS, ERI, FOR, MIS) / BRA(PAR, RGS, SCA) / PRY(APA, CAA, CAN, COA, GUA, PAI, SPE) / URY(ART, CLA, FLA, RIV, TAC)
Pleopeltis tweediana	ARG(CAT, JUJ, LRI, SAL, TUC)
Pleroma caissara	BRA(PAR, SCA)
Pleroma guartelaensis	BRA(PAR)
Pleurobotryum albopurpurea	BRA(PAR)
Pleurobotryum atropurpureum	BRA(SCA)
Pleurobotryum crepinianum	BRA(PAR, RGS, SCA)
Pleurobotryum hatschbachii	ARG(MIS) / BRA(PAR, RGS, SCA)
Pleurobotryum mantiquyranum	BRA(PAR, RGS, SCA)
Pleurobotryum rhabdosepalum	ARG(MIS, SAL) / BRA(PAR)
Pleurophora patagonica	ARG(CHU, MEN, NEU, RNE, SCR)
Pleurophora polyandra	CHL(COQ, VAL, LBO, RME)
Pleurophora pungens	CHL(ANT, ATA, COQ, VAL, LBO, RME)
Pleurophora pusilla	CHL(ATA, COQ, VAL, LBO, RME)
Pleurophora saccocarpa	ARG(CHA, COS, FOR, SAL, SFE) / BRA(Fuera del área del proyecto) / PRY(APA, APY, AMA, BOQ, CAN, CEN, CHO, CON, MIE, ÑEE, PAI, PHA, SPE)
Pleurostachys beyrichii var. panicoides	BRA(PAR)
Pleurostachys beyrichii var. beyrichii	BRA(PAR, SCA)
Pleurostachys cimaensis	BRA(PAR)
Pleurostachys densefoliata	BRA(PAR, SCA)
Pleurostachys foliosa	BRA(PAR, SCA)
Pleurostachys gaudichaudii	BRA(PAR, RGS, SCA)
Pleurostachys graminifolia var. gracilis	BRA(SCA)
Pleurostachys hoehneana	BRA(RGS)
Pleurostachys millegrana	BRA(PAR, SCA)
Pleurostachys puberula var. montana	BRA(PAR, SCA)
Pleurostachys sellowii	BRA(PAR, SCA)
Pleurostachys stricta	BRA(PAR, RGS, SCA)
Pleurostachys tenuiflora	BRA(PAR)
Pleurostachys urvillei	BRA(PAR, SCA)
Pleurothallis gouveiae	BRA(PAR)
Pleurothallis microphyta var. missionum	ARG(MIS)
Pleurothallis pectinata	ARG(SAL) / BRA(PAR, SCA)
Pleurothallis pruinosa	BRA(PAR)
Pleurothallis serpentula	BRA(RGS)
Plinia brachybotrya	BRA(PAR, RGS, SCA)
Plinia cordifolia	BRA(PAR, RGS, SCA)
Plinia hatschbachii	BRA(PAR)
Plinia rivularis	ARG(COS, ERI, MIS) / BRA(RGS, SCA) / PRY(APA, AMA, CAA, CAN, CEN, COA, GUA, ITA, PAI, SPE) / URY(ART, PAY, SAO)
Plinia trunciflora	ARG(MIS) / BRA(RGS, SCA) / PRY(CEN, COA, ÑEE, PAI)
Pluchea chingoyo	CHL(TAR, ANT)
Pluchea laxiflora	BRA(RGS, SCA)
Pluchea microcephala	ARG(CAT, CHA, COR, FOR, JUJ, SAL, SDE, TUC)
Pluchea oblongifolia	BRA(PAR, RGS, SCA)
Pluchea sagittalis	ARG(BAI, CAT, CHA, COR, COS, ERI, FOR, JUJ, LPA, LRI, MIS, SAL, SDE, SFE, SLU, TUC) / BRA(PAR, RGS, SCA) / PRY(APY, AMA, CAU, CAA, CEN, CON, COA, GUA, PAI, PHA) / URY(COL, MON, SOR)
Plumbago caerulea	ARG(COR, JUJ, LRI, SAL, SLU, TUC) / CHL(ANT, ATA, COQ)
Plumbago scandens	ARG(CHA, FOR, JUJ, SAL, SFE, TUC) / BRA(Fuera del área del proyecto) / PRY(APY, CEN, COA)
Plumeria rubra	ARG(MIS) / BRA(SCA)
Poa acinaciphylla	ARG(MEN) / CHL(COQ, VAL, RME)
Poa aequigluma	ARG(SAL)
Poa alopecurus ssp. shuka	ARG(CHU, SCR, TDF)
Poa alopecurus ssp. alopecurus	ARG(SCR, TDF) / CHL(LLA, AIS, MAG, RME)
Poa alopecurus ssp. fuegiana	ARG(CHU, RNE, SCR, TDF) / CHL(LLA, AIS, MAG)
Poa androgyna	CHL(TAR)
Poa annua	ARG(BAI, CAT, CHA, CHU, COR, COS, DFE, ERI, FOR, JUJ, LPA, LRI, MEN, MIS, NEU, RNE, SAL, SJU, SLU, SCR, SFE, SDE, TDF, TUC) / BRA(PAR, RGS, SCA) / CHL(ANT, COQ, VAL, LBO, MAU, BIO, ARA, LLA, AIS, MAG, RME, JFE, IPA) / PRY(GUA, ITA, MIE, PAI) / URY(MAL)
Poa arctica	ARG(TDF)
Poa arechavaletae	URY(MON)
Poa atropidiformis var. patagonica	ARG(SCR, TDF)
Poa atropidiformis var. atropidiformis	ARG(SCR, TDF) / CHL(MAG)
Poa bergii	ARG(BAI, CHU, RNE) / URY(COL)
Poa bonariensis	ARG(BAI, COR, COS, DFE, ERI, LPA, NEU, SFE) / BRA(RGS) / CHL(ANT, ATA, COQ, VAL, BIO, ARA, RME) / URY(MAL, MON)
Poa bradei	BRA(RGS, SCA)
Poa bulbosa ssp. vivipara	ARG(CHU, SCR) / CHL(MAG)
Poa cabreriana	ARG(CAT, SAL)
Poa calchaquiensis	ARG(CAT, JUJ, LRI, SAL, TUC)
Poa chamaeclinos	ARG(CAT, JUJ)
Poa compressa	ARG(CHU, MEN, NEU, RNE) / CHL(ARA, LLA, MAG)
Poa cumingii	CHL(VAL, BIO)
Poa darwiniana	ARG(TDF) / CHL(MAG)
Poa denudata	ARG(CHU, MEN, NEU, RNE) / CHL(BIO, ARA, LLA)
Poa dolichophylla	ARG(CAT, JUJ, SAL, TUC)
Poa durifolia	ARG(CHU, MEN, NEU, RNE, SJU, SCR)
Poa flabellata	ARG(TDF) / CHL(MAG)
Poa gayana	CHL(LBO, MAU, RME)
Poa glaberrima	ARG(JUJ)
Poa glauca	ARG(CHU, NEU, SCR) / CHL(AIS, MAG)
Poa grisebachii	ARG(JUJ)
Poa gymnantha	ARG(JUJ, SAL) / CHL(TAR, ANT)
Poa hachadoensis var. pilosa	ARG(CHU, NEU) / CHL(LBO)
Poa hachadoensis var. hachadoensis	ARG(MEN, NEU, RNE) / CHL(MAU, BIO, ARA, LLA)
Poa hieronymi	ARG(JUJ, LRI, SAL, TUC)
Poa holciformis	ARG(MEN, NEU, SJU) / CHL(COQ, VAL, LBO, MAU, BIO, ARA, RME)
Poa hubbardiana	ARG(COR, SLU)
Poa huecu	ARG(LRI, MEN, NEU, SJU)
Poa humillima	ARG(CAT, SAL, TUC) / CHL(ANT)
Poa infirma	ARG(COR, SAL, TUC) / CHL(VAL, RME)
Poa iridifolia	ARG(BAI)
Poa kurtzii	ARG(CAT, JUJ, LRI, SAL, TUC) / CHL(TAR)
Poa laetevirens	ARG(JUJ, LRI, SAL) / CHL(TAR, ANT, ATA)
Poa lanigera	ARG(BAI, COR, COS, DFE, ERI, LPA, MEN, MIS, SLU, SFE) / BRA(RGS) / PRY(APA, CAU) / URY(DUR, LAV, MAL, MON, ROC, SJO)
Poa lanuginosa var. patagonica	ARG(CHU, MEN, RNE, SCR, TDF) / CHL(MAG)
Poa lanuginosa var. lanuginosa	ARG(BAI, CHU, LPA, MEN, NEU, RNE, SJU, SCR, TDF) / CHL(COQ, VAL, BIO, MAG) / URY(COL, MON)
Poa lanuginosa var. neuquina	ARG(CHU, NEU)
Poa lepidula	ARG(JUJ, LRI, SAL) / CHL(TAR, ANT)
Poa ligularis var. resinulosa	ARG(BAI, CHU, COR, MEN, NEU, RNE, SLU)
Poa ligularis var. ligularis	ARG(BAI, CHU, COR, LPA, LRI, MEN, NEU, RNE, SAL, SCR, SFE, SJU, SLU) / CHL(BIO)
Poa lilloi	ARG(CAT, JUJ, SAL, TUC) / CHL(TAR)
Poa mendocina	ARG(MEN) / CHL(RME)
Poa myriantha	ARG(JUJ, TUC)
Poa nemoralis	ARG(CHU, NEU, SCR, TDF) / CHL(AIS, MAG, RME)
Poa nubensis	ARG(JUJ, LRI, SAL, TUC)
Poa obvallata	ARG(CHU, MEN, NEU, RNE) / CHL(VAL, LBO, MAU, BIO, ARA, LLA, MAG, RME)
Poa palustris	ARG(RNE) / CHL(VAL, MAG, RME)
Poa paposana	CHL(ANT, ATA)
Poa pearsonii	ARG(JUJ) / CHL(TAR)
Poa pedersenii	PRY(CAU)
Poa perligulata	ARG(CAT, JUJ, SAL, TUC) / CHL(TAR)
Poa pfisteri	CHL(BIO)
Poa pilcomayensis	ARG(BAI, CHA, COR, COS, ERI, FOR, SAL, SFE, SDE) / PRY(APA, APY, CAA, ITA, PHA) / URY(MON, TAC)
Poa planifolia	ARG(MEN) / CHL(RME)
Poa plicata	ARG(CAT, LRI, SAL, TUC)
Poa pratensis ssp. alpigena	CHL(MAG)
Poa pratensis ssp. pratensis	ARG(BAI, CHU, COS, DFE, JUJ, LPA, LRI, MEN, NEU, RNE, SJU, SCR, TDF) / BRA(RGS) / CHL(ATA, COQ, VAL, MAU, BIO, ARA, LLA, MAG, RME, JFE) / URY(MON)
Poa pratensis ssp. angustifolia	ARG(CHU, DFE, NEU, RNE)
Poa ragonesei	ARG(SAL, TUC)
Poa reitzii	BRA(RGS, SCA)
Poa scaberula	ARG(CAT, CHU, COR, JUJ, LRI, MEN, NEU, RNE, SAL, SJU, SCR, TDF, TUC) / CHL(ANT, LLA, AIS, MAG)
Poa schizantha	ARG(BAI)
Poa schoenoides	CHL(LLA)
Poa secunda ssp. secunda	ARG(CHU, MEN, NEU, RNE, SCR) / CHL(VAL, LBO, MAG, RME)
Poa secunda ssp. juncifolia	ARG(SCR, TDF) / CHL(MAG)
Poa sellowii	BRA(PAR, RGS, SCA) / PRY(PHA) / URY(MON)
Poa spiciformis var. spiciformis	ARG(SCR, TDF) / CHL(MAG)
Poa spiciformis var. ibari	ARG(CHU, SCR) / CHL(MAG)
Poa stenantha	ARG(NEU, RNE, SCR, TDF) / CHL(MAU, BIO, ARA, AIS, MAG, RME)
Poa stuckertii	ARG(COR, SLU)
Poa superata	ARG(JUJ, LRI, SAL, TUC) / CHL(TAR)
Poa trachyantha	CHL(AIS)
Poa tricolor	CHL(VAL)
Poa trivialis	ARG(BAI, CHU, JUJ, NEU, RNE, SAL, TDF) / CHL(VAL, BIO, LLA, MAG, RME)
Poa tucumana	ARG(CAT, TUC)
Poa umbrosa	BRA(PAR, SCA)
Poa uruguayensis	URY(MON)
Poa yaganica	ARG(TDF) / CHL(MAG)
Podagrostis sesquiflora	ARG(MEN, RNE) / CHL(MAU, BIO, ARA, LLA)
Podanthus mitiqui	CHL(COQ, VAL, LBO, MAU, RME)
Podanthus ovatifolius	CHL(COQ, VAL, LBO, MAU, BIO, ARA)
Podocarpus lambertii	BRA(PAR, RGS, SCA)
Podocarpus nubigenus	ARG(CHU, NEU, RNE) / CHL(ARA, LLA, AIS, MAG)
Podocarpus parlatorei	ARG(CAT, JUJ, SAL, TUC)
Podocarpus salignus	CHL(MAU, BIO, ARA, LLA)
Podocarpus sellowii var. sellowii	BRA(PAR, RGS)
Podocarpus sellowii var. angustifolia	BRA(PAR)
Podocoma bellidifolia	BRA(PAR)
Podocoma blanchetiana	ARG(COS, MIS) / BRA(SCA) / PRY(APA, AMA, CAU, CON, COA, SPE)
Podocoma hieracifolia	ARG(BAI, CAT, CHA, COR, COS, ERI, JUJ, LPA, MIS) / BRA(PAR, RGS) / PRY(CAU, CON, MIE) / URY(FLA, MON, ROC)
Podocoma hirsuta	ARG(BAI, CHA, COR, COS, ERI, FOR, MIS, SFE, TUC) / BRA(PAR, RGS, SCA) / PRY(APA) / URY(CAS, FLA, SJO)
Podocoma spegazzinii	ARG(CHA, SAL) / BRA(RGS, SCA) / URY(RIV)
Podophorus bromoides	CHL(JFE)
Podostemum comatum	ARG(COS, ERI, MIS) / BRA(PAR, RGS, SCA) / PRY(AMA, CON, GUA) / URY(RNO, SAO)
Podostemum distichum	ARG(COS, ERI, MIS) / BRA(PAR, RGS, SCA) / PRY(APA, CON, COA, PAI) / URY(RNO, SAO, SOR)
Podostemum irgangii	BRA(PAR, SCA)
Podostemum muelleri	ARG(COS, ERI, MIS) / BRA(PAR, RGS, SCA) / URY(SAO)
Podostemum rutifolium	ARG(COS, ERI, MIS) / BRA(PAR, RGS, SCA) / PRY(AMA, CON) / URY(SAO, SOR)
Podranea ricasoliana	ARG(BAI) / BRA(RGS)
Poecilanthe parviflora	ARG(BAI, COS, ERI, MIS) / BRA(PAR, RGS, SCA) / PRY(AMA) / URY(ART, COL, MON, PAY, RNO, SAO, SOR)
Pogoniopsis schenckii	BRA(PAR)
Pogonopus tubulosus	ARG(JUJ, SAL, TUC) / BRA(Fuera del área del proyecto)
Poikilacanthus glandulosus	ARG(BAI, COS, DFE, ERI, MIS) / BRA(PAR, RGS, SCA) / PRY(APA, CAU, CAA, CAN, GUA, ITA, MIE, PAI) / URY(SAO)
Poiretia angustifolia	BRA(PAR)
Poiretia latifolia	ARG(COS, MIS) / BRA(PAR, RGS, SCA) / PRY(APA, COA)
Poiretia tetraphylla	ARG(BAI, CHA, COR, COS, ERI, LPA, SDE, SFE, TUC) / BRA(PAR, RGS, SCA) / URY(CAS, CLA, COL, FLA, MAL, MON, PAY, RIV, ROC, TAC, TYT)
Poissonia heterantha	ARG(CAT, JUJ, LRI, SAL, SJU, TUC)
Poissonia hypoleuca	ARG(JUJ, SAL, TUC)
Polemonium micranthum	ARG(CHU, MEN, NEU, RNE, SCR, TDF) / CHL(COQ, VAL, AIS, MAG, RME)
Polyachyrus annuus	CHL(TAR, ANT, ATA, COQ)
Polyachyrus carduoides	CHL(ANT, ATA, COQ, VAL)
Polyachyrus cinereus	CHL(ANT, ATA)
Polyachyrus fuscus	CHL(TAR, ANT, ATA, COQ, VAL)
Polyachyrus gayi	CHL(ATA, COQ)
Polyachyrus poeppigii ssp. poeppigii	CHL(ANT, ATA, COQ, VAL, MAU, RME)
Polyachyrus poeppigii ssp. multifidus	CHL(ANT, ATA)
Polyachyrus sphaerocephalus	CHL(TAR, ANT)
Polybotrya cylindrica	BRA(PAR, RGS, SCA)
Polybotrya goyazensis	BRA(Fuera del área del proyecto) / PRY(AMA)
Polybotrya semipinnata	BRA(SCA)
Polycarpaea corymbosa var. corymbosa	ARG(COS, MIS)
Polycarpaea corymbosa var. brasiliensis	PRY(AMA)
Polycarpaea hassleriana	PRY(CEN, COA, GUA, PAI)
Polycarpon apurense	ARG(COS, ERI, MIS) / BRA(Fuera del área del proyecto) / PRY(CEN)
Polycarpon coquimbense	CHL(COQ)
Polycarpon suffruticosum	ARG(BAI, CAT, CHA, COR, COS, ERI, FOR, JUJ, LRI, SAL, SDE, SFE, TUC) / PRY(APY, BOQ, ÑEE, PHA)
Polycarpon tetraphyllum	ARG(BAI, COR, COS, ERI, SAL, SDE, SFE, SJU, SLU, TUC) / BRA(RGS) / CHL(VAL, LBO, MAU, BIO, ARA, LLA, RME, JFE, IPA) / URY(ROC)
Polygala adenophylla var. parvifolia	BRA(PAR) / PRY(AMA, CAU, COA)
Polygala adenophylla var. adenophylla	ARG(CHA, COS, FOR, MIS, SFE) / BRA(RGS) / PRY(AMA, COA, GUA, SPE) / URY(PAY, RIV)
Polygala altomontana	BRA(PAR, SCA)
Polygala aphylla	BRA(PAR, RGS, SCA) / URY(FLA, LAV, RNO, RIV, TAC)
Polygala argentinensis	ARG(CAT, JUJ, LRI, SAL, TUC)
Polygala aspalatha	ARG(BAI, CHA, COR, COS, ERI, FOR, LPA, MIS, SFE, SLU) / BRA(PAR, RGS, SCA) / PRY(AMA, CAU, COA, SPE) / URY(CAS, MON, TAC)
Polygala australis	ARG(BAI, COS, ERI, SFE) / BRA(RGS) / URY(CAS, CLA, MAL, MON, PAY, RNO, RIV, ROC, SAO, SJO, SOR, TAC)
Polygala boliviensis	ARG(JUJ, SAL, TUC)
Polygala bonariensis	ARG(BAI, COS, ERI, MIS, SFE) / BRA(RGS) / URY(CLA, COL, DUR, FLO, FLA, MAL, MON, PAY, RNO, SAO, SJO, SOR)
Polygala brasiliensis	ARG(BAI, COS, ERI, MIS) / BRA(PAR, RGS, SCA) / PRY(APA, MIE) / URY(CLA, MON, RNO, RIV, SJO, TAC)
Polygala campestris	BRA(PAR, RGS, SCA) / URY(RIV, TAC)
Polygala cneorum	BRA(PAR, RGS, SCA) / PRY(CAN)
Polygala corralitae	ARG(JUJ, SAL, SJU, TUC)
Polygala cyparissias	ARG(BAI, ERI, SFE) / BRA(PAR, RGS, SCA) / URY(CAS, MON, ROC)
Polygala darwiniana	ARG(CHU, NEU, RNE, SCR) / CHL(MAG)
Polygala densiracemosa	BRA(RGS, SCA)
Polygala desiderata	ARG(CHU, MEN, SCR)
Polygala duarteana	ARG(BAI, CHA, COR, COS, ERI, FOR, JUJ, MIS, SAL, SDE, SFE, TUC) / BRA(RGS) / PRY(APY, APA, AMA, CAU, CAN, CEN, CON, COA, GUA, PAI, PHA) / URY(CLA, DUR, MON, PAY, RIV, SAO, SJO, TAC)
Polygala dusenii	BRA(PAR)
Polygala equisetoides	BRA(RGS, SCA)
Polygala fimbriata	BRA(PAR)
Polygala gayi	CHL(VAL, LBO, MAU, BIO, ARA, LLA, RME)
Polygala glochidiata	ARG(COS, FOR) / BRA(PAR) / PRY(APY, AMA, CAU, CAN, CON, COA, ITA, MIE, PAI, SPE)
Polygala gnidioides	ARG(CHU, NEU, RNE) / CHL(COQ, VAL, LBO, MAU, BIO, ARA, LLA, AIS, RME)
Polygala gracilis	BRA(Fuera del área del proyecto) / PRY(CAN)
Polygala guaranitica	PRY(AMA, CON)
Polygala hickeniana	ARG(CHU, MEN, NEU, RNE, SCR)
Polygala hieronymi	ARG(COR, SLU, TUC)
Polygala hygrophila	BRA(Fuera del área del proyecto) / PRY(CAU, CAA, CAN, ÑEE)
Polygala insignis	BRA(PAR)
Polygala jujuyensis	ARG(CAT, JUJ, LRI, SAL)
Polygala kurtzii	ARG(MEN)
Polygala lancifolia	ARG(MIS) / BRA(PAR, RGS, SCA) / PRY(APA)
Polygala laureola	BRA(PAR, SCA) / PRY(APY)
Polygala leptocaulis	ARG(CHA, COS, ERI, FOR, MIS) / BRA(PAR, RGS, SCA) / PRY(APA, AMA, CEN, CON, COA, GUA, MIE, PAI, SPE) / URY(CAS, MAL, MON, RIV, SJO, TAC)
Polygala leucantha	BRA(Fuera del área del proyecto) / PRY(AMA, CAU, COA, PAI)
Polygala linoides var. laxiflora	ARG(MIS)
Polygala linoides var. linoides	ARG(BAI, COR, COS, ERI, MIS, SFE) / BRA(PAR, RGS, SCA) / PRY(AMA, CAA, MIE, PAI, PHA) / URY(CAS, COL, DUR, FLA, MON, ROC, SOR)
Polygala longicaulis	ARG(COS) / BRA(PAR, RGS, SCA) / PRY(AMA, CAU, CAA, CAN, CON, COA, GUA, ITA, PAI, SPE)
Polygala lycopodioides	BRA(PAR)
Polygala molluginifolia	ARG(CHA, COS, ERI, FOR, JUJ, MIS, SAL, SFE, TUC) / BRA(PAR, RGS, SCA) / PRY(APY, APA, CAU, CAN, CEN, CON, COA, GUA, ITA, MIE, ÑEE, PAI, PHA,) / URY(ART, CLA, MON, RIV, SAO, TAC, TYT)
Polygala monosperma	BRA(PAR) / PRY(AMA, CAU, PAI)
Polygala moquiniana	BRA(PAR, SCA)
Polygala obovata	ARG(CHA, COS, MIS) / BRA(PAR, RGS, SCA) / PRY(APY, APA, AMA, CAU, CAN, CON, COA, GUA, ITA, MIE, PAI, PHA, SPE) / URY(SAO)
Polygala oedipus	ARG(SCR)
Polygala oreophila	ARG(MEN, NEU, RNE)
Polygala oxyphylla	BRA(PAR)
Polygala paniculata	ARG(COS, ERI) / BRA(PAR, RGS, SCA) / PRY(GUA)
Polygala patagonica	ARG(CHU, NEU, SCR)
Polygala persistens	ARG(MEN) / CHL(MAU)
Polygala poaya	BRA(Fuera del área del proyecto) / PRY(AMA)
Polygala pterolopha	ARG(CAT, LRI, SJU)
Polygala pulchella	ARG(BAI, CAT, CHA, COS, ERI, JUJ, MIS, SAL, SFE, TUC) / BRA(PAR, RGS, SCA) / PRY(APA, CAU, CAN, GUA, PAI, SPE) / URY(ART, CLA, DUR, MAL, MON, RIV, ROC, SOR, TAC)
Polygala pumila	BRA(PAR, RGS, SCA)
Polygala punctata	ARG(COS, MIS) / BRA(RGS) / PRY(APA, AMA, CAN, COA, GUA, MIE, PAI) / URY(CLA)
Polygala resedoides	ARG(BAI, ERI, LPA) / URY(FLA, LAV, MAL, MON, PAY, RIV, SAO, SOR)
Polygala riograndensis	BRA(RGS)
Polygala rojasii	ARG(FOR, MIS) / BRA(RGS) / PRY(AMA, CAN, CEN)
Polygala rosei	ARG(RNE)
Polygala sabuletorum	ARG(CHU, SCR)
Polygala sabulosa	BRA(PAR, RGS, SCA)
Polygala salasiana	ARG(CHU, MEN, NEU, RNE, SCR, TDF) / CHL(ATA, COQ, LBO, MAU, BIO, ARA, AIS, MAG, RME)
Polygala santacruzensis	ARG(SCR)
Polygala selaginoides	BRA(PAR, RGS, SCA) / PRY(AMA, ITA, SPE)
Polygala solieri	CHL(ATA)
Polygala spinescens	ARG(LPA, MEN, NEU, SJU)
Polygala stenophylla	ARG(BAI, CHU, COR, LPA, LRI, MEN, NEU, RNE, SJU, SLU)
Polygala subandina	ARG(BAI, CAT, COR, JUJ, LPA, LRI, MEN, NEU, RNE, SAL, SJU, SLU, SFE, SDE, TUC) / CHL(BIO, ARA, RME)
Polygala subverticillata	BRA(PAR, RGS, SCA)
Polygala telephium	BRA(PAR, RGS) / PRY(CAN)
Polygala tenuis	BRA(PAR, RGS, SCA) / PRY(AMA, CAU, PAI)
Polygala timoutoides	ARG(COS, MIS) / BRA(PAR, RGS, SCA) / PRY(AMA, CAU, CAN, CEN, CON, COA, GUA, MIE, ÑEE, PAI, PHA, SPE) / URY(RIV)
Polygala ventanensis	ARG(BAI)
Polygala williamsii	ARG(MEN)
Polygonum acuminatum	ARG(BAI, CAT, CHA, COR, COS, ERI, FOR, JUJ, LPA, LRI, MIS, SAL, SDE, SFE, SLU, TUC) / BRA(PAR, RGS, SCA) / CHL(VAL, LBO, MAU, BIO, IPA) / PRY(APA, APY, AMA, CAU, CAA, CAN, CEN, CHO, CON, COA, GUA, MIE, ÑEE, PAI, PHA, SPE) / URY(LAV, ROC)
Polygonum amphibium	ARG(BAI, RNE)
Polygonum arenarium	ARG(RNE)
Polygonum aviculare	ARG(BAI, CAT, CHA, CHU, COR, COS, DFE, ERI, FOR, JUJ, LPA, LRI, MEN, MIS, NEU, RNE, SAL, SCR, SDE, SFE, SJU, SLU, TDF, TUC) / BRA(RGS) / CHL(TAR, ANT, ATA, COQ, VAL, LBO, MAU, BIO, ARA, LLA, AIS, MAG, RME, JFE) / PRY(PHA) / URY(CAS, SJO)
Polygonum bowenkampii	CHL(RME)
Polygonum brasiliense	ARG(BAI, CHA, CHU, COR, ERI, JUJ, LPA, LRI, MEN, NEU, RNE, SAL, SCR, SDE, SFE, SJU, SLU, TDF, TUC) / BRA(RGS) / CHL(AIS) / URY(SJO)
Polygonum campanulatum	CHL(LLA)
Polygonum convolvulus	ARG(BAI, CAT, CHA, COR, COS, ERI, LPA, MEN, MIS, NEU, RNE, SDE, SFE, SLU, TDF, TUC) / BRA(RGS) / CHL(COQ, VAL, LBO, BIO, ARA, LLA, AIS, RME) / PRY(COA, GUA, ITA)
Polygonum ferrugineum	ARG(BAI, CHA, COS, ERI, FOR, MIS, SFE, TUC) / BRA(RGS) / PRY(CEN, CON, COA, ÑEE, PAI, PHA)
Polygonum glabrum	ARG(BAI, COS, ERI, LRI, SAL, SFE, TUC) / BRA(RGS, SCA) / PRY(PHA) / URY(CAS, COL, MON, RNO, ROC, SJO, TYT)
Polygonum hispidum	ARG(BAI, CAT, CHA, COR, COS, ERI, FOR, JUJ, SAL, SDE, SFE, TUC) / BRA(Fuera del área del proyecto) / PRY(APY, BOQ, CEN, CHO, COA, ÑEE, PHA)
Polygonum hydropiper	CHL(BIO, LLA)
Polygonum hydropiperoides var. hydropiperoides	ARG(BAI, CAT, CHA, CHU, COR, COS, ERI, JUJ, LPA, MEN, MIS, SAL, SDE, SFE, SJU, SLU, TUC) / BRA(RGS, SCA) / CHL(TAR, ATA, VAL, LBO, MAU, BIO, ARA, LLA, RME, JFE) / PRY(APA, CAA, CEN, COA, GUA, ITA, MIE, ÑEE, PAI, PHA, SPE) / URY(COL, PAY, ROC)
Polygonum hydropiperoides var. setaceum	ARG(BAI, CHA, COS, ERI, FOR, MIS, SFE, TUC) / BRA(PAR, RGS) / PRY(CAA, CEN, COA, GUA, ITA, MIE, PAI, PHA, SPE) / URY(CLA)
Polygonum lapathifolium	ARG(BAI, CAT, CHU, COR, COS, ERI, JUJ, LPA, LRI, MEN, MIS, NEU, RNE, SAL, SCR, SFE, SJU, SLU) / CHL(MAU, BIO, ARA, LLA, RME, JFE) / PRY(CON, PHA) / URY(CAS)
Polygonum maritimum	ARG(BAI, CAT, LPA, NEU, RNE, SCR, SFE, SJU, SLU, TDF) / CHL(COQ, VAL, BIO, LLA, AIS, MAG)
Polygonum meisnerianum	ARG(BAI, CHA, COR, COS, ERI, FOR, MIS, SAL, SFE) / BRA(PAR, RGS, SCA) / PRY(APA, AMA, CAA, CEN, COA, GUA, ITA, MIE, ÑEE, PAI, SPE) / URY(CLA, PAY, SJO)
Polygonum minus	ARG(MEN, MIS, RNE, SFE)
Polygonum mite	CHL(VAL)
Polygonum orientale	ARG(BAI, COR, ERI, MEN) / BRA(RGS) / CHL(BIO, ARA, RME) / URY(MON)
Polygonum paraguayense	ARG(BAI, CHA, COS, ERI, FOR, SFE) / PRY(CEN, CON, COA, ÑEE, PHA, SPE)
Polygonum persicaria	ARG(BAI, CAT, CHU, COR, COS, ERI, FOR, JUJ, LRI, MEN, MIS, NEU, RNE, SAL, SDE, SFE, SJU, SLU, TDF, TUC) / BRA(RGS) / CHL(TAR, ATA, COQ, VAL, LBO, MAU, BIO, ARA, LLA, AIS, RME)
Polygonum punctatum	ARG(BAI, CAT, CHA, COR, COS, ERI, FOR, JUJ, LRI, MIS, NEU, SAL, SDE, SFE, SJU, SLU, TUC) / BRA(PAR, RGS, SCA) / PRY(APY, APA, AMA, CAA, CAN, CEN, CON, COA, GUA, ITA, ÑEE, PAI, PHA, SPE) / URY(CAS, ROC, SJO, TAC)
Polygonum rubricaule	BRA(PAR) / PRY(CAU)
Polygonum sanguinaria	CHL(COQ, VAL, BIO, AIS, RME)
Polygonum stelligerum	ARG(BAI, CHA, COS, ERI, MIS, SFE) / BRA(PAR, RGS, SCA) / PRY(ITA, MIE, PHA, SPE) / URY(SJO)
Polygonum stypticum	ARG(BAI, CHA, COR, ERI, LPA, LRI, MEN, NEU, RNE, SAL, SFE, SJU, TUC) / URY(RNO)
Polylepis australis	ARG(CAT, COR, JUJ, SAL, SLU, TUC)
Polylepis crista-galli	ARG(JUJ, SAL)
Polylepis hieronymi	ARG(JUJ, SAL, TUC)
Polylepis rugulosa	CHL(TAR)
Polylepis tarapacana	ARG(JUJ) / CHL(TAR, ANT)
Polylepis tomentella	ARG(JUJ, SAL)
Polyphlebium angustatum	ARG(JUJ, MIS, SAL) / BRA(PAR, RGS, SCA) / PRY(AMA, COA, PAI) / URY(CLA, TAC)
Polyphlebium diaphanum	BRA(PAR) / PRY(CAN)
Polypodium chrysolepis	ARG(CAT, JUJ, SAL, TUC)
Polypodium masafuerae	CHL(JFE)
Polypodium pycnocarpum	CHL(ANT)
Polypogon australis	ARG(CHU, LPA, MEN, NEU, RNE, SAL, SJU, SCR, TUC) / CHL(TAR, ANT, ATA, COQ, VAL, LBO, MAU, BIO, ARA, LLA, AIS, RME, JFE)
Polypogon cachinalensis	CHL(COQ)
Polypogon chilensis	ARG(BAI, CHA, COS, DFE, ERI, MIS, RNE, SFE, SDE) / BRA(PAR, RGS, SCA) / CHL(ANT, ATA, VAL, MAU, BIO, LLA, RME, JFE) / PRY(GUA, PAI) / URY(FLO, MON, ROC, SJO)
Polypogon elongatus var. elongatus	ARG(BAI, CAT, CHU, COR, COS, DFE, ERI, JUJ, LPA, LRI, MEN, MIS, RNE, SAL, SJU, SLU, SFE, SDE, TUC) / BRA(PAR, RGS, SCA) / CHL(MAU, LLA, RME) / URY(MAL, ROC)
Polypogon elongatus var. longearistatus	ARG(BAI)
Polypogon elongatus var. strictus	CHL(ARA, LLA)
Polypogon exasperatus	ARG(CAT, CHU, JUJ, LRI, NEU, RNE, SCR, TUC) / BRA(SCA) / CHL(LBO, MAU, BIO, ARA, LLA, AIS, MAG, RME)
Polypogon exasperatus var. kuntzei	ARG(CAT, CHU, JUJ, MEN, NEU, SJU, SCR) / CHL(ATA, COQ, BIO, RME)
Polypogon imberbis	ARG(BAI, CHU, COR, DFE, ERI, JUJ, LPA, LRI, RNE, SLU, SCR, SFE, TUC) / BRA(RGS) / CHL(COQ, LBO, MAU, ARA, LLA, JFE) / URY(DUR, MON, SJO)
Polypogon interruptus	ARG(CAT, CHU, COR, JUJ, LRI, MEN, NEU, SAL, SJU, SLU, TUC) / CHL(TAR, ANT, ATA, COQ, VAL, LBO, MAU, BIO, ARA, LLA, RME)
Polypogon linearis	CHL(TAR, ANT, ATA, COQ, VAL, LBO, MAU, BIO, LLA, RME)
Polypogon magellanicus	ARG(CHU, NEU, RNE, SCR, TDF) / CHL(ARA, LLA, AIS, MAG)
Polypogon maritimus	ARG(BAI) / BRA(RGS) / CHL(VAL, BIO) / URY(MON, SJO)
Polypogon monspeliensis	ARG(BAI, CAT, CHU, COR, DFE, ERI, JUJ, LPA, LRI, MEN, NEU, RNE, SAL, SCR, SDE, SFE, SJU, SLU, TUC) / BRA(RGS) / CHL(TAR, ANT, ATA, COQ, VAL, LBO, MAU, BIO, ARA, LLA, RME) / PRY(CEN) / URY(ROC)
Polypogon viridis	ARG(BAI, CAT, CHU, COR, DFE, ERI, JUJ, LPA, LRI, MEN, NEU, RNE, SAL, SJU, SLU, TUC) / CHL(TAR, ANT, COQ, VAL, BIO, ARA, LLA, RME) / URY(MON)
Polypsecadium arnottianum	ARG(CAT, LRI, MEN, SAL, SJU, SLU)
Polypsecadium brasiliense	BRA(SCA)
Polypsecadium gilliesii	ARG(CAT, COR, JUJ, LRI, SAL, SJU, SLU, TUC)
Polypsecadium grandiflorum	ARG(CAT, COR, JUJ, SAL, TUC)
Polypsecadium harmsianum	ARG(JUJ, SAL, TUC)
Polypsecadium litorale	CHL(BIO)
Polypsecadium magellanicum	ARG(SCR, TDF) / CHL(MAG)
Polypsecadium tucumanense	ARG(JUJ, TUC)
Polypsecadium zoellneri	CHL(ATA)
Polystachya bradei	BRA(PAR)
Polystachya caespitosa	BRA(PAR, RGS, SCA)
Polystachya concreta	ARG(COS, JUJ, MIS, SAL) / BRA(PAR, RGS, SCA) / PRY(AMA, CAA, GUA, SPE)
Polystachya edwallii	BRA(PAR)
Polystachya foliosa	ARG(COS, MIS, SAL) / BRA(PAR, RGS, SCA) / PRY(PAI)
Polystachya micrantha	BRA(RGS)
Polystachya nana	BRA(PAR)
Polystachya pinicola	BRA(SCA)
Polystichum aculeolatum	BRA(PAR, RGS, SCA)
Polystichum andinum	ARG(CHU, NEU, RNE, SCR, TDF) / CHL(LBO, MAU, BIO, ARA, LLA, AIS, MAG, RME)
Polystichum caudescens	BRA(RGS)
Polystichum chilense var. chilense	ARG(CHU, NEU, RNE, SCR, TDF) / CHL(MAU, BIO, ARA, LLA, AIS, MAG)
Polystichum giganteum	BRA(RGS, SCA)
Polystichum laniceps	BRA(RGS)
Polystichum longecuspis	BRA(PAR, RGS, SCA)
Polystichum mohrioides	ARG(TDF)
Polystichum montevidense	ARG(BAI, CAT, COR, COS, JUJ, LRI, MIS, SAL, SLU, TUC) / BRA(PAR, RGS, SCA) / PRY(CAA, PAI) / URY(MAL)
Polystichum multifidum var. multifidum	ARG(CHU, NEU, RNE, SCR, TDF) / CHL(LLA, AIS, MAG)
Polystichum platylepis	ARG(MIS) / BRA(PAR, RGS, SCA)
Polystichum platyphyllum var. klotzschii	ARG(MIS) / BRA(RGS, SCA) / URY(TAC)
Polystichum platyphyllum var. platyphyllum	ARG(JUJ, MIS, SAL, TUC) / BRA(RGS, SCA) / PRY(CAA, GUA, SPE)
Polystichum plicatum	ARG(BAI, CHU, COR, MEN, NEU, RNE, SCR, TDF) / CHL(COQ, VAL, LBO, MAU, BIO, ARA, LLA, AIS, MAG, RME)
Polystichum pycnolepis	ARG(COR, JUJ, SAL, SLU, TUC)
Polystichum subintegerrimum	ARG(CHU, RNE) / CHL(BIO, ARA, LLA, AIS, MAG)
Polystichum tetragonum	CHL(JFE)
Polystichum tijucense	BRA(RGS)
Polytaenium cajenense	BRA(PAR, SCA)
Polytaenium lineatum	ARG(SAL, TUC) / BRA(PAR, RGS, SCA) / PRY(AMA)
Pomaria parviflora	PRY(COA)
Pomaria pilosa	BRA(RGS) / PRY(COA) / URY(CLA, RNO, RIV, TAC, TYT)
Pomaria rubicunda var. hauthalii	ARG(MIS) / PRY(APA, AMA, CAU, CAN, COA)
Pomaria rubicunda var. rubicunda	ARG(COS, MIS) / BRA(PAR, RGS) / PRY(APA, CAA, CAN, GUA, ITA, MIE, SPE) / URY(ART, MON, SAO)
Pomaria stipularis	BRA(PAR, SCA)
Pombalia atropurpurea	ARG(JUJ, SAL) / BRA(PAR) / PRY(CON)
Pombalia bicolor	ARG(COS, FOR, MIS) / BRA(RGS) / PRY(CAU, GUA, MIE, PAI) / URY(MON)
Pombalia bigibbosa	ARG(COS, MIS, SAL) / BRA(PAR, RGS, SCA) / PRY(APA, AMA, CAA, CAN, CEN, COA, ITA, ÑEE, PAI, SPE)
Pombalia brevicaulis	BRA(PAR)
Pombalia calceolaria	ARG(COS, ERI, MIS) / PRY(APY, AMA, BOQ, CAN, CON, SPE)
Pombalia chodatii	ARG(COS, MIS) / PRY(APY, CEN, COA, GUA, PAI)
Pombalia communis	ARG(CHA, COS, ERI, FOR, JUJ, MIS, SAL, SFE) / BRA(PAR, RGS, SCA) / PRY(APA, APY, AMA, CAA, CAN, CEN, COA, GUA, ITA, ÑEE, PAI, SPE) / URY(SAO)
Pombalia glauca	BRA(PAR) / PRY(APY, SPE)
Pombalia graminifolia	ARG(CHA, COS, FOR) / PRY(APY, AMA, BOQ, PAI, PHA)
Pombalia hassleriana	PRY(APY, PAI)
Pombalia hieronymi	ARG(CAT, CHA, FOR, JUJ, SAL, SDE, TUC) / PRY(APY)
Pombalia lanata	ARG(MIS) / BRA(Fuera del área del proyecto)
Pombalia leucopogon	ARG(COS)
Pombalia longistyla	ARG(COS, MIS) / PRY(COA, PHA)
Pombalia oppositifolia	ARG(FOR) / BRA(Fuera del área del proyecto) / PRY(APY, AMA, CEN, COA, PHA)
Pombalia paraguariensis	ARG(COS, MIS, SAL) / BRA(RGS) / PRY(APA, CEN, PAI, SPE)
Pombalia parviflora	ARG(BAI, CAT, CHA, COR, COS, ERI, FOR, JUJ, LPA, LRI, MEN, MIS, RNE, SAL, SLU, SFE, SDE, TUC) / BRA(PAR, RGS, SCA) / CHL(LBO, BIO) / PRY(APY, CEN, COA, ÑEE, PHA, SPE) / URY(ART, CAS, COL, CLA, FLO, FLA, LAV, MAL, MON, PAY, RIV, ROC, SAO, SJO)
Pombalia rivalis	URY(RIV, TAC)
Pombalia serrata	ARG(BAI, CAT, COR, LPA, LRI, MEN, SAL, SJU, SLU, SDE, TUC)
Pombalia velutina	BRA(PAR, RGS) / PRY(CAU, CAA, CAN, ITA, PHA)
Poncirus trifoliata	ARG(BAI, ERI)
Ponera striata	BRA(PAR)
Pontederia cordata var. cordata	ARG(BAI, CHA, COS, DFE, ERI, FOR, MEN, MIS, SFE) / BRA(PAR, RGS, SCA) / PRY(APY, AMA, CAU, CAN, CEN, CON, COA, GUA, ITA, MIE, ÑEE, PAI, PHA, SPE) / URY(CAS, CLA, COL, FLA, MAL, RNO, ROC, TAC)
Pontederia cordata var. ovalis	ARG(COS) / BRA(PAR, RGS) / PRY(CAN) / URY(CAS, ROC)
Pontederia rotundifolia	ARG(BAI, CHA, COS, DFE, ERI, FOR, MIS, SFE) / BRA(PAR) / PRY(APA, CEN, CON, COA, ÑEE, PAI, PHA) / URY(MON, ROC)
Pontederia subovata	ARG(CHA, COS, FOR, MIS, SFE) / BRA(RGS) / PRY(APY, CEN, CON, COA, ÑEE, PHA)
Ponthieva hassleri	PRY(AMA)
Ponthieva mandonii var. bilobipetala	ARG(TUC) / BRA(Fuera del área del proyecto)
Ponthieva mandonii var. mandonii	ARG(JUJ, SAL, TUC) / BRA(Fuera del área del proyecto)
Populus alba	ARG(RNE)
Populus deltoides	ARG(COR)
Populus nigra	ARG(RNE)
Porlieria chilensis	CHL(COQ, VAL, LBO, RME)
Porlieria microphylla	ARG(BAI, CAT, CHA, COR, COS, ERI, FOR, JUJ, LRI, SAL, SDE, SFE, SJU, SLU, TUC) / URY(COL)
Porophyllum angustissimum	ARG(ERI, MIS) / BRA(Fuera del área del proyecto)
Porophyllum cabrerae	ARG(SAL)
Porophyllum hasslerianum	PRY(AMA, CON)
Porophyllum lanceolatum	ARG(CAT, CHA, COR, COS, ERI, FOR, JUJ, MIS, SAL, SFE, SDE, TUC) / BRA(RGS, SCA) / PRY(COA, GUA, PAI)
Porophyllum linifolium	ARG(ERI) / BRA(RGS) / URY(CAS, COL, LAV, MAL, MON, PAY, SOR, TAC)
Porophyllum obscurum	ARG(BAI, CAT, CHA, COR, COS, DFE, ERI, FOR, JUJ, LRI, MEN, MIS, SAL, SJU, SLU, SFE, SDE, TUC) / BRA(PAR, RGS) / PRY(AMA, CON, MIE) / URY(SJO, TAC)
Porophyllum oppositifolium	BRA(Fuera del área del proyecto) / PRY(AMA)
Porophyllum ruderale	ARG(CAT, CHA, COR, COS, ERI, FOR, JUJ, LRI, MIS, SAL, SDE, SFE, SJU, TUC) / BRA(PAR, RGS, SCA) / CHL(ANT) / PRY(APY, AMA, CAA, CEN, GUA, ITA, SPE) / URY(ART, TAC)
Porophyllum spathulatum	BRA(RGS)
Portulaca amilis	ARG(CHA, COS, FOR, MIS, SAL, SDE, SFE, TUC) / BRA(Fuera del área del proyecto) / PRY(APY, CEN, CON, SPE) / URY(ART)
Portulaca argentinensis	ARG(SAL)
Portulaca chacoana	ARG(CHA, FOR) / PRY(APY, PHA)
Portulaca confertifolia var. cordobensis	ARG(COR, SLU)
Portulaca confertifolia var. confertifolia	ARG(CAT, LRI, MEN, SJU, SLU)
Portulaca cryptopetala	ARG(BAI, CHA, COR, COS, ERI, FOR, JUJ, MIS, SAL, SFE, TUC) / BRA(RGS) / PRY(APY, ÑEE, PAI, SPE) / URY(ART, CAS, DUR, FLO, MON, PAY, ROC, SAO, TYT)
Portulaca diegoi	BRA(SCA)
Portulaca echinosperma	ARG(CAT, LRI, MEN, SAL, SJU, SLU, TUC)
Portulaca elongata var. elongata	ARG(JUJ, LRI, SAL)
Portulaca elongata var. pedicellata	ARG(JUJ, LRI, SAL)
Portulaca eruca	ARG(COR, SDE, SLU) / PRY(APY)
Portulaca fluvialis var. tacuaremboënsis	URY(TAC, TYT)
Portulaca fulgens	ARG(CAT, JUJ, LRI, SLU, TUC)
Portulaca gilliesii	ARG(BAI, CHA, COS, ERI, FOR, SAL, SFE, SLU, TUC) / PRY(APY, CEN) / URY(RNO)
Portulaca grandiflora	ARG(BAI, CAT, CHA, CHU, COR, COS, ERI, FOR, JUJ, LPA, LRI, MEN, NEU, RNE, SAL, SJU, SLU, SFE, TUC) / BRA(PAR, RGS) / PRY(APY, BOQ, CEN, CON, MIE, PHA) / URY(ART, CLA, COL, MAL, MON, PAY, RNO, SAO, SJO, TYT)
Portulaca hatschbachii	BRA(PAR)
Portulaca meyeri var. rodrigoi	ARG(COS)
Portulaca meyeri var. meyeri	ARG(COS)
Portulaca mucronata var. mucronata	BRA(PAR)
Portulaca mucronata var. paraguariensis	PRY(COA, PAI)
Portulaca mucronulata var. robusta	ARG(SFE)
Portulaca mucronulata var. mucronulata	ARG(CAT, LRI, SAL, SDE, SFE, SJU, TUC) / BRA(PAR)
Portulaca obtusa	ARG(CAT, COR, JUJ, LRI, SAL, SDE, SJU, SLU, TUC)
Portulaca obtusifolia var. rubrisperma	ARG(COS)
Portulaca obtusifolia var. obtusifolia	ARG(COR)
Portulaca oleracea	ARG(BAI, CAT, CHA, CHU, COR, COS, ERI, FOR, JUJ, LPA, LRI, MEN, MIS, NEU, RNE, SAL, SDE, SFE, SJU, SLU, TUC) / BRA(PAR, RGS, SCA) / CHL(TAR, ATA, VAL, LBO, MAU, ARA, LLA, RME, JFE, IPA) / PRY(APY, PHA) / URY(CLA, MON, SOR)
Portulaca papulifera	ARG(MIS) / BRA(RGS, SCA) / URY(ART, RIV, TAC)
Portulaca papulosa	ARG(BAI, COR, ERI, LPA, MIS) / URY(CAS, COL, FLA, MAL, MON, RIV, SJO, SOR, TAC)
Portulaca perennis	ARG(CAT, JUJ, LRI, SAL, SJU)
Portulaca philippii	CHL(TAR, ANT, ATA)
Portulaca ragonesei	ARG(COR)
Portulaca rotundifolia	ARG(JUJ, LRI, SAL)
Portulaca stellulato-tuberculata	PRY(CEN)
Portulaca thellusonii	BRA(SCA)
Portulaca tingoensis var. tingoensis	ARG(JUJ, LRI, SAL)
Portulaca tingoensis var. andina	ARG(JUJ, LRI, SAL)
Portulaca umbraticola	ARG(CAT, CHA, COR, COS, FOR, JUJ, LRI, MIS, SAL, SJU, SDE, TUC) / BRA(Fuera del área del proyecto) / PRY(ÑEE, PHA)
Posoqueria latifolia	BRA(PAR, RGS, SCA)
Potamogeton crispus	ARG(BAI)
Potamogeton ferrugineus	ARG(BAI, COR, COS, ERI, RNE, SCR, SLU, TUC) / BRA(RGS, SCA) / CHL(AIS) / URY(COL, FLA, ROC)
Potamogeton gayi	ARG(BAI, COS, ERI, FOR, JUJ, LRI, SFE) / BRA(RGS, SCA) / CHL(ARA) / PRY(CEN, MIE) / URY(DUR, MAL, MON, ROC, SJO, TAC)
Potamogeton illinoensis	ARG(BAI, COS, RNE) / BRA(PAR) / CHL(VAL, ARA, LLA, MAG) / PRY(CON) / URY(ROC)
Potamogeton linguatus	ARG(CHU, NEU, RNE, SCR, TDF) / CHL(BIO, ARA, LLA, AIS, MAG)
Potamogeton montevidensis	ARG(COS) / BRA(SCA) / CHL(BIO) / PRY(Desconocida) / URY(SJO)
Potamogeton polygonus	ARG(BAI, COS, ERI, MIS) / BRA(PAR, SCA) / URY(DUR, FLA, SAO)
Potamogeton pusillus	ARG(BAI, CAT, COR, COS, ERI, JUJ, LRI, MEN, SAL, SDE, SFE, SJU, SLU, TUC) / BRA(PAR, RGS, SCA) / CHL(ANT, ATA, VAL, LBO, MAU, BIO, ARA, LLA, RME) / PRY(CEN) / URY(FLO, MON, ROC)
Potamogeton spirilliformis	ARG(BAI, COS, ERI) / BRA(RGS) / CHL(VAL) / URY(ROC)
Potentilla anserina	ARG(CHU, LPA, MEN, NEU, RNE, SCR, TDF) / CHL(ARA)
Potentilla chiloensis	ARG(NEU, RNE) / CHL(LBO, MAU, BIO, ARA, LLA, AIS, JFE)
Potentilla recta	ARG(CHU, NEU, RNE)
Potentilla reptans	CHL(RME)
Potentilla tucumanensis	ARG(CAT, COR, LRI, SJU, SLU, TUC)
Potentilla vesca	ARG(CAT, ERI, LPA, TUC) / BRA(SCA)
Pourouma guianensis	BRA(PAR, SCA)
Pouteria beaurepairei	BRA(PAR, SCA)
Pouteria bullata	BRA(PAR)
Pouteria caimito	BRA(SCA)
Pouteria durlandii	BRA(PAR)
Pouteria fragrans	ARG(COS, MIS) / PRY(COA, PAI)
Pouteria gardneri	BRA(SCA) / PRY(AMA, CEN, CON, COA, GUA, PAI)
Pouteria gardneriana	ARG(CHA, COS, ERI, FOR, MIS, SFE) / BRA(RGS, SCA) / PRY(APY, CON, COA, ÑEE, PAI) / URY(PAY, RIV, SAO)
Pouteria glomerata	ARG(CHA, COS, FOR, MIS) / BRA(PAR) / PRY(APA, APY, AMA, CAU, CAA, CAN, CEN, CON, COA, GUA, ITA, MIE, ÑEE, PAI, PHA, SPE)
Pouteria lucuma	CHL(ATA)
Pouteria ramiflora	BRA(Fuera del área del proyecto) / PRY(AMA)
Pouteria salicifolia	ARG(BAI, COS, ERI, MIS) / BRA(PAR, RGS, SCA) / PRY(ITA, PAI) / URY(CAS, COL, DUR, MAL, PAY, RNO, RIV, ROC, SAO, SOR, TYT)
Pouteria splendens	CHL(COQ, VAL)
Pouteria subcaerulea	BRA(Fuera del área del proyecto) / PRY(AMA, CAN)
Pouteria torta	BRA(PAR) / PRY(AMA)
Pouteria venosa	BRA(PAR, SCA)
Pozoa coriacea	ARG(CHU, MEN, NEU, RNE, SJU) / CHL(COQ, VAL, LBO, MAU, BIO, ARA, RME)
Pozoa volcanica	ARG(MEN, NEU) / CHL(BIO, ARA, LLA)
Pradosia brevipes	BRA(PAR) / PRY(AMA, CAU, CAN)
Pradosia lactescens	BRA(PAR)
Praxelis clematidea	ARG(CAT, CHA, COR, COS, ERI, FOR, JUJ, MIS, SAL, SLU, SFE, SDE, TUC) / PRY(APY, AMA, BOQ, CAU, CAN, CEN, CHO, CON, COA, GUA, MIE, ÑEE, NAS, PAI, PHA, SPE)
Praxelis kleinioides	ARG(MIS) / BRA(PAR, RGS, SCA) / PRY(AMA, CAN, CON, ÑEE)
Praxelis missiona	ARG(COS, MIS) / BRA(RGS, SCA) / PRY(APA, GUA, ITA, MIE)
Praxelis ostenii	ARG(COS) / PRY(AMA, CAU, CEN, CON, COA, GUA, ÑEE, PAI, SPE)
Praxelis pauciflora 	BRA(RGS) / PRY(CEN)
Prescottia densiflora	BRA(PAR, RGS, SCA)
Prescottia lancifolia	BRA(PAR, SCA)
Prescottia montana	ARG(JUJ) / BRA(PAR, SCA)
Prescottia oligantha	ARG(CHA, COS, FOR, MIS) / BRA(PAR, RGS, SCA) / PRY(AMA, CAN) / URY(CAS)
Prescottia ostenii	BRA(RGS) / URY(CAS)
Prescottia phleoides	BRA(PAR)
Prescottia plantaginifolia	BRA(PAR, SCA)
Prescottia stachyodes	ARG(MIS) / BRA(PAR, RGS, SCA) / PRY(PAI)
Prestonia calycina	ARG(COS, MIS) / BRA(Fuera del área del proyecto) / PRY(CAU, GUA, ITA, PAI, SPE)
Prestonia coalita	ARG(MIS) / BRA(PAR, RGS, SCA) / PRY(APY, APA, AMA, CAU, CAN, CON, SPE)
Prestonia cyaniphylla	ARG(COS, JUJ, MIS, SAL) / BRA(PAR) / PRY(APA, AMA, CAU, CAN, CEN, COA, GUA, PAI, SPE)
Prestonia dusenii	BRA(PAR, SCA)
Prestonia erecta	BRA(Fuera del área del proyecto) / PRY(AMA, CON)
Prestonia lagoensis	ARG(Desconocida) / BRA(Fuera del área del proyecto) / PRY(APY, AMA, CON, PAI) / URY(Desconocida)
Prestonia quinquangularis	ARG(FOR, MIS, SAL) / BRA(Fuera del área del proyecto) / PRY(APY, APA, AMA, CAU, CAN, CEN, CON, PAI, SPE)
Prestonia riedelii	ARG(MIS, SAL) / BRA(PAR, RGS) / PRY(APA, AMA, CAA, CEN, CON, COA, GUA, PAI)
Prestonia tomentosa	BRA(Fuera del área del proyecto) / PRY(APA, AMA, CAN, CON, COA, GUA, PAI)
Primula comberi	ARG(CHU, NEU, RNE)
Primula magellanica	ARG(CHU, NEU, RNE, SCR, TDF) / CHL(ARA, LLA, AIS, MAG)
Primula malacoides	ARG(JUJ, SAL)
Priogymnanthus hasslerianus	BRA(Fuera del área del proyecto) / PRY(AMA, CON)
Pristimera celastroides	ARG(CHA, COS, ERI, FOR, JUJ, MIS, SAL) / BRA(PAR, RGS, SCA) / PRY(APA, AMA, CAU, CAN, CEN, CON, COA, GUA, ITA, MIE, PAI, SPE) / URY(PAY, RNO, SAO)
Priva boliviana	ARG(FOR, SAL) / PRY(APY, BOQ, PHA)
Prockia crucis	ARG(CHA, COS, FOR, JUJ, MIS, SAL, TUC) / BRA(PAR, SCA) / PRY(APA, AMA, CAU, CAN, CEN, CON, COA, GUA, ÑEE, PAI, PHA, SPE) / URY(ART)
Promenaea acuminata	BRA(SCA)
Promenaea catharinensis	BRA(SCA)
Promenaea dusenii	BRA(PAR)
Promenaea fuerstenbergiana	BRA(SCA)
Promenaea rollisonii	BRA(PAR, RGS, SCA)
Promenaea stapelioides	BRA(PAR, SCA)
Promenaea xanthina	BRA(PAR, SCA)
Proserpinaca palustris var. australis	BRA(SCA) / URY(MON)
Prosopanche americana	ARG(CAT, CHA, COR, FOR, LPA, LRI, MEN, SAL, SJU, SLU, SDE) / PRY(PHA)
Prosopanche bonacinai	ARG(BAI, CAT, COR, LPA, LRI, MEN, MIS, NEU, SLU, TUC) / BRA(RGS) / PRY(APA)
Prosopidastrum angusticarpum	ARG(BAI, LPA, NEU, RNE, SLU)
Prosopidastrum benthami	ARG(MEN)
Prosopidastrum dehiscens	ARG(MEN, SJU)
Prosopidastrum globosum	ARG(CAT, MEN, TUC)
Prosopidastrum gracile	ARG(CAT, MEN, SJU)
Prosopidastrum striatum	ARG(BAI, CHU, MEN, NEU, RNE, SCR)
Prosopis abbreviata	ARG(CAT, COR, COS, SDE, SJU, SLU)
Prosopis affinis	ARG(BAI, CHA, COR, COS, ERI, FOR, SDE, SFE) / BRA(RGS) / PRY(APY, CEN, CON, COA, ÑEE, PAI) / URY(ART, CLA, COL, MON, PAY, RNO, RIV, SAO, SOR)
Prosopis alba var. alba	ARG(BAI, CHA, COR, COS, ERI, FOR, JUJ, SAL, SDE, SFE, SLU) / CHL(TAR, ANT, ATA) / PRY(APY, CEN, ÑEE, PHA)
Prosopis alba var. panta	ARG(CHA, COR, COS, ERI, JUJ, SAL, SFE, SLU, TUC) / PRY(APY)
Prosopis alpataco f. rubra	ARG(MEN)
Prosopis alpataco var. lamaro	ARG(LPA, MEN)
Prosopis alpataco f. alpataco	ARG(BAI, CHU, LPA, LRI, MEN, NEU, RNE, SJU)
Prosopis argentina	ARG(CAT, LRI, MEN, SJU)
Prosopis burkartii	CHL(TAR)
Prosopis caldenia	ARG(BAI, COR, LPA, MEN, RNE, SLU)
Prosopis calingastana	ARG(SJU)
Prosopis campestris	ARG(COR, SLU)
Prosopis castellanosii	ARG(LPA, MEN, NEU)
Prosopis chilensis var. chilensis	ARG(CAT, COR, LRI, MEN, SAL, SDE, SJU, SLU, TUC) / CHL(ATA, COQ, VAL, LBO, RME) / PRY(APY)
Prosopis chilensis var. riojana	ARG(CAT, LRI)
Prosopis chilensis var. catamarcana	ARG(CAT, COR, LRI, SAL, TUC)
Prosopis denudans var. denudans	ARG(CHU, NEU, RNE, SCR)
Prosopis denudans var. stenocarpa	ARG(CHU, LPA, SCR)
Prosopis denudans var. patagonica	ARG(MEN, NEU, RNE, SCR)
Prosopis elata	ARG(CHA, COR, FOR, LRI, SAL, SDE, SFE) / PRY(APY, PHA)
Prosopis ferox	ARG(JUJ, SAL)
Prosopis fiebrigii	ARG(FOR) / PRY(APY, PHA)
Prosopis flexuosa f. subinermis	ARG(BAI, LPA, SAL, SJU, TUC)
Prosopis flexuosa var. depressa	ARG(CHU, LPA, MEN, NEU, RNE, SJU)
Prosopis flexuosa var. fruticosa	ARG(LPA, RNE) / CHL(ATA, COQ)
Prosopis flexuosa f. flexuosa	ARG(BAI, CAT, COR, LPA, LRI, MEN, RNE, SAL, SJU, SLU, TUC) / CHL(TAR, ANT, ATA, COQ)
Prosopis hassleri var. hassleri	ARG(CHA, FOR, SFE) / PRY(APY, CEN, CON, PHA)
Prosopis hassleri var. nigroides	ARG(SFE)
Prosopis humilis	ARG(BAI, COR, LPA, SLU)
Prosopis kuntzei	ARG(CHA, COR, COS, ERI, FOR, LRI, SAL, SDE, SFE) / PRY(APY, CON, PHA)
Prosopis nigra var. nigra	ARG(BAI, CAT, CHA, COR, COS, ERI, FOR, JUJ, LRI, SAL, SDE, SFE, SJU, SLU, TUC) / BRA(RGS) / PRY(APY, CEN, MIE, ÑEE, PAI, PHA) / URY(ART, PAY, RNO, SAO, SOR)
Prosopis nigra var. longispina	ARG(CHA, COS)
Prosopis nigra var. ragonesei	ARG(SFE)
Prosopis nuda	PRY(APY, PHA)
Prosopis pugionata	ARG(CAT, COR, LRI, MEN, SJU, SLU)
Prosopis reptans var. chilensis	CHL(ATA)
Prosopis reptans var. reptans	ARG(COR, LRI, RNE, SDE, SFE, SJU, TUC)
Prosopis rojasiana	PRY(APY)
Prosopis rubiflora	BRA(Fuera del área del proyecto) / PRY(APY, AMA, CON)
Prosopis ruizleali	ARG(LPA, MEN, NEU)
Prosopis ruscifolia	ARG(CHA, COR, FOR, SAL, SDE, SFE, TUC) / BRA(Fuera del área del proyecto) / PRY(APY, CON, PHA)
Prosopis sericantha	ARG(CAT, CHA, COR, FOR, LRI, MEN, SAL, SJU, SLU, SFE, SDE, TUC) / PRY(APY)
Prosopis strombulifera var. ruiziana	ARG(MEN)
Prosopis strombulifera var. strombulifera	ARG(BAI, CAT, COR, JUJ, LPA, LRI, MEN, NEU, RNE, SAL, SJU, SLU, TUC) / CHL(TAR, ATA, COQ, VAL, LBO)
Prosopis tamarugo	CHL(TAR, ANT)
Prosopis torquata	ARG(CAT, COR, LRI, MEN, SAL, SDE, SJU, SLU, TUC)
Prosopis vinalillo	ARG(CHA, COR, FOR, SAL, SFE, SDE, TUC) / PRY(APY, PHA)
Prosthechea bulbosa	BRA(PAR, RGS, SCA)
Prosthechea fausta	BRA(PAR, RGS, SCA)
Prosthechea fragrans	BRA(PAR, RGS, SCA)
Prosthechea inversa	BRA(PAR, RGS, SCA)
Prosthechea papilio	BRA(RGS, SCA)
Prosthechea punctifera	BRA(PAR, RGS, SCA)
Prosthechea pygmaea	BRA(RGS, SCA)
Prosthechea tigrina	BRA(PAR, RGS, SCA)
Prosthechea vespa	BRA(PAR, RGS, SCA)
Protium heptaphyllum	BRA(PAR) / PRY(AMA, CAU, CAN, CON, COA, PAI)
Protium kleinii	BRA(PAR, RGS, SCA)
Proustia cuneifolia var. mollis	ARG(JUJ, SAL)
Proustia cuneifolia var. mendocina	ARG(CAT, COR, LPA, LRI, MEN, SJU, SLU, TUC)
Proustia cuneifolia f. cinerea	CHL(COQ, VAL, RME)
Proustia cuneifolia f. tipia	CHL(ANT)
Proustia cuneifolia var. cuneifolia	ARG(CAT, JUJ, LRI, SAL, SJU, TUC) / CHL(TAR, COQ, VAL, LBO, MAU, BIO, RME)
Proustia ilicifolia f. ilicifolia	CHL(ATA, COQ, RME)
Proustia ilicifolia f. baccharoides	CHL(ATA, COQ, VAL, LBO, RME)
Proustia pyrifolia f. pyrifolia	CHL(COQ, VAL, LBO, MAU, BIO, ARA, LLA)
Proustia pyrifolia f. glandulosa	CHL(VAL)
Prumnopitys andina	ARG(NEU) / CHL(LBO, MAU, BIO, ARA, LLA)
Prunella laciniata	ARG(NEU)
Prunella vulgaris	ARG(BAI, CHU, COR, DFE, ERI, MIS, NEU, RNE, SAL, TDF, TUC) / BRA(RGS, SCA) / CHL(COQ, VAL, LBO, MAU, BIO, ARA, LLA, AIS, MAG, RME, JFE) / URY(CAS, FLA)
Prunus armeniaca	ARG(LPA)
Prunus avium	ARG(CHU, NEU, RNE)
Prunus brasiliensis	ARG(MIS) / BRA(PAR, RGS, SCA)
Prunus cerasifera	ARG(NEU, RNE)
Prunus cerasus	ARG(BAI, NEU, RNE, SCR)
Prunus chamissoana	ARG(MIS) / BRA(Fuera del área del proyecto) / PRY(CAA)
Prunus domestica	ARG(BAI)
Prunus douglasii	PRY(AMA, CON)
Prunus instititia	ARG(COR)
Prunus laurocerasus	ARG(NEU, RNE)
Prunus ligustrina	BRA(PAR, RGS, SCA) / PRY(APA, AMA, CAA, PAI)
Prunus mahaleb	ARG(BAI, NEU, RNE, SLU)
Prunus myrtifolia	BRA(PAR, RGS, SCA)
Prunus oleifolia	PRY(PAI)
Prunus omissa	PRY(COA, PAI)
Prunus padus	ARG(NEU, RNE)
Prunus persica var. persica	ARG(BAI, DFE, ERI, JUJ, LPA, MIS, SAL, TUC)
Prunus persica var. aposarca	ARG(COR, JUJ, TUC)
Prunus ravenii	PRY(APA, CAU, MIE, PAI, SPE)
Prunus sellowii	BRA(PAR, RGS, SCA)
Prunus subcoriacea	ARG(COS, MIS) / BRA(PAR, RGS, SCA) / PRY(AMA, CAN, ITA) / URY(RIV, TAC, TYT)
Prunus tucumanensis	ARG(CAT, JUJ, SAL, TUC)
Prunus ulei	BRA(PAR, SCA)
Pseudabutilon aristulosum	ARG(COS, MIS, SAL) / BRA(Fuera del área del proyecto) / PRY(AMA)
Pseudabutilon benense	PRY(AMA, COA, GUA, PAI)
Pseudabutilon callimorphum var. callimorphum	ARG(CHA, COR, COS, ERI, FOR, JUJ, LRI, SAL) / PRY(APY, CON, PHA)
Pseudabutilon callimorphum var. intermedium	ARG(FOR) / PRY(PHA)
Pseudabutilon cinereum	ARG(CAT, COR, LRI, SAL, SDE, SJU)
Pseudabutilon pedunculatum	ARG(CAT, CHA, COR, COS, ERI, FOR, JUJ, LRI, SAL, SDE, SFE, SLU, TUC) / PRY(APY, PHA)
Pseudabutilon virgatum	ARG(BAI, CAT, CHA, COR, COS, ERI, FOR, JUJ, LPA, LRI, MEN, SAL, SDE, SFE, SJU, SLU, TUC) / BRA(Fuera del área del proyecto) / PRY(APY, BOQ, CEN, CHO, PHA)
Pseudananas sagenarius	ARG(CHA, COS, ERI, FOR, MIS, SFE) / BRA(PAR) / PRY(APY, CAU, CAN, CEN, CON, COA, GUA, ÑEE, PAI)
Pseudechinolaena polystachya	ARG(BAI, CAT, COS, ERI, JUJ, MIS, SAL, SFE, TUC) / BRA(PAR, RGS, SCA) / PRY(APA, CAU, CAA, CEN, COA, GUA, PAI) / URY(CLA, RIV, TAC)
Pseudelephantopus spiralis	ARG(JUJ, SAL)
Pseuderanthemum riedelianum	BRA(PAR, SCA)
Pseudobombax argentinum	ARG(JUJ, SAL) / BRA(Fuera del área del proyecto) / PRY(APY, AMA, CON, COA, PAI)
Pseudobombax grandiflorum var. majus	BRA(PAR)
Pseudobombax grandiflorum var. grandiflorum	BRA(PAR, RGS, SCA)
Pseudobombax longiflorum	BRA(PAR, SCA) / PRY(APY, AMA)
Pseudobombax marginatum	BRA(Fuera del área del proyecto) / PRY(AMA)
Pseudobombax tomentosum	BRA(Fuera del área del proyecto) / PRY(APY, AMA, CON, COA)
Pseudocyclanthera australis	PRY(CEN, CON)
Pseudognaphalium aldunateoides	ARG(CAT, CHU, MEN, NEU, RNE, SJU) / CHL(COQ, VAL, LBO, MAU, BIO, ARA, LLA, RME, JFE)
Pseudognaphalium cabrerae	ARG(BAI, CAT, COR, LRI, MEN, RNE, SAL, SJU, SLU, SFE) / CHL(TAR, MAU, ARA, RME)
Pseudognaphalium cheiranthifolium	ARG(BAI, COR, ERI, JUJ, LPA, LRI, MEN, SAL, SLU, SFE) / BRA(PAR, RGS, SCA) / CHL(COQ, VAL, LBO, MAU, BIO, ARA, LLA, RME, JFE) / URY(CAS, CLA, LAV, MAL, MON, ROC, SJO, SJO, TYT)
Pseudognaphalium cymatoides	ARG(CHU, NEU, RNE) / CHL(COQ, VAL, LBO, MAU, BIO, ARA, LLA, RME)
Pseudognaphalium dysodes	ARG(CAT, COR, JUJ, LRI, TUC)
Pseudognaphalium gaudichaudianum	ARG(BAI, CAT, CHA, CHU, COR, COS, DFE, ERI, FOR, JUJ, LPA, LRI, MEN, MIS, NEU, RNE, SAL, SJU, SLU, SFE, TUC) / BRA(PAR, RGS, SCA) / PRY(CEN, PHA) / URY(ART, CAS, CLA, FLA, MAL, MON, PAY, RNO, ROC, TAC, TYT)
Pseudognaphalium gayanum	ARG(SLU) / CHL(TAR, ANT, ATA, COQ, VAL, LBO, MAU, BIO, LLA, AIS, MAG, RME)
Pseudognaphalium glanduliferum	ARG(CAT, COR, JUJ, LRI, SAL)
Pseudognaphalium jujuyense	ARG(JUJ, SAL, TUC)
Pseudognaphalium lacteum	ARG(CAT, JUJ, SAL) / CHL(TAR, ANT, COQ, BIO)
Pseudognaphalium leucopeplum	ARG(BAI, CAT, CHU, COR, JUJ, LPA, LRI, NEU, RNE, SAL, SJU, SLU, TUC) / BRA(RGS) / URY(MON, SJO)
Pseudognaphalium luteoalbum	ARG(TDF) / BRA(RGS) / CHL(RME)
Pseudognaphalium munoziae	CHL(TAR)
Pseudognaphalium psilophyllum	ARG(CAT, COR, JUJ, LRI, MEN, NEU, RNE, SAL, TUC) / CHL(TAR, ANT, COQ, VAL, LBO, MAU, LLA)
Pseudognaphalium tarapacanum	ARG(CAT, COR, JUJ, LRI, SAL, SLU, TUC) / CHL(TAR, ANT, COQ, MAU, BIO, RME)
Pseudognaphalium viravira	ARG(BAI, CHU, JUJ, LRI, MEN, NEU, RNE, SAL, SJU, SCR, TDF) / CHL(TAR, ATA, COQ, VAL, LBO, MAU, BIO, ARA, LLA, AIS, MAG, RME)
Pseudognaphalium yalaense	ARG(CAT, JUJ, SAL, TUC)
Pseudogynoxys benthamii	ARG(CHA, COS, FOR, JUJ, MIS, SAL, SFE) / BRA(Fuera del área del proyecto) / PRY(APA, CAU, CAA, CEN, COA, GUA, ITA, MIE, ÑEE, PAI, PHA, SPE)
Pseudolmedia hirtula	BRA(PAR, SCA)
Pseudolmedia laevigata	BRA(Fuera del área del proyecto) / PRY(AMA)
Pseudolycopodiella meridionalis	ARG(COS) / BRA(PAR, RGS, SCA) / PRY(CAU, CAN) / URY(CAS, MON)
Pseudopiptadenia warmingii	BRA(PAR, SCA)
Pseudoplantago friesii	ARG(MIS) / BRA(PAR, RGS, SCA)
Pseudostelis spiralis	BRA(PAR, RGS, SCA)
Pseudotsuga menziesii	ARG(NEU, RNE)
Psidium araucanum	BRA(PAR)
Psidium australe var. australe	ARG(MIS) / BRA(PAR) / PRY(APA, AMA, CAA, CAN, ITA, MIE, PAI)
Psidium australe var. argenteum	ARG(COS) / BRA(PAR) / PRY(CAN)
Psidium australe var. suffruticosum	BRA(PAR) / PRY(AMA, CAN)
Psidium cattleianum	BRA(PAR, RGS, SCA) / URY(CLA, ROC, TYT)
Psidium grandifolium	ARG(COS, MIS) / BRA(PAR) / PRY(AMA, CAU, CAA, CAN, ITA, ÑEE, PAI, SPE)
Psidium guajava	ARG(CHA, COS, FOR, JUJ, MIS, SAL, TUC) / BRA(PAR, RGS, SCA) / PRY(APY, AMA, BOQ, CAU, CAA, CAN, CEN, COA, GUA, ÑEE, PAI, PHA)
Psidium guineense	ARG(COS, MIS) / BRA(SCA) / PRY(AMA, CAA, CAN, CEN, CON, COA, ÑEE, PAI)
Psidium hians	ARG(COS, MIS) / BRA(Fuera del área del proyecto) / PRY(COA, ÑEE)
Psidium imaruinense	BRA(SCA)
Psidium kennedyanum	ARG(CHA, COS, ERI, FOR, SFE) / BRA(PAR) / PRY(APY, CAU, CON, GUA, PHA)
Psidium laruotteanum	BRA(PAR) / PRY(CAN)
Psidium longipetiolatum	BRA(PAR, SCA)
Psidium missionum	ARG(MIS) / PRY(CAA, GUA, ITA, PAI)
Psidium ooideum	PRY(PAI)
Psidium salutare var. salutare	BRA(PAR, RGS, SCA) / PRY(CAU)
Psidium salutare var. mucronatum	ARG(COS, ERI, MIS, TUC) / BRA(PAR, RGS) / PRY(ITA, PAI) / URY(ART, CAS, CLA, MAL, MON, PAY, RIV, ROC, SAO, SJO, SOR, TAC)
Psidium salutare var. sericeum	ARG(COS, ERI, MIS, TUC) / BRA(RGS) / PRY(CEN, COA, MIE, PAI) / URY(CLA, DUR, MON, PAY, RIV, SJO, TAC)
Psidium salutare var. decussatum	BRA(PAR)
Psidium spathulatum	BRA(PAR, SCA)
Psiguria ternata	BRA(PAR) / PRY(APA, AMA)
Psilocarphus brevissimus	ARG(CHU, SCR) / CHL(COQ, RME)
Psilocarphus tenellus var. globiferus	CHL(COQ, VAL, LBO, RME)
Psilochilus dusenianus	BRA(PAR)
Psilochilus modestus	BRA(PAR, RGS, SCA)
Psilotum nudum	ARG(CHA, COS, MIS, SAL) / BRA(RGS, SCA) / PRY(APA, AMA, CAU, CAN, CEN, CON, COA, PAI, SPE) / URY(ROC)
Psittacanthus cordatus	ARG(CHA, FOR) / BRA(Fuera del área del proyecto) / PRY(APY, CEN, CHO, PHA, SPE)
Psoralea pinnata var. speciosa	URY(MON, ROC)
Psychotria anceps	BRA(Fuera del área del proyecto) / PRY(AMA, CAN, COA, PAI)
Psychotria argentinensis	ARG(JUJ, SAL)
Psychotria brachyceras	BRA(PAR, RGS, SCA)
Psychotria brevicollis	ARG(MIS) / BRA(Fuera del área del proyecto) / PRY(APA, CAA, CAN, GUA, PAI, SPE)
Psychotria capillacea	BRA(Fuera del área del proyecto) / PRY(AMA, CAU, CAN, CEN, CON, COA, GUA, PAI, SPE)
Psychotria capitata	BRA(Fuera del área del proyecto) / PRY(COA)
Psychotria carthagenensis	ARG(BAI, CHA, COS, ERI, FOR, JUJ, MIS, SAL, SFE, TUC) / BRA(PAR, RGS, SCA) / PRY(APA, AMA, CAU, CAA, CAN, CEN, CON, COA, GUA, ITA, MIE, ÑEE, PAI, PHA, SPE) / URY(CLA, COL, PAY, RIV, ROC, SAO, SJO, TYT)
Psychotria deflexa	ARG(MIS) / BRA(PAR) / PRY(CAN)
Psychotria dusenii	BRA(PAR, SCA)
Psychotria fractistipula	BRA(SCA)
Psychotria gracilenta	BRA(Fuera del área del proyecto) / PRY(AMA, CAN)
Psychotria hastisepala	BRA(PAR, SCA)
Psychotria hoffmannseggiana	BRA(PAR) / PRY(CAN)
Psychotria laciniata	BRA(PAR, RGS, SCA)
Psychotria leiocarpa	ARG(COS, MIS) / BRA(PAR, RGS, SCA) / PRY(APA, CAA, CAN, COA, GUA, PAI, SPE)
Psychotria longipes	BRA(PAR, SCA)
Psychotria malaneoides	BRA(PAR, SCA)
Psychotria mapourioides	BRA(PAR, SCA)
Psychotria myriantha	ARG(COS, MIS) / BRA(PAR, RGS, SCA) / PRY(APA, AMA, CAN)
Psychotria nemorosa	BRA(PAR, SCA)
Psychotria nitidula	ARG(MIS) / BRA(RGS) / PRY(AMA, CAA, COA, PAI, SPE)
Psychotria nuda	BRA(PAR, RGS, SCA)
Psychotria stachyoides	BRA(PAR, SCA)
Psychotria suterella	ARG(MIS) / BRA(PAR, RGS, SCA)
Psychotria tenerior	BRA(Fuera del área del proyecto) / PRY(AMA, CAN, CON, PAI)
Psychotria umbellata	BRA(PAR, RGS, SCA)
Psychotria vellosiana	BRA(PAR, SCA) / PRY(AMA, PAI)
Psygmorchis pusilla	BRA(PAR)
Pterichis boliviana	ARG(JUJ, SAL)
Pterichis multiflora	ARG(SAL)
Pteridium arachnoideum	ARG(BAI, CAT, CHA, COR, COS, ERI, JUJ, LRI, MIS, SAL, TUC) / BRA(PAR, RGS, SCA) / PRY(AMA, CAA, CAN, COA) / URY(ART, CLA, FLO, LAV, MAL, ROC, SAO, SJO, TAC, TYT)
Pteris altissima	BRA(PAR, SCA) / PRY(CAN)
Pteris angustata	BRA(PAR, SCA)
Pteris berteroana	CHL(VAL, JFE)
Pteris brasiliensis	ARG(CHA, COS, FOR, MIS, SAL, SFE) / BRA(PAR, RGS, SCA) / PRY(APY, CEN)
Pteris chilensis	CHL(VAL, LBO, MAU, BIO, ARA, LLA)
Pteris cretica	ARG(BAI, COS, ERI, JUJ, SAL, TDF, TUC) / BRA(Fuera del área del proyecto) / PRY(GUA, ITA)
Pteris decurrens	BRA(PAR, RGS, SCA)
Pteris deflexa	ARG(JUJ, MIS, SAL, TUC) / BRA(PAR, RGS, SCA) / PRY(APA, AMA, CAA, CAN, COA, GUA, PAI) / URY(MON, TYT)
Pteris denticulata var. tristicula	ARG(COS, JUJ, MIS, SAL) / BRA(PAR, SCA)
Pteris denticulata var. denticulata	ARG(CHA, COS, FOR, JUJ, MIS, SAL, SFE) / BRA(PAR, RGS, SCA) / PRY(APY, CAA, CAN, CEN, COA, GUA, PAI, SPE)
Pteris exigua	ARG(JUJ, SAL, TUC)
Pteris famatinensis	ARG(LRI)
Pteris inermis	ARG(JUJ, SAL)
Pteris lechleri	ARG(MIS) / BRA(PAR, RGS, SCA)
Pteris leptophylla	BRA(PAR, SCA)
Pteris multifida	ARG(BAI, CHA, DFE, SAL) / BRA(Fuera del área del proyecto) / URY(MON)
Pteris plumula	ARG(JUJ, MIS, SAL) / BRA(RGS) / PRY(AMA, CAN)
Pteris podophylla	BRA(SCA)
Pteris propinqua	BRA(PAR, SCA) / PRY(AMA)
Pteris semiadnata	ARG(CHU, NEU, RNE) / CHL(BIO, ARA, LLA, AIS, MAG)
Pteris sotae	ARG(SAL)
Pteris splendens	BRA(PAR, RGS, SCA) / PRY(Desconocida)
Pteris vittata	ARG(BAI, CAT, CHA, COR, COS, DFE, ERI, JUJ, MIS, SAL, SFE, TUC) / BRA(PAR, SCA) / URY(MON, PAY, SAO)
Pterocactus araucanus	ARG(CHU, NEU, RNE)
Pterocactus australis	ARG(CHU, RNE, SCR) / CHL(AIS)
Pterocactus fischeri	ARG(MEN, NEU, RNE)
Pterocactus gonjianii	ARG(SJU)
Pterocactus hickenii	ARG(CHU, SCR) / CHL(AIS)
Pterocactus megliolii	ARG(SJU)
Pterocactus reticulatus	ARG(MEN, SJU)
Pterocactus tuberosus f. tuberosus	ARG(BAI, CAT, COR, LPA, LRI, MEN, NEU, RNE, SAL, SJU, SLU, TUC)
Pterocactus tuberosus f. lelongii	ARG(MEN, SJU)
Pterocactus valentinii	ARG(CHU, LPA, MEN, NEU)
Pterocarpus rohrii	BRA(PAR, SCA)
Pterocarpus santalinoides	ARG(COS, FOR) / PRY(APY, CEN, CON)
Pterocaulon alopecuroides	ARG(CHA, COR, COS, FOR, JUJ, MIS, SAL, SFE, SLU, TUC) / BRA(PAR, RGS, SCA) / PRY(APY, AMA, CAU, CAA, CAN, CEN, COA, GUA, PAI, PHA) / URY(MON, ROC)
Pterocaulon angustifolium	ARG(COR, COS, ERI, MIS) / BRA(PAR, RGS, SCA) / PRY(AMA, CAU, CAA, CAN, CEN, COA, GUA, ITA, MIE, PAI, SPE) / URY(PAY)
Pterocaulon balansae	ARG(BAI, COR, COS, ERI, MIS, TUC) / BRA(PAR, RGS, SCA) / PRY(APA, AMA, CAU, CEN, COA, GUA, PAI) / URY(CAS, MON, ROC, SJO, TYT)
Pterocaulon cordobense	ARG(BAI, CHA, COR, COS, DFE, ERI, FOR, LPA, SFE, SLU) / BRA(RGS) / PRY(COA, GUA, PHA) / URY(CAS, COL, MAL, MON, SOR)
Pterocaulon lanatum	ARG(SAL) / BRA(PAR) / PRY(AMA, COA, PAI, SPE)
Pterocaulon lorentzii	ARG(BAI, CHA, COS, ERI, FOR, MIS, SFE, TUC) / BRA(PAR, RGS, SCA) / PRY(AMA, CEN, COA, GUA, ÑEE, PHA) / URY(CAS, COL, MAL, MON, RNO, ROC, SJO, TAC)
Pterocaulon polypterum	ARG(COS, MIS) / BRA(RGS, SCA) / URY(CLA)
Pterocaulon polystachyum	ARG(CHA, COS, ERI, FOR, MIS, SFE) / BRA(RGS, SCA) / PRY(APA, AMA, CAU, CAA, CEN, COA, GUA, PAI) / URY(MON, PAY)
Pterocaulon purpurascens	ARG(BAI, CHA, COR, COS, ERI, FOR, JUJ, SAL, SFE, SDE, TUC) / PRY(APY, CEN, CON, COA, PHA)
Pterocaulon rugosum	ARG(CHA, COR, COS, ERI, MIS) / BRA(PAR, RGS, SCA) / PRY(AMA, CEN, PHA, SPE)
Pterocaulon virgatum	ARG(BAI, CAT, CHA, COR, COS, ERI, FOR, JUJ, SAL, SDE, SFE, TUC) / BRA(RGS, SCA) / PRY(APY, APA, AMA, CAU, CAN, CEN, COA, GUA, MIE, PAI, PHA) / URY(ART, MON, PAY, RNO, ROC)
Pteroglossa glazioviana	BRA(PAR) / PRY(CAA)
Pteroglossa luteola	ARG(COS)
Pteroglossa magnifica	PRY(AMA)
Pteroglossa regia	ARG(MIS)
Pteroglossa rhombipetala	ARG(SFE) / PRY(GUA)
Pterogyne nitens	ARG(CHA, COS, ERI, FOR, JUJ, MIS, SAL, TUC) / BRA(PAR, RGS, SCA) / PRY(APY, AMA, CAU, CAN, CEN, COA, ÑEE, NAS, PAI) / URY(SAO)
Pterolepis buraeavii	BRA(Fuera del área del proyecto) / PRY(PAI)
Pterolepis glomerata	BRA(PAR, SCA) / PRY(CAN, PHA)
Pterolepis repanda	ARG(JUJ, MIS) / BRA(Fuera del área del proyecto) / PRY(AMA, CAU, CAN, COA, PAI, PHA)
Pteropepon argentinense	ARG(CAT, JUJ, SAL, TUC)
Pteropepon parodii	ARG(SAL)
Ptilochaeta densiflora	BRA(Fuera del área del proyecto) / PRY(APY)
Ptilochaeta nudipes	ARG(JUJ, SAL) / PRY(APY)
Puccinellia argentinensis	ARG(CAT, JUJ, LRI, MEN, SAL, SJU) / CHL(ATA)
Puccinellia biflora	ARG(SCR, TDF) / CHL(MAG)
Puccinellia frigida	ARG(CAT, JUJ, LRI, MEN, SAL, SJU, TUC) / CHL(TAR, ANT, ATA, COQ)
Puccinellia glaucescens	ARG(BAI, CHU, DFE, ERI, LPA, MEN, RNE, SJU, SLU, SCR, SFE, TDF) / CHL(COQ, VAL, BIO, LLA, AIS, MAG, RME) / URY(MON)
Puccinellia magellanica	ARG(CHU, SCR, TDF) / CHL(MAG)
Puccinellia mendozina	ARG(BAI, CHU, COR, LPA, MEN, SAL, SJU, SCR)
Puccinellia parvula	ARG(SAL, TUC)
Puccinellia preslii	ARG(CHU, MEN, SCR, SJU) / CHL(ATA, COQ)
Puccinellia pusilla	ARG(CHU, NEU, SCR, TDF) / CHL(MAG)
Puccinellia skottsbergii	ARG(CHU, SCR, TDF) / CHL(MAG)
Pueraria montana var. lobata	ARG(MIS)
Puna bonniae	ARG(CAT)
Puna clavarioides	ARG(MEN, SJU)
Puna subterranea	ARG(JUJ)
Puya alpestris	ARG(NEU, SJU) / CHL(COQ, VAL, LBO, MAU, BIO, ARA, RME)
Puya assurgens	ARG(JUJ)
Puya berteroniana	CHL(VAL, LBO)
Puya boliviensis	CHL(ANT, ATA)
Puya bravoi	ARG(SAL)
Puya castellanosii	ARG(SAL)
Puya chilensis	CHL(COQ, VAL, LBO, BIO, RME)
Puya coerulea var. monteroana	CHL(LBO)
Puya coerulea var. intermedia	CHL(VAL, LBO, RME)
Puya coerulea var. violacea	CHL(VAL, LBO, MAU, BIO)
Puya coerulea var. coerulea	CHL(COQ, VAL, LBO, RME)
Puya dyckioides	ARG(JUJ, SAL, TUC)
Puya gilmartiniae	CHL(COQ)
Puya harmsii	ARG(CAT, COR, LRI, TUC)
Puya hofstenii	ARG(JUJ)
Puya lilloi	ARG(CAT, JUJ, SAL, TUC)
Puya micrantha	ARG(JUJ, SAL)
Puya mirabilis	ARG(JUJ, SAL, TUC)
Puya novarae	ARG(SAL)
Puya pumila	CHL(BIO)
Puya smithii	ARG(JUJ, SAL, TUC)
Puya spathacea	ARG(CAT, COR, JUJ, LRI, MEN, SAL, SLU, TUC)
Puya venusta	CHL(COQ, VAL)
Puya vervoorstii	ARG(SJU)
Puya volcanensis	ARG(JUJ, SAL)
Puya weberiana	ARG(SAL, TUC)
Puya yakespala	ARG(SAL)
Pycnophyllopsis muscosa	ARG(CHU, NEU, RNE, SCR, TDF)
Pycnophyllum argentinum	ARG(LRI)
Pycnophyllum bryoides	ARG(CAT, JUJ, SAL) / CHL(TAR, ANT)
Pycnophyllum convexum	ARG(CAT, JUJ, SAL, TUC)
Pycnophyllum glomeratum	CHL(TAR)
Pycnophyllum macropetalum	ARG(SAL) / CHL(TAR, ANT)
Pycnophyllum molle	ARG(CAT, JUJ, SAL) / CHL(TAR, ANT)
Pycnophyllum mucronulatum	ARG(JUJ)
Pycnophyllum spathulatum	CHL(TAR, ANT)
Pycnophyllum tetrastichum	ARG(CAT, JUJ, LRI, SAL, TUC)
Pycreus decumbens	BRA(PAR)
Pycreus polystachyos ssp. riograndensis	BRA(RGS, SCA)
Pyracantha angustifolia	ARG(COR, SAL)
Pyracantha atalantioides	ARG(COR)
Pyrolirion tubiflorum	CHL(TAR)
Pyrostegia venusta	ARG(COS, JUJ, MIS, TUC) / BRA(PAR, RGS, SCA) / PRY(APA, AMA, CAU, CAA, CAN, CEN, CON, COA, GUA, ITA, MIE, PAI, SPE)
Pyrrhocactus aspillagae	CHL(LBO, MAU)
Pyrrhocactus bulbocalyx	ARG(LRI, SJU, SLU)
Pyrrhocactus catamarcensis	ARG(SJU)
Pyrrhocactus chilensis var. albidiflorus	CHL(COQ)
Pyrrhocactus chilensis var. chilensis	CHL(COQ, VAL)
Pyrrhocactus confinis	CHL(ATA)
Pyrrhocactus crispus	CHL(ATA)
Pyrrhocactus curvispinus	CHL(ATA, COQ, VAL, LBO, MAU, RME)
Pyrrhocactus echinus	CHL(ANT)
Pyrrhocactus engleri	CHL(VAL, RME)
Pyrrhocactus eriosyzoides	CHL(ATA, COQ)
Pyrrhocactus floccosus	CHL(ANT)
Pyrrhocactus garaventai	CHL(VAL)
Pyrrhocactus heinrichianus	CHL(ATA, COQ)
Pyrrhocactus kattermannii	ARG(LRI, SJU)
Pyrrhocactus marksianus	CHL(LBO, MAU)
Pyrrhocactus pachacoensis	ARG(MEN, SJU)
Pyrrhocactus paucicostatus	CHL(ANT)
Pyrrhocactus philippianus	CHL(ANT)
Pyrrhocactus pilispinus	CHL(ATA)
Pyrrhocactus pygmaeus	CHL(ANT, ATA)
Pyrrhocactus reconditus	CHL(ANT)
Pyrrhocactus sanjuanensis	ARG(SJU)
Pyrrhocactus simulans	CHL(COQ)
Pyrrhocactus strausianus	ARG(LPA, MEN, NEU, RNE)
Pyrrhocactus taltalensis	CHL(ANT, ATA)
Pyrrhocactus tuberisulcatus	CHL(LBO, RME)
Pyrrhocactus umadeave	ARG(JUJ, SAL)