Ecclinusa ramiflora	BRA(PAR)
Eccremocarpus scaber	ARG(CHU, NEU, RNE) / CHL(VAL, LBO, MAU, ARA, LLA, RME)
Echeveria peruviana	ARG(JUJ, SAL)
Echinochloa chacoënsis	ARG(JUJ, SFE)
Echinochloa colona	ARG(BAI, CAT, CHA, COR, COS, DFE, ERI, FOR, JUJ, LPA, LRI, MEN, MIS, RNE, SAL, SJU, SLU, SFE, SDE, TUC) / BRA(RGS) / CHL(COQ, VAL, MAU, BIO, ARA, JFE) / PRY(APY, AMA, BOQ, CEN, CON, COA, GUA, ITA, PHA) / URY(ART, CLA, COL, MAL, MON, PAY, ROC, SAO, SOR)
Echinochloa crus-galli var. crus-galli	ARG(BAI, CAT, CHA, COR, COS, DFE, ERI, LPA, MEN, MIS, NEU, RNE, SAL, SJU, SLU, SFE) / BRA(PAR, RGS, SCA) / CHL(COQ, VAL, LBO, MAU, BIO, ARA, LLA, RME) / PRY(CEN, COA, PHA) / URY(ART, CAS, CLA, FLA, MON, RIV, ROC, SAO, SOR)
Echinochloa crus-galli var. mitis	ARG(BAI, COR, COS, ERI, FOR, JUJ, LPA, LRI, MEN, MIS, NEU, RNE, SAL, SJU, SFE) / CHL(VAL, LBO, MAU, ARA, RME) / URY(MON)
Echinochloa crus-galli var. zelayensis	ARG(BAI, CHA, JUJ, SAL) / CHL(MAU)
Echinochloa crus-pavonis	ARG(BAI, CAT, CHA, COR, COS, DFE, ERI, FOR, JUJ, LPA, LRI, MEN, MIS, SAL, SDE, SFE, SJU, SLU, TUC) / BRA(PAR, RGS, SCA) / CHL(TAR, COQ, VAL, MAU, BIO, ARA, LLA, RME) / PRY(APY, APA, CEN, CON, COA, GUA, ITA, PHA) / URY(ART, CAS, CLA, COL, FLA, MAL, MON, RIV, ROC, SAO, SJO, SOR)
Echinochloa helodes	ARG(BAI, CHA, COR, COS, DFE, ERI, FOR, SFE) / PRY(APY) / URY(ART, CAS, COL, LAV, MAL, MON, RNO, ROC, SAO, SJO, TAC)
Echinochloa oryzoides	ARG(COS, ERI, MIS) / BRA(Fuera del área del proyecto) / PRY(COA)
Echinochloa polystachya var. polystachya	ARG(BAI, CHA, COS, DFE, ERI, MIS, SFE) / BRA(PAR, RGS, SCA) / PRY(PHA) / URY(COL, MON)
Echinochloa polystachya var. spectabilis	ARG(BAI, CHA, COS, DFE, ERI, FOR, SFE) / BRA(SCA) / PRY(CEN, ÑEE, PHA) / URY(CAS, MON)
Echinodorus australis	ARG(COS) / BRA(PAR, SCA)
Echinodorus berteroi	ARG(RNE) / PRY(APY)
Echinodorus floribundus	ARG(CHA, COS, MIS, SFE) / BRA(PAR, RGS, SCA) / PRY(AMA, CAN, CEN, COA, PHA, SPE) / URY(RIV)
Echinodorus grandiflorus	ARG(BAI, CHA, COR, COS, DFE, ERI, FOR, MIS, SAL, SFE, TUC) / BRA(PAR, RGS, SCA) / PRY(APY, AMA, BOQ, CAU, CAA, CAN, CEN, CON, COA, GUA, ITA, MIE, ÑEE, PAI, PHA) / URY(ART, CAS, PAY, RNO, RIV, ROC, SJO, TYT)
Echinodorus longipetalus	ARG(MIS) / BRA(Fuera del área del proyecto) / PRY(AMA, CAU, CAA, CAN, CEN, COA, PAI, PHA)
Echinodorus longiscapus	ARG(BAI, ERI, SFE) / BRA(PAR, RGS, SCA) / PRY(MIE) / URY(SOR, TAC)
Echinodorus macrophyllus ssp. macrophyllus	BRA(PAR, SCA)
Echinodorus paniculatus	ARG(CHA, COS, FOR, MIS) / BRA(PAR) / PRY(APY, BOQ, CAN, CEN, CON, COA, ÑEE, PHA)
Echinodorus reptilis	ARG(COS, MIS) / BRA(RGS) / PRY(MIE)
Echinodorus scaber	ARG(COR, COS) / BRA(PAR, SCA) / PRY(CON)
Echinodorus subalatus	BRA(PAR, SCA) / PRY(CEN)
Echinodorus uruguayensis	ARG(MIS) / BRA(PAR, RGS, SCA) / CHL(LLA) / URY(ART, FLO, PAY, SAO, SJO, SOR)
Echinopepon disjunctus	ARG(JUJ)
Echinopepon racemosus	ARG(CAT, COR, JUJ, LRI, SAL, SJU, TUC) / BRA(Fuera del área del proyecto)
Echinopsis albispinosa	ARG(SAL, TUC)
Echinopsis ancistrophora	ARG(JUJ, SAL, TUC)
Echinopsis aurea var. albiflora	ARG(COR)
Echinopsis aurea var. aurea	ARG(COR, LRI, SDE, SLU)
Echinopsis aurea var. fallax	ARG(CAT, SAL)
Echinopsis aurea var. dobeana	ARG(CAT)
Echinopsis leucantha	ARG(BAI, CAT, LRI, MEN, RNE, SAL, SDE, SJU, SLU, TUC)
Echinopsis mamillosa	ARG(SAL)
Echinopsis oxygona	ARG(BAI, COS, ERI, SFE) / BRA(RGS) / PRY(GUA) / URY(CLA, TAC)
Echinopsis rhodotricha	ARG(CHA, COS, ERI, FOR, SDE, SFE) / PRY(APY, CON, COA) / URY(PAY, RNO, SJO)
Echinopsis tubiflora	ARG(SAL, TUC)
Echium plantagineum	ARG(BAI, COR, COS, DFE, ERI, LPA, MEN, MIS, NEU, SAL, SLU, SFE, TDF, TUC) / BRA(PAR) / CHL(LBO, MAU, BIO, ARA) / URY(ART, MON)
Echium vulgare var. wierzbickii	ARG(NEU)
Echium vulgare var. vulgare	ARG(NEU, RNE) / CHL(COQ, VAL, LBO, MAU, BIO, ARA, LLA, AIS, MAG, RME)
Eclipta elliptica	ARG(BAI, COS, ERI) / BRA(PAR, RGS, SCA) / URY(CAS, CLA, COL, FLA, MAL, MON, RNO, ROC, SJO, SOR)
Eclipta megapotamica	ARG(BAI, COS, ERI) / BRA(RGS)
Eclipta prostrata	ARG(BAI, CAT, CHA, COR, COS, DFE, ERI, FOR, JUJ, LRI, MIS, SAL, SJU, SFE, SDE, TUC) / BRA(PAR, RGS, SCA) / CHL(VAL, MAU, RME) / PRY(APY, AMA, CAN, COA, PHA) / URY(ART, COL, MON, PAY, RNO, RIV, ROC, SAO, SJO, SOR)
Edmundoa lindenii var. lindenii	BRA(PAR, RGS, SCA)
Edmundoa lindenii var. rosea	BRA(PAR, RGS, SCA)
Egeria densa	ARG(BAI, COR, COS, ERI, MIS, SFE) / BRA(PAR, SCA) / CHL(VAL, BIO, LLA, RME) / URY(CAS, FLO, FLA, MON, ROC)
Egeria najas	ARG(BAI, COS, ERI) / BRA(PAR) / PRY(COA, ITA, ÑEE, SPE) / URY(TAC)
Egletes viscosa	ARG(CHA, COS, FOR, SAL) / BRA(PAR) / PRY(APY, ÑEE, PHA)
Ehretia cortesia	ARG(COR, LRI, MEN, SDE, SFE, SJU, SLU)
Ehrharta villosa	ARG(BAI)
Eichhornia azurea	ARG(BAI, CHA, COR, COS, ERI, FOR, MIS, SFE) / BRA(PAR, RGS, SCA) / PRY(APA, CEN, COA, GUA, ITA, MIE, ÑEE, PAI, PHA) / URY(CAS, CLA, MAL, MON, RNO, ROC, SJO, TAC, TYT)
Eichhornia crassipes	ARG(BAI, CHA, COS, ERI, FOR, JUJ, LRI, MIS, SAL, SFE, TUC) / BRA(PAR, RGS, SCA) / CHL(ATA, COQ, VAL, BIO) / PRY(APY, CEN, CON, COA, GUA, ITA, ÑEE, PAI, PHA, SPE) / URY(MON, ROC, TYT)
Eichhornia meyeri	ARG(CHA, MIS, SAL) / BRA(Fuera del área del proyecto) / PRY(APY, PHA)
Eithea blumenavia	BRA(SCA)
Elachyptera festiva	BRA(PAR)
Elachyptera micrantha	ARG(MIS) / BRA(PAR, SCA) / PRY(APA)
Elaeagnus angustifolia	ARG(LPA, NEU, RNE, SCR)
Elaphoglossum alpestre	BRA(PAR)
Elaphoglossum balansae	BRA(PAR, RGS) / PRY(AMA, CAU, PAI)
Elaphoglossum beaurepairei	BRA(PAR, RGS)
Elaphoglossum brachyneuron	BRA(PAR, RGS, SCA)
Elaphoglossum brevipes	BRA(PAR)
Elaphoglossum burchellii	BRA(PAR, RGS, SCA) / PRY(APA, CAA, CAN)
Elaphoglossum chrysolepis	BRA(SCA)
Elaphoglossum craspedariaforme	BRA(PAR)
Elaphoglossum crassinerve	BRA(PAR, SCA)
Elaphoglossum crassipes	ARG(CAT, JUJ, SAL, TUC)
Elaphoglossum dutrae	BRA(RGS)
Elaphoglossum edwallii	BRA(PAR, RGS, SCA)
Elaphoglossum fonkii	CHL(LLA)
Elaphoglossum gayanum	ARG(BAI, CAT, COR, JUJ, LRI, SAL, SLU, TUC) / BRA(PAR) / CHL(ARA, LLA) / URY(MAL)
Elaphoglossum gertii	BRA(PAR, RGS)
Elaphoglossum hartwegii	
Elaphoglossum hassleri	PRY(CAN, COA)
Elaphoglossum horridulum	BRA(PAR)
Elaphoglossum hybridum	ARG(JUJ, SAL, TUC)
Elaphoglossum iguapense	BRA(PAR, SCA)
Elaphoglossum itatiayensis	BRA(SCA)
Elaphoglossum lagesianum	BRA(RGS, SCA)
Elaphoglossum lindenii	CHL(JFE)
Elaphoglossum lingua	BRA(PAR, SCA)
Elaphoglossum lorentzii	ARG(CAT, COR, JUJ, SAL, SLU, TUC)
Elaphoglossum luridum	BRA(PAR, RGS, SCA)
Elaphoglossum macahense	BRA(PAR, RGS, SCA)
Elaphoglossum macrophyllum var. macrophyllum	BRA(PAR, RGS, SCA)
Elaphoglossum macrophyllum var. schmalzii	BRA(RGS, SCA)
Elaphoglossum minutum	BRA(PAR, SCA)
Elaphoglossum nigrescens	BRA(PAR, SCA)
Elaphoglossum ornatum	BRA(PAR, RGS, SCA)
Elaphoglossum pachydermum	ARG(MIS) / BRA(PAR, RGS, SCA)
Elaphoglossum paulistanum	BRA(PAR)
Elaphoglossum porteri	ARG(Desconocida) / CHL(LLA)
Elaphoglossum rubicundum	BRA(PAR, SCA)
Elaphoglossum schwackeanum	BRA(RGS)
Elaphoglossum scolopendrifolium	BRA(RGS, SCA)
Elaphoglossum sellowianum	ARG(JUJ, SAL) / BRA(PAR, RGS, SCA)
Elaphoglossum skottsbergii	CHL(ATA)
Elaphoglossum spathulatum	ARG(CAT, COR, JUJ, SAL, TUC) / BRA(PAR, RGS, SCA) / URY(TAC)
Elaphoglossum squamipes	BRA(PAR)
Elaphoglossum strictum	BRA(PAR, SCA)
Elaphoglossum subarborescens	BRA(PAR, SCA)
Elaphoglossum subcochleare	PRY(CAN, GUA, PAI)
Elaphoglossum tectum	ARG(MIS) / BRA(PAR)
Elaphoglossum tenax	BRA(SCA)
Elaphoglossum ulei	BRA(RGS, SCA)
Elaphoglossum vagans	BRA(PAR, RGS, SCA)
Elaphoglossum wettsteinii	BRA(PAR)
Elaphoglossum yungense	ARG(JUJ, SAL, TUC)
Elatine lorentziana	ARG(COR, COS, ERI, MIS, SFE)
Elatine triandra var. triandra	ARG(MEN, RNE, SFE) / CHL(LBO, MAU, BIO, ARA, LLA)
Elatine triandra var. brachysperma	ARG(BAI, ERI, FOR) / URY(MAL, SJO)
Eleocharis acutangula ssp. acutangula	ARG(COS, FOR, MIS, SAL, SFE, TUC) / BRA(PAR, RGS, SCA) / PRY(APA, AMA, CAU, CAA, CAN, CEN, CON, COA, GUA, PAI) / URY(CLA, RIV, TAC)
Eleocharis acutangula ssp. breviseta	BRA(PAR, RGS)
Eleocharis argentina	ARG(MEN)
Eleocharis atacamensis	ARG(CAT, CHU, JUJ, LRI, MEN, SAL, SCR, SJU) / CHL(ANT, ATA, BIO)
Eleocharis atrobrunnea	BRA(RGS)
Eleocharis atropurpurea	ARG(FOR, JUJ, SAL) / BRA(Fuera del área del proyecto) / PRY(APY)
Eleocharis baldwinii	URY(MON)
Eleocharis barrosii	ARG(CHA, COS, FOR, SFE) / BRA(SCA)
Eleocharis bicolor	ARG(COS, MIS) / BRA(SCA) / PRY(APY, APA, CAA, PHA)
Eleocharis bonariensis	ARG(BAI, CAT, CHA, COR, COS, DFE, ERI, JUJ, LPA, LRI, MEN, MIS, RNE, SAL, SFE, SJU, SLU, TUC) / BRA(PAR, RGS, SCA) / CHL(ATA, COQ, VAL, MAU, BIO, ARA, LLA, RME) / PRY(APA, CAU, CAA, CEN, CON, COA, GUA, ITA, ÑEE, PAI) / URY(CAS, DUR, FLA, MON, PAY, SAO, SJO, SOR)
Eleocharis canindeyuensis	PRY(CAN)
Eleocharis capillacea	ARG(MIS) / BRA(PAR, SCA) / PRY(APA, CAU, CAA, COA, MIE, PAI, SPE)
Eleocharis confervoides	ARG(MIS) / BRA(RGS, SCA) / PRY(AMA, CAU)
Eleocharis contracta	ARG(BAI, CHA, COR, COS, DFE, ERI, FOR, JUJ, MIS, SAL, SFE, TUC) / BRA(RGS, SCA) / PRY(APY, APA, AMA, CAN, CEN, CON, COA, ITA, MIE, ÑEE, PAI, PHA) / URY(ART, PAY, SAO, TAC)
Eleocharis cordillerana	CHL(LLA)
Eleocharis crinalis	ARG(CAT, COR, JUJ, LRI, SAL, SLU, TUC) / PRY(AMA, CON)
Eleocharis cylindrica	ARG(CHA, COS, ERI, FOR, SFE) / PRY(APY, CAA, CEN, GUA, PAI, PHA)
Eleocharis debilis	BRA(PAR, SCA) / PRY(AMA, CAA, CEN, PHA)
Eleocharis densicaespitosa	ARG(CHA, COS, ERI) / BRA(RGS)
Eleocharis dombeyana	ARG(CAT, COR, JUJ, LRI, MEN, SAL, SJU, SLU, TUC) / CHL(ATA)
Eleocharis dunensis	ARG(BAI, CHA, COS, DFE, ERI, SFE) / BRA(RGS) / URY(ART, CAS, FLO, FLA, LAV, MAL, MON, PAY, SJO, SOR)
Eleocharis elegans	ARG(BAI, CAT, CHA, COS, ERI, FOR, MIS, SAL, SFE) / BRA(PAR, RGS, SCA) / PRY(APA, APY, AMA, BOQ, CAU, CAN, CEN, CON, COA, GUA, ITA, MIE, ÑEE, PAI, PHA, SPE) / URY(ART, CLA, PAY, SJO, TAC)
Eleocharis elongata	BRA(SCA)
Eleocharis filiculmis	ARG(BAI, CHA, COS, ERI, RNE, SDE, SFE, TUC) / BRA(PAR, RGS, SCA) / PRY(APY, APA, AMA, CAU, CAN, CEN, CON, COA, GUA, ITA, MIE, PAI, SPE)
Eleocharis flavescens	ARG(BAI, CHA, COS, DFE, FOR, MIS, SFE) / BRA(PAR, RGS, SCA) / CHL(MAU, BIO, RME) / PRY(AMA, CAU, CAA, CON, COA, ITA, ÑEE, PAI) / URY(CAS, SJO)
Eleocharis fuscopurpurea	ARG(CAT, COR, JUJ, MEN, SFE, SJU, TUC) / CHL(MAU, BIO, LLA, JFE)
Eleocharis geniculata	ARG(BAI, CHA, COS, ERI, FOR, JUJ, SAL, SFE, TUC) / BRA(PAR, RGS, SCA) / PRY(APY, CAN, CEN, CON, COA, PAI, SPE) / URY(Desconocida)
Eleocharis glauco-virens	ARG(COS) / BRA(PAR, SCA) / PRY(COA, PAI)
Eleocharis grandirostris	PRY(CEN, COA, GUA, ITA, PAI)
Eleocharis hatschbachii	ARG(COS) / BRA(Fuera del área del proyecto)
Eleocharis haumaniana	ARG(BAI, CHA, COR, COS, DFE, ERI, RNE, SFE) / URY(CAS, COL, FLA, MON, PAY, RNO, TAC)
Eleocharis interstincta	ARG(COS) / BRA(PAR, RGS, SCA) / PRY(AMA, CON, COA, ÑEE, SPE)
Eleocharis kleinii	BRA(RGS, SCA)
Eleocharis laeviglumis	BRA(RGS, SCA)
Eleocharis lechleri	ARG(JUJ, RNE, SAL, TUC) / CHL(LLA)
Eleocharis loefgreniana	BRA(PAR, RGS, SCA)
Eleocharis macrostachya	ARG(BAI, CAT, CHA, CHU, COR, ERI, FOR, JUJ, LPA, LRI, MEN, NEU, RNE, SAL, SCR, SDE, SFE, SJU, TDF, TUC) / CHL(COQ, VAL, LBO, MAU, BIO, ARA, LLA, AIS, MAG, RME) / URY(CAS, FLA, LAV, MON, PAY, ROC, SJO)
Eleocharis maculosa	ARG(BAI, CAT, CHA, COR, LPA, NEU, RNE, TUC) / BRA(PAR, RGS, SCA) / CHL(VAL, MAU, BIO, LLA) / URY(CAS, MON, RIV)
Eleocharis melanocephala	ARG(BAI, CAT, CHA, COR, NEU, RNE, SAL, TUC) / CHL(VAL, MAU, BIO, LLA)
Eleocharis melanomphala	ARG(CAT, CHU, COR, JUJ, LRI, MEN, NEU, SAL, SCR, SJU, TUC) / CHL(RME)
Eleocharis melanostachys	ARG(CHU, NEU, RNE, SCR, TDF) / CHL(ATA, MAU, BIO, ARA, LLA, AIS, MAG, RME)
Eleocharis mendocina	ARG(CAT, JUJ, LRI, MEN, SJU, TUC)
Eleocharis minarum	PRY(MIE)
Eleocharis minima	ARG(CHA, COS, FOR, JUJ, MIS) / BRA(PAR, RGS, SCA) / PRY(APY, APA, AMA, CAU, CAA, CEN, CON, COA, ITA, MIE, ÑEE, PAI, PHA, SPE)
Eleocharis montana	ARG(BAI, CAT, CHA, COR, COS, ERI, FOR, JUJ, MEN, MIS, SAL, SFE, TUC) / BRA(PAR, RGS, SCA) / CHL(MAU, BIO, ARA) / PRY(APA, APY, AMA, CAU, CAA, CAN, CEN, CON, COA, GUA, ITA, MIE, ÑEE, PAI, PHA, SPE) / URY(ART, CAS, COL, FLO, FLA, MAL, MON, RNO, ROC, SAO, SJO, SOR, TYT)
Eleocharis montevidensis	ARG(BAI, CAT, COR, DFE, ERI, JUJ, SAL, SFE, TUC) / BRA(PAR, RGS, SCA) / URY(MON)
Eleocharis mutata	BRA(PAR, SCA) / PRY(AMA, CAA, CAN, CEN, COA, PHA, SPE)
Eleocharis nana	BRA(PAR, SCA) / URY(ROC)
Eleocharis niederleinii	ARG(COS, ERI) / BRA(SCA)
Eleocharis nigrescens	BRA(Fuera del área del proyecto) / PRY(CON)
Eleocharis nubigena	ARG(JUJ, SAL)
Eleocharis nudipes	ARG(COS, MIS) / BRA(PAR, RGS, SCA) / PRY(APY, APA, AMA, CAU, CAA, CAN, CON, COA, GUA, ITA, MIE, SPE) / URY(RNO, RIV, TAC)
Eleocharis obtusa	ARG(BAI, SFE)
Eleocharis obtusetrigona	ARG(CHA, COS, ERI) / BRA(PAR, RGS, SCA) / PRY(CEN, COA, SPE) / URY(ART, RNO)
Eleocharis occidentalis	PRY(PHA)
Eleocharis ochrostachys	BRA(RGS, SCA)
Eleocharis pachycarpa	ARG(CHU, NEU, RNE, TDF) / CHL(COQ, VAL, LBO, MAU, BIO, ARA, LLA, MAG)
Eleocharis parodii	ARG(BAI, COR, COS, ERI, SFE) / BRA(RGS) / URY(FLO, FLA, LAV, PAY, RNO)
Eleocharis parvispicula	BRA(PAR)
Eleocharis pauciglumis	BRA(SCA)
Eleocharis plicarhachis	ARG(CHA, COS, SAL) / BRA(PAR, SCA) / PRY(AMA, CEN, PAI, SPE)
Eleocharis pseudoalbibracteata	ARG(CAT, CHU, COR, JUJ, LPA, LRI, MEN, NEU, RNE, SAL, SCR, SJU, TDF, TUC) / CHL(TAR, ANT, ATA, COQ, LBO, MAU, BIO, ARA, LLA, AIS, MAG, RME, IPA)
Eleocharis quinquangularis	ARG(CHA, COS, MIS) / BRA(PAR, RGS) / PRY(APA, AMA, CAN, CEN, COA, GUA, SPE)
Eleocharis quinqueflora	ARG(CAT, CHU, JUJ, LRI, MEN, SAL, SCR, SJU) / CHL(ANT, ATA, BIO)
Eleocharis rabenii	BRA(PAR, RGS, SCA) / URY(MON)
Eleocharis radicans	ARG(BAI, CAT, COR, COS, ERI, JUJ, LRI, MEN, MIS, RNE, SAL, SJU, SLU, SFE, TUC) / BRA(PAR, RGS, SCA) / CHL(VAL, LBO, MAU, BIO, ARA, LLA) / PRY(APA, MIE) / URY(CAS, COL, MON, ROC, SOR)
Eleocharis ramboana	BRA(RGS)
Eleocharis rostellata	ARG(SJU, TUC)
Eleocharis sellowiana	ARG(COS, ERI, MIS) / BRA(PAR, RGS, SCA) / PRY(CAU, CAA, CEN, COA, GUA, ITA, ÑEE, PAI, SPE) / URY(CAS, MON, SJO)
Eleocharis squamigera	BRA(PAR, RGS, SCA)
Eleocharis subarticulata	BRA(PAR, RGS, SCA) / PRY(CAA, COA, PHA, SPE) / URY(RIV, TAC)
Eleocharis tucumanensis	ARG(JUJ, SJU, TUC) / CHL(TAR, ANT)
Eleocharis uniflora	CHL(BIO)
Eleocharis urceolatoides	BRA(RGS) / PRY(CEN, COA)
Eleocharis viridans	ARG(BAI, CHA, COR, COS, DFE, ERI, SFE, TUC) / BRA(PAR, RGS, SCA) / PRY(APA, CAU, CAA, CAN, CEN, COA, GUA, ITA, PAI, PHA) / URY(CAS, COL, FLA, LAV, MON, ROC, TYT)
Elephantopus micropappus	BRA(PAR)
Elephantopus mollis	ARG(CAT, CHA, COS, ERI, FOR, JUJ, MIS, SAL, SFE, TUC) / BRA(PAR, RGS, SCA) / PRY(APA, AMA, CAU, CAA, CAN, CEN, CON, COA, GUA, MIE, PAI, SPE) / URY(ART, RIV, TAC)
Elephantopus palustris	PRY(AMA, CAN, SPE)
Eleusine indica	ARG(BAI, CAT, CHA, COR, COS, DFE, ERI, FOR, JUJ, LPA, LRI, MIS, SAL, SLU, SFE, TUC) / BRA(PAR, RGS) / PRY(AMA, CAA, CEN, GUA) / URY(MON, PAY, RNO, TAC)
Eleusine tristachya	ARG(BAI, CAT, CHA, COR, COS, DFE, ERI, FOR, JUJ, LPA, LRI, MEN, MIS, SAL, SJU, SLU, SFE, SDE, TUC) / BRA(PAR, RGS, SCA) / CHL(ANT, ATA, VAL, MAU, BIO, ARA, LLA, RME, JFE) / PRY(CEN, MIE, ÑEE, PAI) / URY(ART, CAS, CLA, COL, DUR, FLA, MAL, MON, PAY, RNO, RIV, ROC, SAO, SJO, SOR)
Eleutherine bulbosa	ARG(JUJ, SAL, TUC) / BRA(Fuera del área del proyecto) / PRY(PHA)
Eleutherine latifolia	ARG(JUJ, TUC)
Elionurus ciliaris	PRY(PHA)
Elionurus lividus	PRY(CAU, CAN, SPE)
Elionurus muticus	ARG(BAI, CAT, CHA, CHU, COR, COS, ERI, FOR, JUJ, LPA, LRI, MIS, RNE, SAL, SLU, SFE, SDE, TUC) / BRA(PAR, RGS, SCA) / PRY(APY, APA, PHA) / URY(ART, CLA, FLO, FLA, LAV, MAL, MON, PAY, RNO, RIV, SAO, SJO, SOR)
Elionurus tripsacoides	ARG(JUJ, SAL) / PRY(AMA)
Elleanthus brasiliensis	BRA(PAR, RGS, SCA)
Elleanthus linifolius	BRA(PAR)
Elodea callitrichoides	ARG(BAI, CHA, COR, COS, ERI, JUJ, RNE, SFE) / URY(MON)
Elodea potamogeton	CHL(TAR, VAL, LBO, MAU, BIO, RME)
Eltroplectris calcarata	PRY(COA, PAI)
Eltroplectris lurida	ARG(CHA, SAL) / BRA(SCA) / PRY(PHA)
Eltroplectris roseoalba	ARG(CHA, COS, FOR, JUJ, MIS, SAL) / BRA(Fuera del área del proyecto)
Eltroplectris schlechterana	ARG(MIS) / BRA(PAR) / PRY(APA)
Eltroplectris travassosii	ARG(MIS)
Eltroplectris triloba	ARG(CHA, COS, MIS, TUC) / BRA(RGS) / PRY(COA, PAI)
Elymus angulatus	ARG(CHU, LPA, MEN, NEU, RNE, SJU, SCR, TDF) / CHL(ANT, ATA, COQ, VAL, LBO, MAU, BIO, ARA, LLA, AIS, MAG, RME)
Elymus magellanicus	ARG(CHU, LPA, MEN, NEU, SJU, SCR, TDF) / CHL(MAG)
Elymus mendocinus	ARG(MEN)
Elymus patagonicus	ARG(CHU, NEU, SCR, TDF) / CHL(AIS, MAG)
Elymus scabrifolius	ARG(BAI, CHA, COR, COS, ERI, LPA, NEU, RNE, SFE, TUC) / URY(CAS, COL, MON, PAY, SJO, SOR)
Elymus scabriglumis	ARG(BAI, JUJ, LPA, MEN, NEU, RNE, SLU, TUC) / CHL(ANT)
Elymus x lineariglumis	ARG(MEN, TDF)
Elytraria imbricata	ARG(JUJ, SAL)
Elytrigia repens	ARG(BAI, COR, DFE, ERI, NEU, RNE, SLU, SCR, TDF) / CHL(ARA, LLA, MAG, RME)
Elytropus chilensis	ARG(RNE) / CHL(LBO, MAU, BIO, ARA, LLA, AIS)
Embothrium coccineum	ARG(CHU, NEU, RNE, SCR, TDF) / CHL(MAU, BIO, ARA, LLA, AIS, MAG)
Emex spinosa	ARG(BAI, COS, ERI, FOR, SFE) / CHL(COQ) / URY(MON, PAY, SOR)
Emilia fosbergii	ARG(MIS) / BRA(RGS) / PRY(APA, AMA, CAU, CAN, CEN, COA, GUA)
Emilia sonchifolia 	BRA(RGS)
Emmeorhiza umbellata	BRA(PAR, RGS, SCA) / PRY(CAN)
Empetrum rubrum	ARG(CHU, MEN, NEU, RNE, SCR, TDF) / CHL(VAL, MAU, BIO, ARA, LLA, AIS, MAG, RME, JFE)
Encelia canescens var. oblongifolia	CHL(TAR, ANT, ATA, COQ)
Encelia canescens var. canescens	CHL(TAR, ANT, ATA, COQ)
Encelia canescens var. parvifolia	CHL(TAR, ANT, ATA, COQ)
Encyclia almasii	BRA(SCA)
Encyclia argentinensis	ARG(JUJ, SAL, TUC) / BRA(PAR)
Encyclia dutrae	BRA(RGS, SCA)
Encyclia flava	BRA(PAR) / PRY(PAI, SPE)
Encyclia megalantha	BRA(PAR)
Encyclia oncidioides	BRA(PAR, SCA) / PRY(PHA)
Encyclia patens	BRA(PAR, SCA)
Endlicheria paniculata	BRA(PAR, RGS, SCA) / PRY(APA, APY, AMA, CAU, CAA, CAN, GUA, SPE)
Ennealophus euryandrus ssp. euryandrus	ARG(JUJ, SAL, TUC)
Ennealophus euryandrus ssp. oxydandrus	ARG(CAT)
Ennealophus fimbriatus	ARG(JUJ, SAL)
Ennealophus simplex	ARG(JUJ, TUC)
Ennealophus tucumanensis	ARG(TUC)
Enneapogon desvauxii	ARG(CAT, COR, JUJ, LRI, MEN, SAL, SJU, SLU, TUC) / CHL(TAR, ANT)
Enterolobium contortisiliquum	ARG(BAI, CHA, COS, ERI, FOR, JUJ, MIS, SAL, SFE, TUC) / BRA(RGS, SCA) / PRY(APA, CEN, COA, GUA, ÑEE, PAI) / URY(CLA, MON, PAY, RNO, ROC)
Enterolobium timbouva	PRY(CEN, CON)
Enydra anagallis	ARG(BAI, CHA, COS, DFE, ERI, FOR, JUJ, SAL, SFE, TUC) / BRA(PAR, RGS, SCA) / PRY(ÑEE, PAI, PHA) / URY(CAS, CLA, COL, ROC, SJO)
Enydra sessilis	ARG(COS) / BRA(RGS, SCA) / URY(CAS, MAL, MON, ROC, SJO)
Ephedra americana	ARG(CAT, COR, JUJ, LRI, MEN, SAL, SJU, SLU, TUC) / CHL(TAR, ANT, ATA, COQ)
Ephedra boelckei	ARG(MEN, SJU)
Ephedra chilensis	ARG(CHU, JUJ, LRI, MEN, NEU, RNE, SAL, SJU, SCR, TDF, TUC) / CHL(TAR, ANT, ATA, COQ, VAL, LBO, MAU, BIO, ARA, AIS, MAG, RME)
Ephedra gracilis	CHL(ATA, COQ, VAL, RME)
Ephedra multiflora	ARG(CAT, LRI, MEN, NEU, SAL, SJU) / CHL(TAR, ANT)
Ephedra ochreata	ARG(BAI, CAT, CHU, LPA, LRI, MEN, NEU, RNE, SCR, SJU, SLU) / CHL(AIS)
Ephedra triandra	ARG(BAI, CAT, CHA, COR, ERI, LPA, LRI, MEN, RNE, SAL, SDE, SFE, SJU, SLU, TUC)
Ephedra trifurcata	CHL(VAL)
Ephedra tweediana	ARG(BAI, CAT, COS, DFE, ERI, SFE, TUC) / BRA(RGS) / URY(FLO, FLA, MAL, RNO, ROC, SJO)
Epidendrum andres-johnsonii	ARG(MIS) / BRA(PAR)
Epidendrum aquaticum	BRA(PAR)
Epidendrum armeniacum	BRA(PAR, RGS, SCA)
Epidendrum avicula	BRA(PAR, RGS)
Epidendrum caldense	BRA(PAR, RGS, SCA)
Epidendrum cinnabarinum	BRA(PAR)
Epidendrum coronatum	BRA(PAR)
Epidendrum crassinervium	ARG(SAL)
Epidendrum cristatum	BRA(PAR, RGS, SCA)
Epidendrum dendrobioides	BRA(PAR)
Epidendrum densiflorum	ARG(JUJ, MIS, SAL) / BRA(PAR, RGS, SCA) / PRY(CAN)
Epidendrum ecostatum	BRA(PAR, SCA)
Epidendrum ensiferum	BRA(PAR)
Epidendrum fulgens	BRA(PAR, RGS, SCA)
Epidendrum geniculatum	BRA(PAR, SCA)
Epidendrum hassleri	ARG(MIS) / BRA(PAR) / PRY(AMA)
Epidendrum henschenii	BRA(PAR, RGS, SCA)
Epidendrum imbricatum	BRA(PAR, SCA)
Epidendrum latilabre	BRA(PAR, RGS, SCA)
Epidendrum loefgrenii	BRA(PAR)
Epidendrum longovarium	BRA(PAR)
Epidendrum noackii	ARG(MIS) / BRA(PAR, RGS, SCA) / PRY(APA, CAN)
Epidendrum nocturnum	BRA(PAR, SCA)
Epidendrum nutans	BRA(PAR)
Epidendrum obergii	BRA(PAR, SCA)
Epidendrum paranaense	BRA(PAR, SCA)
Epidendrum pedale	BRA(PAR)
Epidendrum polyanthum	BRA(SCA)
Epidendrum proligerum	BRA(PAR, RGS, SCA)
Epidendrum pseudavicula	BRA(PAR)
Epidendrum pseudodifforme	BRA(PAR, RGS, SCA)
Epidendrum puniceoluteum	BRA(PAR, SCA)
Epidendrum purpureum	BRA(PAR, RGS, SCA)
Epidendrum ramosum	BRA(PAR, RGS)
Epidendrum rigidum	ARG(JUJ, MIS) / BRA(PAR, RGS, SCA)
Epidendrum rojasii	PRY(AMA)
Epidendrum samaipatense	ARG(JUJ, SAL)
Epidendrum saximontanum	BRA(PAR)
Epidendrum secundum f. albescens	BRA(PAR)
Epidendrum secundum f. secundum	BRA(PAR, RGS, SCA) / PRY(AMA)
Epidendrum strobiliferum	BRA(PAR, RGS, SCA)
Epidendrum versicolor	BRA(PAR, SCA)
Epidendrum vesicatum	BRA(PAR, RGS, SCA)
Epidendrum viridipurpureum	BRA(PAR)
Epidendrum weddellii	PRY(APA, CAN)
Epilobium australe	ARG(CHU, MEN, NEU, RNE, SCR, TDF) / CHL(LBO, MAU, BIO, ARA, LLA, AIS, MAG, RME)
Epilobium barbeyanum	ARG(MEN, NEU, SJU) / CHL(ATA, COQ, VAL, LBO, MAU, BIO, RME)
Epilobium brachycarpum	ARG(CHU, NEU, RNE) / CHL(BIO)
Epilobium campestre	ARG(CHU, NEU, RNE, SCR) / CHL(RME)
Epilobium ciliatum ssp. ciliatum	ARG(CHU, COR, MEN, NEU, RNE, SCR, SJU, SLU, TDF) / CHL(ATA, COQ, VAL, LBO, MAU, BIO, ARA, LLA, AIS, MAG, RME)
Epilobium conjugens	ARG(TDF) / CHL(AIS, MAG)
Epilobium densifolium	ARG(CHU, NEU, RNE) / CHL(VAL, LBO, MAU, BIO, ARA, RME)
Epilobium denticulatum	ARG(CAT, COR, JUJ, LRI, MEN, SAL, SJU, SLU, TUC) / CHL(TAR, ANT, COQ)
Epilobium fragile	CHL(TAR, ANT)
Epilobium glaucum	ARG(CHU, MEN, NEU, RNE, SCR, SJU) / CHL(COQ, VAL, LBO, MAU, BIO, ARA, LLA, AIS, MAG, RME)
Epilobium hirtigerum	ARG(BAI, COR, COS, DFE, ERI) / BRA(RGS, SCA) / URY(CAS, CLA, FLA, MAL, MON, ROC, SJO)
Epilobium nivale	ARG(CHU, MEN, NEU, RNE, SCR) / CHL(COQ, VAL, LBO, MAU, BIO, ARA, MAG, RME)
Epilobium obscurum	CHL(BIO, ARA, LLA, RME)
Epilobium puberulum	ARG(CHU, NEU) / CHL(VAL, LBO, MAU, BIO, ARA, LLA, AIS, RME)
Epilobium subdentatum	ARG(CHU, NEU) / CHL(COQ, VAL, LBO, MAU, BIO, ARA, RME)
Epilobium tetragonum ssp. lamyi	CHL(MAU, BIO, ARA, LLA, RME)
Epiphyllum phyllanthus	ARG(COS, MIS) / BRA(PAR, RGS, SCA) / PRY(APA, AMA, CAN, CEN, COA, GUA, ITA, ÑEE, PAI, SPE)
Epistephium clorophyllum	PRY(GUA)
Epistephium lucidum	BRA(Fuera del área del proyecto) / PRY(AMA)
Epistephium sclerophyllum	ARG(COS, MIS) / BRA(PAR) / PRY(APA, AMA, CAA)
Equisetum bogotense	ARG(CAT, CHU, COR, JUJ, MEN, NEU, RNE, SAL, SJU, TUC) / CHL(TAR, ANT, ATA, COQ, VAL, LBO, MAU, BIO, LLA, AIS, RME)
Equisetum giganteum	ARG(BAI, CAT, CHA, CHU, COR, COS, DFE, ERI, FOR, JUJ, LPA, LRI, MEN, MIS, NEU, RNE, SAL, SJU, SLU, SCR, SFE, SDE, TDF, TUC) / BRA(PAR, RGS, SCA) / CHL(TAR, ANT, ATA, COQ, VAL, LBO, MAU, BIO, ARA, RME) / PRY(AMA, CAA, CAN, CEN, GUA, ITA, PHA) / URY(ART, CAS, COL, MAL, RNO, RIV, ROC, SAO, SJO, SJO, TAC)
Eragrostis acutiglumis	ARG(COS, ERI) / BRA(RGS) / URY(ART, DUR, FLO, FLA, PAY, RNO, SOR, TAC)
Eragrostis airoides	ARG(BAI, CHA, COR, COS, DFE, ERI, FOR, JUJ, LPA, MIS, SAL, SLU, SFE, SDE, TUC) / BRA(PAR, RGS, SCA) / PRY(APA, AMA, CEN, GUA, MIE, PAI, PHA, SPE) / URY(ART, DUR, FLA, LAV, MAL, PAY, RNO, RIV, ROC, SAO, SJO, SOR, TAC)
Eragrostis amabilis	BRA(PAR) / PRY(CEN, COA, SPE)
Eragrostis andicola	ARG(JUJ, SAL)
Eragrostis articulata	ARG(COR, COS, FOR, JUJ, LRI, MIS, SAL, SDE) / BRA(PAR, RGS) / PRY(APY, AMA, BOQ, CAU, CEN, COA, GUA, SPE)
Eragrostis attenuata	CHL(ANT, ATA)
Eragrostis bahiensis	ARG(BAI, CHA, COR, COS, ERI, FOR, JUJ, MIS, SAL, SFE, TUC) / BRA(PAR, RGS) / PRY(APA, AMA, CAU, CEN, CON, COA, GUA, MIE, PAI, PHA, SPE) / URY(ART, CAS, CLA, DUR, FLO, FLA, LAV, MAL, MON, PAY, RNO, RIV, ROC, SAO, SJO, SOR, TAC, TYT)
Eragrostis barrelieri	ARG(BAI, CAT, COR, DFE, JUJ, LRI, SAL, SLU, SDE, TUC) / URY(CAS, MAL, MON)
Eragrostis cataclasta	ARG(BAI, COS, ERI) / BRA(RGS, SCA) / URY(CAS, CLA, COL, DUR, LAV, MAL, MON, PAY, RNO, ROC, SJO, SOR, TAC, TYT)
Eragrostis chiquitaniensis	PRY(APY)
Eragrostis cilianensis	ARG(BAI, CAT, CHA, CHU, COR, COS, DFE, ERI, FOR, JUJ, LPA, LRI, MEN, NEU, RNE, SAL, SDE, SFE, SJU, SLU, TUC) / BRA(RGS) / PRY(APY) / URY(CLA, COL, MON, PAY, RNO, SAO)
Eragrostis ciliaris	ARG(MIS, SAL) / BRA(PAR, RGS, SCA) / PRY(CEN)
Eragrostis curvula	ARG(BAI, CAT, CHA, CHU, COR, COS, JUJ, LPA, MEN, NEU, RNE, SAL, SLU, SFE, TUC) / BRA(PAR, RGS, SCA) / CHL(BIO, MAG) / URY(COL, FLA, SOR, TAC)
Eragrostis hackelii	PRY(CEN, COA)
Eragrostis hypnoides	ARG(BAI, CHA, COR, COS, DFE, ERI, FOR, MIS, SFE) / BRA(PAR, RGS, SCA) / PRY(APY, CEN, COA, PHA) / URY(ART, CAS, PAY, ROC, SAO, SOR, TAC)
Eragrostis japonica	ARG(BAI, CHA, COS, DFE, ERI, FOR, JUJ, MIS, SAL, SFE, TUC) / BRA(PAR, RGS) / PRY(APY, APA, CON, ÑEE, SPE) / URY(ART, PAY, RNO, SAO)
Eragrostis kuschelii	CHL(IDE)
Eragrostis lehmanniana	ARG(MEN)
Eragrostis leucosticta	BRA(PAR, RGS) / PRY(AMA, CAU)
Eragrostis lugens	ARG(BAI, CAT, CHA, COR, COS, DFE, ERI, FOR, JUJ, LPA, LRI, MEN, MIS, RNE, SAL, SJU, SLU, SFE, SDE, TUC) / BRA(PAR, RGS, SCA) / PRY(APY, BOQ, CEN, CON, COA, GUA, ÑEE, PAI) / URY(ART, CAS, CLA, DUR, FLO, FLA, LAV, MAL, MON, PAY, RNO, RIV, ROC, SAO, SJO, SOR, TAC)
Eragrostis macrothyrsa	PRY(AMA, CEN, CON)
Eragrostis maypurensis	BRA(Fuera del área del proyecto)
Eragrostis mexicana ssp. mexicana	ARG(BAI, CAT, CHU, COR, COS, ERI, JUJ, LPA, LRI, MEN, RNE, SAL, SJU, SLU, SFE, TUC) / BRA(Fuera del área del proyecto) / CHL(TAR, ANT) / URY(FLA, MON, RNO, SJO, TYT)
Eragrostis mexicana ssp. virescens	ARG(BAI, CAT, CHA, COR, COS, DFE, ERI, JUJ, LPA, LRI, MEN, MIS, NEU, RNE, SAL, SJU, SLU, SFE, SDE, TUC) / BRA(PAR, RGS, SCA) / CHL(TAR, ANT, ATA, COQ, VAL, LBO, MAU, BIO, ARA, LLA, RME) / PRY(APY, CAU, CEN, ÑEE) / URY(ART, CLA, COL, MAL, MON, PAY, ROC, SAO, SOR)
Eragrostis minor	ARG(BAI, DFE, ERI) / URY(MON)
Eragrostis neesii var. lindmanii	ARG(BAI, CHA, COS, DFE, ERI, JUJ, MIS, SAL) / BRA(PAR, RGS) / PRY(APA, CEN, MIE, PAI) / URY(CLA, COL, FLA, PAY, RIV, SAO)
Eragrostis neesii var. neesii	ARG(BAI, COR, COS, ERI, FOR, MIS) / BRA(PAR, RGS, SCA) / PRY(APY, GUA, ITA, PAI) / URY(ART, CAS, CLA, DUR, FLO, FLA, LAV, MAL, MON, PAY, RNO, RIV, ROC, SAO, SJO, SOR, TAC)
Eragrostis neesii var. expansiflora	ARG(CHA, COR, COS, MIS, SFE) / PRY(GUA)
Eragrostis nigricans	ARG(CAT, JUJ, LRI, SAL, SJU, TUC) / CHL(TAR, ANT)
Eragrostis orthoclada	ARG(CAT, CHA, COR, COS, ERI, FOR, JUJ, LRI, SAL, SJU, SLU, SFE, SDE, TUC) / PRY(APY, PAI, PHA)
Eragrostis pastoensis	ARG(CAT, COR, JUJ, SAL, SDE, TUC) / PRY(PAI)
Eragrostis pectinacea var. pectinacea	ARG(BAI, CHA, COR, DFE, LPA) / BRA(Fuera del área del proyecto) / URY(CAS)
Eragrostis pectinacea var. miserrima	ARG(CHA, COR, DFE, ERI)
Eragrostis perennis	ARG(COS, ERI, MIS) / BRA(PAR, RGS) / URY(PAY, RIV)
Eragrostis peruviana	CHL(TAR, ANT, ATA, IDE)
Eragrostis pilosa	ARG(BAI, CAT, CHA, COR, COS, DFE, ERI, FOR, LPA, MEN, MIS, RNE, SAL, SLU, SFE) / BRA(PAR, RGS, SCA) / CHL(COQ, MAU, BIO, MAG, RME) / PRY(APA, COA) / URY(ART, CAS, CLA, FLO, LAV, PAY, RNO, RIV, SAO, SJO, SOR, TAC)
Eragrostis plana	BRA(PAR, RGS, SCA) / URY(CLA)
Eragrostis polytricha	ARG(BAI, CAT, COR, COS, ERI, LRI, MIS, SAL, SJU, SLU, SFE, TUC) / BRA(PAR, RGS, SCA) / CHL(BIO, ARA, LLA, RME) / PRY(AMA, CAN, CON, MIE, PAI) / URY(CLA, FLA, LAV, MAL, RNO, RIV, SJO, TAC, TYT)
Eragrostis purpurascens	BRA(RGS, SCA) / PRY(CON) / URY(ART, CAS, CLA, MAL, MON, RIV, ROC, TAC)
Eragrostis pycnantha	CHL(ATA)
Eragrostis retinens	ARG(BAI, COR, ERI, LPA, SFE, SLU) / BRA(RGS) / URY(ART, CAS, CLA, COL, FLA, MAL, MON, RNO, SJO, SOR, TAC)
Eragrostis rojasii	ARG(COS, MIS) / BRA(RGS) / PRY(AMA, CAU)
Eragrostis rufescens	BRA(PAR) / PRY(AMA)
Eragrostis seminuda	ARG(COS, MIS) / BRA(PAR, RGS) / PRY(MIE)
Eragrostis solida	ARG(COS) / BRA(PAR) / PRY(AMA, CAN, CEN, CON, COA, GUA, MIE, PAI, SPE)
Eragrostis spicata	ARG(CHA, ERI, FOR, SAL, SFE) / PRY(APY)
Eragrostis tef	ARG(MEN, SLU) / BRA(Fuera del área del proyecto)
Eragrostis tenuifolia	ARG(COS, FOR, JUJ, MIS, SAL, TUC) / BRA(PAR, RGS) / CHL(VAL)
Eragrostis triangularis	PRY(AMA, CAU)
Eragrostis trichocolea	ARG(BAI, CAT, COR, COS, ERI, JUJ, LPA, LRI, MEN, MIS, SAL, SJU, SLU, SFE, TUC) / BRA(PAR, RGS, SCA) / PRY(CAU, ITA) / URY(ART, CAS, COL, MAL, MON, RNO, ROC, SAO, SJO, SOR)
Eragrostis weberbaueri	CHL(TAR, ANT)
Ercilla spicata	CHL(VAL, MAU, BIO, LLA)
Ercilla syncarpellata	CHL(MAU, LLA, AIS)
Erechtites goyazensis	BRA(Fuera del área del proyecto) / PRY(AMA)
Erechtites hieraciifolius var. cacalioides	ARG(BAI, CHA, COR, COS, DFE, ERI, FOR, JUJ, MIS, SAL, SFE, TUC) / BRA(PAR, RGS) / PRY(APA, APY, AMA, CAU, CAN, CEN, CON, COA, GUA, ITA, PAI, PHA, SPE) / URY(CAS, COL, MON, PAY, RNO, RIV, ROC, SAO, SOR, TAC)
Erechtites hieraciifolius var. hieraciifolius	PRY(APY, AMA)
Erechtites ignobilis	BRA(PAR) / PRY(AMA, CAU, CAN, SPE)
Erechtites leptanthus	CHL(ANT, ATA)
Erechtites missionus	ARG(MIS) / BRA(PAR, RGS) / PRY(CAU)
Erechtites valerianifolius f. valerianifolius	ARG(CHA, COS, ERI, FOR, MIS, SAL) / BRA(PAR, RGS, SCA) / PRY(APA, AMA, CAU, CAA, CAN, CEN, COA, GUA, ITA, PAI) / URY(RIV, ROC, TAC, TYT)
Erechtites valerianifolius f. organensis	BRA(PAR)
Erechtites valerianifolius f. prenanthoides	BRA(PAR, RGS)
Erechtites valerianifolius f. reductus	BRA(PAR)
Eremium erianthum	ARG(CHU, LRI, MEN, NEU, RNE, SJU, SCR) / CHL(VAL)
Eremocharis confinis	CHL(TAR)
Eremocharis fruticosa	CHL(TAR, ANT, ATA)
Eremodraba intricatissima	CHL(TAR)
Eriachaenium magellanicum	ARG(CHU, SCR, TDF) / CHL(MAG)
Erianthus angustifolius	ARG(CHA, COS, FOR, MIS, SFE) / BRA(PAR, RGS) / PRY(PHA) / URY(DUR, MAL, MON, RIV, TAC)
Erianthus asper	ARG(ERI, MIS) / BRA(PAR, RGS, SCA) / PRY(MIE) / URY(RIV)
Erianthus balansae	ARG(COS, MIS) / PRY(CAU)
Erianthus giganteus	ARG(MIS) / BRA(Fuera del área del proyecto) / PRY(AMA)
Erianthus trinii	ARG(BAI, CHA, COS, ERI, FOR, MIS, SFE) / BRA(PAR, RGS, SCA) / PRY(CAU, GUA) / URY(RIV, SJO)
Erigeron andicola	ARG(CHU, MEN, NEU, SCR, SJU) / CHL(COQ, LBO, MAU, BIO, ARA, AIS, MAG, RME)
Erigeron campanensis	CHL(VAL)
Erigeron cinereus	ARG(CHU, MEN, NEU, RNE, SCR) / CHL(BIO, ARA, AIS, MAG, RME)
Erigeron fasciculatus	CHL(COQ, VAL)
Erigeron fernandezius	CHL(JFE)
Erigeron gilliesii	ARG(CHU, MEN, NEU, RNE, SCR) / CHL(LBO, MAU, BIO, ARA, MAG, RME)
Erigeron illapelinus	ARG(MEN, SJU) / CHL(COQ)
Erigeron imbricatus	ARG(CHU, RNE, SCR)
Erigeron incertus	ARG(TDF)
Erigeron ingae	CHL(JFE)
Erigeron karwinskianus	ARG(COR) / CHL(VAL, BIO, LLA, RME)
Erigeron lanceolatus	ARG(JUJ, SAL, TUC)
Erigeron leiolepis	ARG(MEN)
Erigeron leptopetalus	ARG(CAT, CHU, LRI, MEN, NEU, RNE, SCR, SJU, TDF) / CHL(ATA, COQ, MAU, BIO, LLA, MAG, RME)
Erigeron luteoviridis	CHL(JFE)
Erigeron luxurians	CHL(COQ, VAL)
Erigeron myosotis	ARG(CHU, MEN, NEU, RNE, SCR, TDF) / CHL(COQ, LBO, MAU, BIO, ARA, LLA, AIS, MAG)
Erigeron othonnifolius	CHL(VAL, MAU, BIO)
Erigeron patagonicus	ARG(CHU, NEU, SCR, TDF) / CHL(BIO, MAG)
Erigeron pulcher	ARG(MEN, SJU) / CHL(VAL, RME)
Erigeron rosulatus	ARG(JUJ) / CHL(TAR)
Erigeron rupicola	CHL(JFE)
Erigeron schnackii	ARG(CHU, MEN, NEU, RNE)
Eriobotrya japonica	ARG(MIS)
Eriocaulon arechavaletae	ARG(CHA, COS, MIS) / BRA(RGS) / URY(CAS, TAC)
Eriocaulon caaguazuensis	PRY(APA, CAU, CAN)
Eriocaulon candidum	BRA(RGS)
Eriocaulon crassiscapum	ARG(COS, MIS) / BRA(PAR, RGS)
Eriocaulon dictyophyllum	BRA(PAR, SCA)
Eriocaulon elichrysoides	BRA(Fuera del área del proyecto) / PRY(APA, AMA, SPE)
Eriocaulon gomphrenoides	BRA(RGS, SCA)
Eriocaulon leptophyllum	ARG(COS, MIS) / BRA(PAR, RGS, SCA) / PRY(GUA) / URY(CAS)
Eriocaulon ligulatum	BRA(PAR, RGS, SCA)
Eriocaulon magnificum	BRA(PAR, RGS, SCA) / URY(ROC)
Eriocaulon magnum	ARG(CHA, COS, MIS) / BRA(RGS) / PRY(APA, AMA, CAU, COA, PAI, PHA, SPE)
Eriocaulon megapotamicum	BRA(RGS)
Eriocaulon missionum	ARG(MIS)
Eriocaulon modestum	BRA(PAR, RGS, SCA) / PRY(APA, CAU, SPE) / URY(CAS)
Eriocaulon reitzii	BRA(SCA)
Eriocaulon sellowianum var. sellowianum	ARG(COS) / BRA(PAR, SCA) / PRY(APA, CAU, CAN, SPE)
Eriocaulon sellowianum var. longifolium	BRA(PAR)
Eriocaulon sellowianum var. paranense	BRA(PAR, SCA) / PRY(APA, SPE)
Eriocaulon ulaei var. ulaei	BRA(SCA)
Eriocaulon ulaei var. radiosum	BRA(SCA)
Eriochloa acuminata	ARG(CAT, COR)
Eriochloa distachya	PRY(AMA)
Eriochloa grandiflora	ARG(MIS) / BRA(PAR) / PRY(AMA, CAU, CON)
Eriochloa montevidensis	ARG(BAI, CHA, COR, COS, ERI, FOR, JUJ, SAL, SDE, SFE, TUC) / BRA(RGS) / CHL(TAR) / PRY(APY, CEN, PHA) / URY(Desconocida)
Eriochloa nana	ARG(COS, FOR)
Eriochloa polystachya	BRA(RGS, SCA)
Eriochloa pseudoacrotricha	ARG(CHA, LRI, SAL, SLU)
Eriochloa punctata	ARG(BAI, CAT, CHA, COR, COS, DFE, ERI, FOR, JUJ, LRI, MIS, SAL, SLU, SFE, SDE, TUC) / BRA(PAR, RGS) / PRY(AMA, CAU, CEN, CON, ÑEE, PAI, PHA) / URY(ART)
Eriochloa tridentata	ARG(CAT, CHA, COS, ERI, FOR, SFE, SDE)
Eriochrysis cayennensis	ARG(COS, ERI, MIS) / BRA(PAR, RGS, SCA) / PRY(CAA, CAN) / URY(DUR, RIV, TAC)
Eriochrysis filiformis	BRA(PAR) / PRY(CAU)
Eriochrysis holcoides	BRA(PAR) / PRY(AMA, CAN, COA, GUA)
Eriochrysis laxa	ARG(COS, MIS) / BRA(PAR, RGS, SCA)
Eriochrysis villosa	BRA(SCA)
Eriogonum divaricatum	ARG(CHU, NEU, SCR)
Eriolarynx iochromoides	ARG(CAT)
Eriolarynx lorentzii	ARG(CAT, TUC)
Erioneuron avenaceum var. kurtzianum	ARG(LPA, SJU)
Erioneuron avenaceum var. longiglume	ARG(CAT, LRI, MEN, SJU, TUC)
Erioneuron avenaceum var. pygmaeum	ARG(JUJ, SAL, TUC)
Erioneuron pilosum var. longiaristatum	ARG(COR, LPA, LRI, MEN, RNE, SDE, SJU, SLU)
Erioneuron pilosum var. mendocinum	ARG(LPA, MEN)
Eriope crassipes ssp. trichopoda	PRY(COA)
Eriope crassipes ssp. crassipes	BRA(PAR)
Eriope macrostachya var. macrostachya	BRA(PAR) / PRY(AMA, CON)
Eriope macrostachya var. hypoleuca	BRA(Fuera del área del proyecto) / PRY(APY, CAN, CON, PHA)
Eriopsis sceptrum	BRA(PAR)
Eriosema boelckei	BRA(Fuera del área del proyecto) / PRY(AMA)
Eriosema campestre var. delicatula	ARG(COS) / BRA(RGS) / PRY(CAU, CAN, COA, SPE)
Eriosema campestre var. macrophyllum	BRA(PAR, SCA)
Eriosema campestre var. campestre	ARG(MIS) / BRA(PAR, RGS, SCA) / PRY(APA, AMA, CAU, CAN, SPE)
Eriosema crinitum var. discolor	BRA(PAR, SCA)
Eriosema crinitum var. pulchellum	BRA(PAR, RGS) / PRY(AMA, CAU, COA, SPE)
Eriosema crinitum var. crinitum	BRA(PAR, RGS, SCA)
Eriosema glabrum	ARG(MIS) / BRA(PAR)
Eriosema hasslerianum	BRA(Fuera del área del proyecto) / PRY(CAN)
Eriosema heterophyllum	BRA(PAR, SCA)
Eriosema longifolium	BRA(PAR, RGS, SCA) / PRY(AMA, CAN, SPE)
Eriosema obovatum	BRA(PAR)
Eriosema platycarpon	ARG(CHA, COS, MIS) / BRA(Fuera del área del proyecto) / PRY(AMA, CAN, CON, COA, GUA, ITA, ÑEE, PAI, SPE)
Eriosema rufum var. macrostachyum	ARG(MIS) / BRA(PAR, RGS, SCA) / PRY(APY, AMA, CAU, CAN, CON, SPE)
Eriosema simplicifolium	ARG(CHA) / BRA(PAR) / PRY(AMA)
Eriosema strictum	BRA(PAR, RGS, SCA) / PRY(AMA, CAN, GUA)
Eriosema tacuaremboense	ARG(CHA, COS, MIS, SFE) / BRA(PAR, RGS, SCA) / PRY(AMA, CAU, CAA, CAN, CON, COA, GUA, MIE, PAI, SPE) / URY(RIV, TAC)
Eriosema violaceum	BRA(Fuera del área del proyecto) / PRY(AMA)
Eriosorus areniticola	BRA(PAR, SCA)
Eriosorus myriophyllus	BRA(PAR, RGS, SCA) / URY(CLA)
Eriosyce aurata var. aurata	CHL(ATA, COQ, VAL, RME)
Eriosyce aurata var. spinibarbis	CHL(ATA)
Eriosyce ihotzkyana	CHL(COQ)
Eriosyce lapampaensis	CHL(ATA)
Eriosyce megacarpa	CHL(ATA)
Eriosyce rodentiophila	CHL(ANT, ATA)
Eriotheca gracilipes	BRA(Fuera del área del proyecto) / PRY(AMA, CAN)
Erodium botrys	CHL(COQ, VAL, BIO, ARA, RME)
Erodium cicutarium	ARG(BAI, CAT, CHU, COR, DFE, ERI, JUJ, LPA, LRI, MEN, NEU, RNE, SAL, SCR, SFE, SJU, SLU, TDF, TUC) / CHL(TAR, ANT, ATA, COQ, VAL, LBO, MAU, BIO, ARA, LLA, AIS, MAG, RME, JFE) / URY(PAY, SOR)
Erodium geoides	ARG(BAI, COR, LPA) / BRA(RGS) / CHL(COQ, VAL, ARA) / URY(COL, ROC)
Erodium malacoides var. malacoides	ARG(BAI, COR, ERI, LPA, SDE, SFE) / CHL(ANT, ATA, COQ, VAL, RME) / URY(MON)
Erodium malacoides var. ribifolium	CHL(COQ, VAL, RME)
Erodium moschatum	ARG(BAI, COR, ERI, JUJ, LPA, LRI, TUC) / CHL(ANT, COQ, VAL, LBO, MAU, BIO, ARA, LLA, RME) / URY(MON)
Errazurizia multifoliolata	CHL(ANT, ATA, COQ)
Eruca vesicaria ssp. sativa	ARG(BAI, CAT, CHU, COR, COS, ERI, FOR, JUJ, LPA, LRI, MEN, NEU, RNE, SAL, SDE, SFE, SJU, SLU, TUC) / CHL(VAL)
Eryngium agavifolium	ARG(COR, SDE, SLU)
Eryngium aloifolium	BRA(SCA)
Eryngium anomalum	CHL(ATA, COQ, VAL)
Eryngium balansae	ARG(CHA, FOR) / BRA(RGS) / PRY(APA, CAU, GUA, PAI, SPE)
Eryngium bupleuroides	CHL(JFE)
Eryngium cabrerae	ARG(BAI, SFE)
Eryngium canaliculatum	BRA(PAR, SCA)
Eryngium cardosii	CHL(BIO)
Eryngium chamissonis	ARG(COS, MIS) / BRA(PAR, RGS, SCA) / PRY(MIE) / URY(ROC)
Eryngium chubutense	ARG(BAI, CAT, CHA, CHU, COR, ERI, LPA, RNE, SFE, TUC)
Eryngium ciliatum	ARG(COS, ERI) / BRA(RGS) / PRY(SPE) / URY(ART, RIV, TAC)
Eryngium coquimbanum	CHL(COQ)
Eryngium corallinum	BRA(PAR, SCA)
Eryngium coronatum	ARG(BAI, CHA, COR, COS, ERI, FOR, JUJ, LPA, MIS, SDE, SFE, TUC) / PRY(APY, CEN, PHA)
Eryngium depressum	CHL(VAL, LBO, MAU, BIO, ARA, LLA, RME)
Eryngium divaricatum	ARG(BAI, CHA, COS, DFE, ERI, MIS, SFE) / BRA(RGS) / PRY(CEN) / URY(RNO)
Eryngium dorae	ARG(COS, ERI, SFE) / BRA(RGS) / URY(RNO, RIV)
Eryngium dusenii	BRA(PAR, RGS, SCA)
Eryngium ebracteatum	ARG(BAI, CAT, CHA, COR, COS, ERI, FOR, JUJ, LPA, LRI, MIS, RNE, SAL, SDE, SFE, SJU, TUC) / BRA(PAR, RGS, SCA) / PRY(APY, BOQ, CAA, CAN, ÑEE, PHA) / URY(MON)
Eryngium eburneum	ARG(BAI, CHA, COS, ERI, FOR, MIS, SDE, SFE) / BRA(PAR, RGS, SCA) / PRY(CAU, CAN, COA, ÑEE) / URY(ART, COL, FLA, MAL, MON, RNO, SJO, SOR, TAC)
Eryngium echinatum	ARG(BAI, CHA, COS, ERI, MIS, SFE) / BRA(RGS, SCA) / URY(ART, CAS, COL, FLO, FLA, MAL, MON, RNO, ROC, SAO, SJO, SOR, TAC)
Eryngium ekmanii	ARG(BAI, CHA, COS, MIS, SFE) / BRA(PAR, RGS, SCA) / PRY(APA, CAA, PAI)
Eryngium elegans	ARG(BAI, CAT, CHA, COR, COS, ERI, FOR, JUJ, LPA, MIS, SAL, SDE, SFE, TUC) / BRA(PAR, RGS, SCA) / PRY(AMA, COA, ITA, ÑEE, PAI, SPE) / URY(CAS, CLA, COL, MAL, RIV, ROC, SAO, SJO, SOR, TAC)
Eryngium eriophorum	ARG(COS, MIS) / BRA(PAR, RGS, SCA) / URY(RIV, TAC)
Eryngium falcifolium	BRA(RGS)
Eryngium fernandezianum	CHL(JFE)
Eryngium floribundum	ARG(BAI, CHA, COS, FOR, MIS) / BRA(PAR, RGS, SCA) / PRY(AMA, CAA, CAN, GUA, ITA, MIE)
Eryngium glossophyllum	ARG(JUJ, SAL)
Eryngium horridum	ARG(BAI, CHA, COR, COS, ERI, MIS, SDE, SFE, SLU) / BRA(PAR, RGS, SCA) / PRY(CAN, COA, ÑEE, PAI) / URY(CAS, FLA, LAV, MAL, PAY, RIV, SJO, SOR)
Eryngium humifusum	CHL(BIO, ARA, LLA)
Eryngium inaccessum	CHL(JFE)
Eryngium incantatum	ARG(SAL)
Eryngium junceum	BRA(PAR, RGS, SCA)
Eryngium juncifolium	ARG(MIS) / BRA(PAR, SCA) / PRY(APA, AMA)
Eryngium koehneanum	BRA(PAR, SCA)
Eryngium lorentzii	ARG(TUC)
Eryngium luzulaefolium	ARG(BAI, COS, MIS, SFE) / BRA(RGS) / PRY(CAU) / URY(PAY, SAO, SOR)
Eryngium macracanthum	CHL(ATA)
Eryngium megapotamicum	ARG(ERI) / BRA(PAR, RGS, SCA) / URY(CAS, CLA, FLA, MAL, MON, PAY, SJO, SJO)
Eryngium mesopotamicum	ARG(BAI, CHA, COS, DFE, ERI, SFE) / BRA(PAR, RGS, SCA) / URY(CAS, COL, RIV, SJO, SJO)
Eryngium nudicaule	ARG(BAI, CHA, COR, COS, ERI, LRI, MIS, SFE, SLU) / BRA(RGS, SCA) / PRY(CEN, PAI) / URY(ART, CLA, COL, FLO, FLA, LAV, MAL, MON, PAY, RIV, ROC, SAO, SJO, SOR)
Eryngium ombrophilum	BRA(PAR)
Eryngium pandanifolium	ARG(BAI, CHA, COS, ERI, MIS, SFE) / BRA(PAR, RGS, SCA) / PRY(APA, ÑEE) / URY(CAS, COL, MAL, MON)
Eryngium paniculatum	ARG(BAI, CHU, LPA, NEU, RNE) / BRA(RGS) / CHL(COQ, VAL, LBO, MAU, BIO, ARA, LLA, RME)
Eryngium paraguariense	BRA(RGS) / PRY(CAN)
Eryngium plantaginifolium	PRY(AMA, CAU)
Eryngium pohlianum	BRA(PAR, RGS, SCA)
Eryngium polyrhizum	CHL(BIO)
Eryngium pristis	ARG(CHA, COS, MIS) / BRA(PAR, RGS) / PRY(APA, CAA) / URY(CLA, TYT)
Eryngium pseudojunceum	ARG(NEU) / CHL(VAL, BIO, ARA, LLA)
Eryngium pulchellum	CHL(ANT, ATA, COQ, VAL)
Eryngium ramboanum	BRA(RGS)
Eryngium raulinii	BRA(SCA)
Eryngium regnellii	ARG(BAI, MIS) / BRA(RGS, SCA) / URY(LAV, MAL, MON, RNO)
Eryngium rojasii	PRY(AMA)
Eryngium rostratum	CHL(VAL, LBO, MAU, BIO, ARA)
Eryngium sanguisorba	ARG(COS, ERI, MIS) / BRA(PAR, RGS, SCA) / PRY(APA, CAU, CAA, CAN, CEN, ITA, MIE, SPE) / URY(CAS, CLA, FLA, LAV, MAL, PAY, ROC, SJO, SOR, TAC, TYT)
Eryngium sarcophyllum	CHL(JFE)
Eryngium scirpinum	BRA(PAR, RGS, SCA)
Eryngium serra	ARG(BAI, ERI, SFE) / BRA(RGS, SCA) / PRY(CEN) / URY(CAS, FLA, MAL, SJO, SOR)
Eryngium smithii	BRA(RGS, SCA)
Eryngium stenophyllum	ARG(CHA, COS, MIS, SFE) / BRA(PAR, RGS) / PRY(CAA, ITA) / URY(ART, RIV)
Eryngium subinerme	BRA(PAR, SCA)
Eryngium urbanianum	BRA(RGS, SCA)
Eryngium zosterifolium	BRA(RGS, SCA)
Erysimum cheiranthoides	ARG(TDF)
Erysimum repandum	ARG(BAI, CHU, LPA, MEN, NEU, RNE, SCR)
Erythranthe bridgesii	ARG(CHU) / CHL(VAL, LBO, MAU, BIO, ARA, LLA, RME)
Erythranthe cuprea	ARG(CHU, MEN, NEU, RNE) / CHL(LBO, MAU, BIO, ARA)
Erythranthe depressa var. ciminum	CHL(ATA)
Erythranthe depressa	ARG(JUJ, MEN, SAL, SJU, TUC) / CHL(ANT, ATA, COQ)
Erythranthe lacerata	ARG(SJU)
Erythranthe lutea	ARG(BAI, CAT, CHU, JUJ, LRI, MEN, NEU, RNE, SAL, SJU, SCR, TDF, TUC) / CHL(ATA, COQ, VAL, LBO, MAU, BIO, ARA, LLA, AIS, RME)
Erythranthe lutea var. variegata	CHL(LBO, MAU)
Erythranthe minima	CHL(ATA)
Erythranthe parviflora	
Erythranthe pilosiuscula	
Erythrina crista-galli var. crista-galli	ARG(BAI, CAT, CHA, COS, ERI, FOR, JUJ, LPA, MIS, SAL, SFE, SDE, TUC) / BRA(PAR, RGS, SCA) / PRY(APA, CAU, CAN, COA, ITA, ÑEE, PAI) / URY(CAS, CLA, COL, DUR, MON, ROC, SAO, SJO, SOR, TAC)
Erythrina crista-galli var. leucochloa	URY(TYT)
Erythrina crista-galli var. longiflora	ARG(JUJ, SAL, SDE, TUC)
Erythrina dominguezii	ARG(CHA, FOR, JUJ, SAL) / BRA(Fuera del área del proyecto) / PRY(APY, CAN, ÑEE)
Erythrina falcata	ARG(COS, JUJ, MIS, SAL, TUC) / BRA(PAR, RGS, SCA) / PRY(APA)
Erythrina similis	BRA(Fuera del área del proyecto) / PRY(COA)
Erythrina speciosa	BRA(PAR, SCA)
Erythrodes commelinoides	BRA(PAR)
Erythroxylum ambiguum	BRA(PAR, SCA)
Erythroxylum anguifugum	BRA(PAR) / PRY(AMA, CON, SPE)
Erythroxylum argentinum	ARG(CAT, JUJ, MIS, SAL, SDE, TUC) / BRA(PAR, RGS, SCA)
Erythroxylum buxus	BRA(PAR) / PRY(AMA)
Erythroxylum campestre	BRA(PAR) / PRY(AMA, CON)
Erythroxylum catharinense	BRA(SCA)
Erythroxylum cuneifolium	ARG(CHA, COS, ERI, FOR, JUJ, MIS, SAL, SDE, SFE) / BRA(PAR, RGS, SCA) / PRY(APA, APY, AMA, BOQ, CAU, CAN, CEN, CHO, CON, COA, GUA, ITA, ÑEE, NAS, PAI, PHA, SPE)
Erythroxylum cuspidifolium	BRA(PAR, RGS, SCA)
Erythroxylum deciduum	ARG(COS, MIS) / BRA(PAR, RGS, SCA) / PRY(APA, CAU, CAA, CAN, COA, GUA, ITA, PAI, SPE)
Erythroxylum gonoclados	BRA(PAR, SCA)
Erythroxylum microphyllum	ARG(CHA, COS, ERI, MIS, SFE) / BRA(PAR, RGS, SCA) / PRY(APA, AMA, CAU, COA, SPE) / URY(ART, TYT)
Erythroxylum myrsinites	ARG(COS, MIS) / BRA(PAR, RGS, SCA) / PRY(CAA, CAN, GUA, MIE) / URY(ART, RIV, TAC)
Erythroxylum pachyneurum	PRY(CAU)
Erythroxylum paraguariense	PRY(CON, COA, SPE)
Erythroxylum patentissimum	PRY(APY, CON)
Erythroxylum pelleterianum	BRA(PAR, RGS) / PRY(AMA, CAN, COA, PAI, SPE)
Erythroxylum suberosum	BRA(PAR) / PRY(AMA, CAU, CAN, CON, SPE)
Erythroxylum substriatum	BRA(RGS)
Erythroxylum vaccinifolium	BRA(PAR, RGS, SCA) / URY(ART, MON)
Escallonia alpina var. alpina	ARG(CHU, NEU, RNE, SCR) / CHL(VAL, MAU, BIO, ARA, LLA, AIS, MAG, RME)
Escallonia alpina var. carmelitana	ARG(MEN, NEU) / CHL(VAL, LBO, MAU, BIO, RME)
Escallonia alpina var. glabrata	CHL(BIO)
Escallonia angustifolia	ARG(SJU) / CHL(TAR, ATA, COQ)
Escallonia bifida	ARG(MIS) / BRA(PAR, RGS, SCA) / PRY(APA, CAU, CAA, GUA) / URY(MAL, MON, RIV, ROC, TAC, TYT)
Escallonia callcottiae	CHL(JFE)
Escallonia chlorophylla	BRA(PAR, RGS)
Escallonia cordobensis	ARG(COR, SLU)
Escallonia farinacea	BRA(PAR, SCA)
Escallonia florida	CHL(MAU, BIO, ARA)
Escallonia gayana	CHL(BIO, ARA, LLA)
Escallonia hypoglauca	ARG(JUJ, SAL)
Escallonia illinita var. illinita	CHL(COQ, VAL, LBO, MAU, BIO, RME)
Escallonia illinita var. pubicalycina	CHL(COQ, VAL, LBO, MAU, BIO, ARA, RME)
Escallonia laevis	BRA(PAR, SCA)
Escallonia ledifolia	BRA(SCA)
Escallonia leucantha	ARG(CHU, NEU) / CHL(MAU, BIO, ARA, LLA)
Escallonia megapotamica var. megapotamica	ARG(BAI, COS, ERI, MIS) / BRA(PAR, RGS, SCA) / URY(CAS, CLA, COL, FLA, MON, PAY, RNO, ROC, SAO)
Escallonia millegrana	ARG(JUJ, SAL, TUC)
Escallonia myrtilloides	ARG(SAL)
Escallonia myrtoidea	ARG(MEN) / CHL(COQ, VAL, LBO, MAU, BIO, RME)
Escallonia obtusissima	BRA(PAR, SCA)
Escallonia petrophila	BRA(RGS, SCA)
Escallonia pulverulenta var. glabra	CHL(COQ, VAL, LBO, MAU, BIO, RME)
Escallonia pulverulenta var. pulverulenta	CHL(COQ, VAL, LBO, MAU, BIO, ARA, RME)
Escallonia revoluta	CHL(COQ, VAL, MAU, BIO, ARA, LLA)
Escallonia rosea	ARG(CHU) / CHL(MAU, BIO, ARA, LLA, AIS, MAG)
Escallonia rubra var. rubra	ARG(CHU, NEU, RNE, SCR) / CHL(COQ, VAL, LBO, MAU, BIO, ARA, LLA, AIS, MAG, RME)
Escallonia rubra var. dumetorum	ARG(CHU, NEU, RNE) / CHL(ARA, LLA)
Escallonia rubra var. glutinosa	CHL(LBO, MAU, BIO)
Escallonia rubra var. macrantha	CHL(BIO, ARA, LLA, AIS)
Escallonia rubra var. thalassica	CHL(COQ, VAL, MAU, RME)
Escallonia schreiteri	ARG(JUJ, SAL, TUC)
Escallonia serrata	ARG(TDF) / CHL(LLA, AIS, MAG)
Escallonia tucumanensis	ARG(CAT, JUJ, LRI, SAL, TUC)
Escallonia virgata	ARG(CHU, NEU, RNE, SCR, TDF) / CHL(MAU, BIO, ARA, LLA, AIS, MAG, RME)
Eschscholzia californica	ARG(BAI, CHA, CHU, COR, LPA, NEU, RNE, SLU, TUC) / CHL(COQ, VAL, LBO, MAU, BIO, ARA, LLA, RME)
Escobedia grandiflora	ARG(COS, FOR) / BRA(PAR, RGS, SCA) / PRY(AMA, CAU)
Esenbeckia densiflora	ARG(MIS) / BRA(SCA) / PRY(AMA, CAU, CEN, COA, GUA, PAI)
Esenbeckia febrifuga	ARG(MIS) / BRA(PAR) / PRY(APA, AMA, CAU, CAA, CAN, CEN, CON, COA, GUA, ITA, PAI, SPE)
Esenbeckia grandiflora	ARG(COS, MIS) / BRA(PAR, RGS, SCA) / PRY(APA, CAU, CAN, COA, PAI)
Esenbeckia hieronymi	BRA(PAR, SCA)
Esterhazya macrodonta	BRA(PAR)
Esterhazya splendida	BRA(PAR, RGS, SCA) / PRY(AMA)
Eubrachion ambiguum	ARG(CAT, COR, COS, ERI, SAL, TUC) / BRA(PAR, RGS, SCA) / URY(ART, FLA, MON, SAO, SJO, SOR)
Eucalyptus cinerea	ARG(COR)
Eucalyptus grandis	ARG(JUJ)
Eucalyptus quadrangulata	ARG(JUJ)
Eucalyptus sideroxylon	ARG(COR)
Eucalyptus tereticornis	ARG(COR)
Eucryphia cordifolia	ARG(CHU, NEU, RNE) / CHL(BIO, ARA, LLA, AIS)
Eucryphia glutinosa	CHL(MAU, BIO, ARA)
Eugenia adenantha	PRY(COA, PHA)
Eugenia angelyana	BRA(SCA)
Eugenia angustissima	BRA(RGS) / PRY(CAN)
Eugenia anomala	ARG(COS, MIS) / BRA(PAR, RGS) / PRY(COA) / URY(ART, TAC)
Eugenia arenosa	BRA(RGS)
Eugenia astrigens	BRA(PAR, SCA)
Eugenia atrata	PRY(AMA)
Eugenia aurata	BRA(PAR) / PRY(AMA, CON)
Eugenia bacopari	BRA(PAR, RGS, SCA)
Eugenia beaurepaireana	BRA(PAR, SCA)
Eugenia bimarginata	BRA(PAR) / PRY(AMA, CAN)
Eugenia bocainensis	BRA(PAR)
Eugenia brasiliensis	BRA(PAR, SCA)
Eugenia bresolinii	BRA(SCA)
Eugenia brevipedunculata	BRA(PAR, SCA)
Eugenia brevistila	BRA(PAR, RGS, SCA)
Eugenia brunneopubescens	BRA(PAR)
Eugenia bunchosiifolia	BRA(PAR)
Eugenia burkartiana	ARG(COS, MIS) / BRA(PAR, SCA) / PRY(APA, COA)
Eugenia capitulifera	BRA(PAR)
Eugenia catharinae	BRA(PAR, SCA)
Eugenia catharinensis	BRA(PAR, SCA)
Eugenia cerasiflora	BRA(SCA)
Eugenia cereja	BRA(PAR, SCA)
Eugenia convexinervia	BRA(PAR, SCA)
Eugenia copacabanensis	BRA(PAR)
Eugenia corrientina	PRY(CAN)
Eugenia cuprea	BRA(PAR)
Eugenia cycliantha	BRA(SCA)
Eugenia diantha	BRA(Fuera del área del proyecto) / PRY(CAA, CON, COA, PAI, PHA)
Eugenia dimorpha var. australis	BRA(RGS)
Eugenia dimorpha var. dimorpha	BRA(RGS)
Eugenia dimorpha var. oeidocarpa	BRA(RGS)
Eugenia egensis	BRA(PAR) / PRY(APY, AMA, CAA, CEN, COA, PHA, SPE)
Eugenia eurysepala	BRA(PAR)
Eugenia excelsa	BRA(PAR)
Eugenia flava	BRA(Fuera del área del proyecto) / PRY(CAN)
Eugenia florida	BRA(PAR) / PRY(AMA, CAN, COA, ÑEE, PAI)
Eugenia floscellus	BRA(SCA)
Eugenia gardneriana	BRA(PAR, SCA)
Eugenia grandisepala	BRA(PAR)
Eugenia hagelundii	BRA(PAR, RGS) / PRY(PAI)
Eugenia handroana	BRA(PAR, SCA)
Eugenia handroi	BRA(PAR, RGS, SCA)
Eugenia hassleriana	PRY(SPE)
Eugenia herbacea	BRA(Fuera del área del proyecto) / PRY(APA)
Eugenia hyemalis var. marginata	ARG(COS, ERI, FOR, JUJ, MIS, SAL) / BRA(RGS) / PRY(COA, PAI)
Eugenia hyemalis var. hyemalis	BRA(PAR, RGS, SCA) / PRY(CAA, ÑEE, PAI)
Eugenia ilhensis	PRY(CON, PHA)
Eugenia imaruiensis	BRA(SCA)
Eugenia involucrata	ARG(COS, MIS) / BRA(PAR, RGS, SCA) / PRY(APA, CAA, COA, GUA) / URY(PAY)
Eugenia itacolumensis	BRA(PAR, SCA)
Eugenia janeirensis	BRA(PAR)
Eugenia klappenbachiana	BRA(PAR)
Eugenia kleinii var. kleinii	BRA(PAR, SCA)
Eugenia kleinii var. aristata	BRA(PAR)
Eugenia lanosa	BRA(SCA)
Eugenia lepida	BRA(PAR)
Eugenia ligustrina	BRA(PAR, SCA)
Eugenia lilloana	ARG(MIS)
Eugenia longipedunculata	BRA(SCA)
Eugenia lucida	BRA(PAR, SCA)
Eugenia macrobracteolata	BRA(PAR)
Eugenia magnibracteolata	BRA(PAR)
Eugenia malacantha	BRA(PAR, SCA)
Eugenia mansoni	ARG(COS, ERI, MIS) / BRA(RGS, SCA) / PRY(APA, APY, CEN, CON, COA, ÑEE, PAI) / URY(PAY)
Eugenia maracayuensis	PRY(AMA, CAN)
Eugenia mattosii	BRA(SCA)
Eugenia melanogyna	BRA(PAR, SCA)
Eugenia meridionalis	BRA(RGS)
Eugenia microcarpa	BRA(PAR, SCA)
Eugenia minutifolia	BRA(SCA)
Eugenia moraviana	ARG(CHA, COS, FOR, JUJ, MIS, SAL) / BRA(PAR, SCA) / PRY(CAU, CAN, CEN, COA, GUA, ÑEE, PAI, PHA)
Eugenia mosenii	BRA(PAR)
Eugenia multicostata var. multicostata	BRA(RGS, SCA)
Eugenia multicostata var. octocostata	BRA(SCA)
Eugenia multiovulata	BRA(PAR)
Eugenia myrcianthes	ARG(CHA, COS, ERI, FOR, MIS, SFE) / BRA(PAR, RGS) / PRY(APA, APY, AMA, CAN, CEN, CON, COA, PAI) / URY(ART, PAY, SAO)
Eugenia myrciariifolia	BRA(PAR)
Eugenia neoaustralis var. impresso-venosa	BRA(PAR, SCA)
Eugenia neoglomerata	BRA(PAR)
Eugenia neomultipunctata	BRA(PAR)
Eugenia neomyrtifolia	BRA(PAR, SCA)
Eugenia neosilvestris	BRA(SCA)
Eugenia neotristis	BRA(SCA)
Eugenia neoverrucosa	BRA(PAR, SCA)
Eugenia nutans	BRA(SCA)
Eugenia obovata	BRA(PAR, SCA)
Eugenia osoriana	BRA(PAR)
Eugenia pachyclada	BRA(PAR, SCA)
Eugenia pantagensis	BRA(RGS, SCA)
Eugenia paranaensis	BRA(PAR)
Eugenia paranaguensis	BRA(PAR)
Eugenia parodiana	ARG(FOR) / PRY(CEN, SPE)
Eugenia pinhaesensis	BRA(PAR)
Eugenia piresiana	BRA(PAR)
Eugenia pitanga	ARG(COS, MIS) / BRA(PAR, RGS, SCA) / PRY(AMA, CAU, CAN, CEN, GUA, MIE, PAI)
Eugenia platysema	BRA(PAR, RGS)
Eugenia pleurantha	BRA(PAR)
Eugenia pluriflora	BRA(PAR, RGS, SCA) / PRY(COA)
Eugenia prasima	BRA(PAR)
Eugenia pruinosa	BRA(SCA)
Eugenia pruniformis	BRA(PAR)
Eugenia pseudomalacantha	BRA(SCA)
Eugenia psidiiflora var. riedeliana	ARG(COS) / BRA(PAR, RGS, SCA) / PRY(COA)
Eugenia psidiiflora var. schultziana	BRA(RGS, SCA)
Eugenia psidiiflora var. triflora	BRA(PAR)
Eugenia punicifolia	ARG(CHA, COS, FOR) / BRA(Fuera del área del proyecto) / PRY(AMA, CAA, CAN, COA, ÑEE, PAI, PHA)
Eugenia pyriformis var. pyriformis	ARG(COS, MIS) / BRA(PAR, RGS, SCA) / PRY(APA, AMA, CAU, CAA, CAN, CON, COA, GUA, ÑEE, PAI, SPE)
Eugenia pyriformis var. uvalha	ARG(COS, MIS) / BRA(Fuera del área del proyecto) / PRY(CEN, PAI, SPE) / URY(SAO)
Eugenia pyriformis var. argentea	BRA(PAR)
Eugenia racemulosa	BRA(PAR, SCA)
Eugenia ramboi	ARG(MIS) / BRA(PAR, RGS, SCA) / PRY(AMA)
Eugenia reitziana	BRA(SCA)
Eugenia repanda	ARG(COS, ERI, FOR, JUJ, MIS, SAL, SFE) / BRA(PAR, RGS) / PRY(APA, CEN) / URY(ART, RNO, SOR)
Eugenia riedeliana	BRA(PAR)
Eugenia rojasiana	PRY(PAI, SPE)
Eugenia rostratofalcata	BRA(PAR)
Eugenia rostrifolia	BRA(RGS, SCA)
Eugenia rotundicosta	BRA(SCA)
Eugenia rubrescens	BRA(PAR)
Eugenia schüchiana	BRA(PAR, RGS, SCA)
Eugenia sclerocalyx var. sclerocalyx	BRA(SCA)
Eugenia sclerocalyx var. cambajuvensis	BRA(SCA)
Eugenia sehnemiana	BRA(RGS)
Eugenia speciosa	ARG(Desconocida) / BRA(PAR, RGS, SCA) / PRY(CAA, COA) / URY(PAY)
Eugenia stigmatosa	BRA(SCA)
Eugenia striata	BRA(PAR)
Eugenia subavenia	BRA(PAR, SCA)
Eugenia sulcata	BRA(PAR, SCA)
Eugenia uniflora	ARG(CAT, CHA, COS, ERI, FOR, JUJ, MIS, SAL, SFE, TUC) / BRA(PAR, RGS, SCA) / PRY(APY, AMA, CAU, CAA, CAN, CEN, CON, COA, GUA, ÑEE, PAI, PHA, SPE) / URY(DUR, PAY, RIV, ROC, SAO, SOR, TAC, TYT)
Eugenia uruguayensis	ARG(BAI, COS, ERI, MIS) / BRA(PAR, RGS, SCA) / PRY(APA) / URY(DUR, PAY, ROC, SAO, SOR, TAC, TYT)
Eulophia alta	ARG(COS, MIS) / BRA(PAR, RGS, SCA) / PRY(AMA, CAN, PAI)
Eulophia ruwenzoriensis	ARG(COR, COS, SFE) / BRA(PAR) / URY(MAL, RNO)
Eulychnia acida	CHL(ATA, COQ)
Eulychnia aricensis	CHL(TAR)
Eulychnia breviflora	CHL(ANT, ATA, COQ)
Eulychnia castanea	CHL(COQ, VAL)
Eulychnia iquiquensis	CHL(TAR, ANT, ATA)
Eulychnia saint-pieana	CHL(ANT, ATA)
Eupatorium agrigaudium	BRA(PAR, SCA)
Eupatorium alpestre	BRA(SCA)
Eupatorium amambayense	PRY(AMA)
Eupatorium amphidictyum	BRA(PAR)
Eupatorium amygdalinum var. amygdalinum	BRA(Fuera del área del proyecto) / PRY(AMA)
Eupatorium amygdalinum var. ocychlaenum	BRA(Fuera del área del proyecto) / PRY(CAN)
Eupatorium angusticeps	BRA(RGS)
Eupatorium apense	PRY(AMA, SPE)
Eupatorium areniscophilum	PRY(CAU, COA)
Eupatorium asperrimum	BRA(Fuera del área del proyecto) / PRY(AMA)
Eupatorium barbacense	BRA(Fuera del área del proyecto) / PRY(APY, AMA)
Eupatorium betonicaeforme var. ascendens	BRA(SCA)
Eupatorium betonicaeforme var. hastatum	BRA(RGS, SCA)
Eupatorium bupleurifolium var. microcephalum	BRA(SCA)
Eupatorium casarettoi	BRA(PAR, RGS, SCA)
Eupatorium catharinense	BRA(SCA)
Eupatorium charpinii	BRA(Fuera del área del proyecto) / PRY(APY, CON)
Eupatorium chlorolepis	BRA(PAR)
Eupatorium compressum	BRA(RGS, SCA)
Eupatorium concinnum	BRA(PAR, RGS)
Eupatorium cuneatum	BRA(PAR, SCA)
Eupatorium debeauxii	BRA(RGS, SCA)
Eupatorium dispalatum	BRA(SCA)
Eupatorium dusenii	BRA(PAR, SCA)
Eupatorium ericoides	BRA(PAR, RGS) / URY(RIV)
Eupatorium gaudichaudianum var. bipinnatum	BRA(PAR)
Eupatorium gaudichaudianum var. gaudichaudianum	BRA(SCA)
Eupatorium gaudichaudianum var. leucodon	BRA(PAR, RGS, SCA)
Eupatorium gaudichaudianum var. macrodon	BRA(PAR)
Eupatorium gaudichaudianum f. lobatum	BRA(PAR)
Eupatorium gaudichaudianum var. oppositifolium	BRA(PAR)
Eupatorium glechonophyllum	CHL(ANT, COQ, VAL, LBO, MAU, BIO, RME)
Eupatorium gnaphalloides	PRY(GUA)
Eupatorium griseopubescens	BRA(PAR)
Eupatorium hieronymi	URY(FLA, LAV, MAL)
Eupatorium intermedium	BRA(PAR, RGS, SCA) / URY(RIV, TAC)
Eupatorium itatiayense	BRA(PAR, RGS, SCA)
Eupatorium kingii	BRA(SCA)
Eupatorium kleinii	BRA(PAR, SCA)
Eupatorium lanigerum var. minus	ARG(CHA)
Eupatorium lanigerum var. aureoviride	PRY(AMA, CAU, SPE)
Eupatorium lanigerum var. deltoideum	BRA(RGS) / PRY(AMA, CAU, CAN, CON, GUA) / URY(RIV)
Eupatorium leptophlebium	BRA(PAR)
Eupatorium ligulaefolium	BRA(PAR, RGS, SCA)
Eupatorium littorale	BRA(PAR, RGS, SCA)
Eupatorium lobatifolium	BRA(SCA)
Eupatorium lymansmithii	BRA(SCA)
Eupatorium lysimachioides	PRY(APA, AMA, CAU)
Eupatorium maracayuense	BRA(PAR) / PRY(AMA, CAU, CAN)
Eupatorium margaritense	PRY(AMA, CEN, CON, COA, PAI)
Eupatorium megacephalum	BRA(PAR) / PRY(CAU)
Eupatorium multifidum	BRA(SCA)
Eupatorium nummularia	BRA(PAR, RGS)
Eupatorium odoratum var. pauciflorum	BRA(SCA)
Eupatorium oinopolepis	BRA(PAR, SCA)
Eupatorium orbiculatum	BRA(PAR, RGS, SCA)
Eupatorium oxylepis	BRA(Fuera del área del proyecto) / PRY(AMA)
Eupatorium palmare	BRA(PAR, RGS, SCA)
Eupatorium polycladum	BRA(PAR)
Eupatorium polystachyum var. subcordatum	BRA(SCA)
Eupatorium punctulatum	BRA(PAR)
Eupatorium pyrifolium	BRA(SCA)
Eupatorium ramboi	BRA(RGS, SCA)
Eupatorium ramosissimum	BRA(Fuera del área del proyecto) / PRY(AMA)
Eupatorium reitzii	BRA(RGS, SCA)
Eupatorium rhinanthaceum	BRA(RGS) / PRY(CAN)
Eupatorium riedelii	BRA(Fuera del área del proyecto) / PRY(AMA)
Eupatorium rojasii	PRY(AMA)
Eupatorium rosengurttii	BRA(SCA)
Eupatorium rosmarinaceum	BRA(PAR, SCA)
Eupatorium salvium	CHL(COQ, VAL, LBO, MAU, BIO, RME)
Eupatorium sanctopaulense	BRA(PAR, SCA)
Eupatorium serrulatum	BRA(PAR, RGS, SCA) / PRY(APA, AMA)
Eupatorium spathulatum	BRA(RGS, SCA) / PRY(CAU)
Eupatorium squalidum var. subvelutinum	BRA(PAR)
Eupatorium squalidum var. squalidum	BRA(PAR)
Eupatorium stachyophyllum	BRA(PAR)
Eupatorium subcapitatum	BRA(PAR) / PRY(AMA)
Eupatorium subintegerrimum var. aliciae	BRA(SCA)
Eupatorium tacuarembense	URY(TAC)
Eupatorium trichobasis	BRA(PAR, SCA)
Eupatorium tubaraoense	BRA(RGS, SCA)
Eupatorium tweedieanum var. angustius	BRA(RGS)
Eupatorium ulei	BRA(RGS, SCA)
Eupatorium umbelliforme	BRA(PAR, SCA)
Eupatorium variegatum	BRA(PAR) / PRY(AMA, CAU, SPE)
Eupatorium variolatum	BRA(PAR, RGS)
Eupatorium vauthierianum var. trichotomum	PRY(Desconocida)
Eupatorium vauthierianum var. campestre	BRA(PAR, SCA)
Eupatorium vauthierianum var. ramosissimum	BRA(PAR, SCA)
Eupatorium xylorhizum	BRA(SCA)
Euphorbia acerensis	ARG(CAT, COR, JUJ, SAL, SDE, TUC)
Euphorbia adenoptera	ARG(CHA, COR, FOR, MIS, SFE) / PRY(PHA)
Euphorbia amandi	ARG(CAT, JUJ, LRI, SAL, SJU) / CHL(TAR, ANT)
Euphorbia araucana	CHL(BIO, ARA)
Euphorbia argillosa	PRY(CON)
Euphorbia berteroana	ARG(CAT, CHA, COR, COS, ERI, FOR, JUJ, LRI, SAL, SDE, SJU, SLU, TUC) / PRY(PHA)
Euphorbia besseri	
Euphorbia burkartii	ARG(COS, ERI)
Euphorbia caespitosa var. caespitosa	ARG(BAI, MEN) / URY(MON, ROC)
Euphorbia caespitosa var. ventanicola	ARG(BAI)
Euphorbia catamarcensis	ARG(CAT, LRI, MEN, SAL, SJU, SLU)
Euphorbia chamaerrhodos	BRA(RGS) / PRY(APA, AMA, CAU, CON, MIE, PAI)
Euphorbia characias	ARG(BAI)
Euphorbia collina var. andina	ARG(MEN, NEU, SCR) / CHL(MAU, ARA, MAG)
Euphorbia collina var. chrysophylla	ARG(JUJ, SAL, TUC) / BRA(Fuera del área del proyecto)
Euphorbia collina var. collina	ARG(BAI, CHU, COR, JUJ, LPA, MEN, NEU, RNE, SJU, SLU, SCR, SFE) / CHL(COQ, MAU, ARA, RME)
Euphorbia collina var. glaucescens	ARG(CHU, MEN, NEU, RNE, SCR, SJU)
Euphorbia collina var. minor	ARG(MEN, NEU, SCR) / CHL(MAG)
Euphorbia collina var. nahuelhuapina	ARG(CHU, MEN, NEU, RNE, SCR)
Euphorbia collina var. patagonica	ARG(BAI, CHU, MEN, NEU, RNE, SCR, SJU, TDF)
Euphorbia collina var. spathulata	ARG(CHU, MEN, NEU, RNE, SCR) / CHL(AIS)
Euphorbia copiapina	CHL(ANT, ATA)
Euphorbia cyathophora	ARG(COR, ERI, JUJ, MIS, SAL, SDE) / BRA(RGS) / CHL(ANT) / PRY(GUA)
Euphorbia davidii	ARG(BAI, COR, SLU)
Euphorbia dentata	ARG(BAI, CAT, COR, ERI, FOR, JUJ, LPA, LRI, SAL, SFE, SLU, TUC) / PRY(PAI) / URY(FLO)
Euphorbia eichleri	ARG(CAT, CHA, COR, FOR, LRI, SAL, SJU, SLU, SFE, SDE, TUC) / PRY(APY, PHA)
Euphorbia elodes	BRA(PAR, RGS, SCA)
Euphorbia elquiensis	CHL(COQ)
Euphorbia emarginata	URY(RNO)
Euphorbia engelmannii	CHL(ATA, COQ, VAL, LBO, BIO, RME)
Euphorbia falcata	CHL(RME)
Euphorbia germainii	CHL(COQ, RME)
Euphorbia graminea	ARG(JUJ)
Euphorbia guaraniorum	PRY(ITA, MIE)
Euphorbia helioscopia	ARG(BAI, COR, DFE, LPA, MIS) / CHL(TAR, ATA, COQ, VAL, ARA, LLA, RME)
Euphorbia heterophylla	ARG(COR, COS, ERI, FOR, JUJ, MIS, SAL, SFE, TUC) / BRA(PAR, RGS, SCA) / PRY(CAA, CAN, CEN, CON, COA, GUA, ITA, PAI) / URY(SAO)
Euphorbia hieronymi	ARG(CAT, CHU, COR, LRI, MEN, NEU, RNE, SJU, SLU)
Euphorbia hinkleyorum	ARG(JUJ, SAL)
Euphorbia hirta var. hirta	ARG(CHA, COS, ERI, FOR, MIS, SAL) / BRA(PAR, RGS, SCA) / CHL(TAR, IPA) / PRY(APY, CEN)
Euphorbia hirta var. ophthalmica	ARG(BAI, CAT, CHA, COR, COS, FOR, JUJ, LPA, LRI, MIS, SAL, SFE, SDE, TUC) / BRA(SCA) / CHL(TAR, VAL) / PRY(APY) / URY(ART, MON, PAY, SAO)
Euphorbia hirtella	ARG(COS) / BRA(RGS, SCA) / URY(CAS)
Euphorbia huanchalana	ARG(CAT, TUC)
Euphorbia hunzikeri	ARG(SAL, TUC)
Euphorbia hypericifolia	ARG(BAI, CHA, COR, COS, ERI, FOR, JUJ, MIS, RNE, SAL, SFE, TUC) / BRA(Fuera del área del proyecto) / PRY(APY)
Euphorbia hyssopifolia	ARG(BAI, CAT, CHA, COR, COS, FOR, JUJ, MEN, MIS, SAL, SDE, SJU, TUC) / BRA(PAR, RGS, SCA) / PRY(APY, COA, PAI) / URY(ART, PAY, RNO, RIV, SAO)
Euphorbia insulana	ARG(CHA, COS, FOR, MIS, SAL) / BRA(PAR, SCA) / PRY(AMA, PHA)
Euphorbia invaginata	PRY(APY)
Euphorbia klotzschii var. argentina	ARG(BAI, CAT, CHA, CHU, COR, COS, ERI, FOR, JUJ, LRI, MEN, MIS, NEU, RNE, SDE, SFE, SJU, SLU, TUC) / CHL(MAU)
Euphorbia klotzschii var. klotzschii	ARG(BAI, CAT, CHA, COR, COS, ERI, FOR, JUJ, LPA, LRI, MEN, MIS, NEU, RNE, SAL, SDE, SFE, SJU, SLU, TUC) / CHL(TAR, ANT, ATA, COQ, VAL, LBO, MAU, BIO, ARA, RME) / PRY(APY, BOQ, ÑEE, PAI) / URY(MON)
Euphorbia klotzschii var. schizosepala	ARG(BAI, CAT, COR, ERI, JUJ, LRI, MEN, SAL, SJU, SLU, SFE, SDE) / CHL(MAU) / URY(COL)
Euphorbia koernerana	BRA(RGS)
Euphorbia kurtzii	ARG(COR, LRI, MIS, SAL, SLU, TUC)
Euphorbia lactiflua	CHL(ANT, ATA)
Euphorbia lasiocarpa	ARG(CAT, CHA, COR, FOR, JUJ, MIS, SAL, SDE, SFE, SLU, TUC)
Euphorbia lathyrus	ARG(BAI, CHU, COR, FOR, JUJ, LPA, LRI, MEN, SFE, TUC) / CHL(VAL, LBO, MAU, BIO, ARA, LLA, RME, JFE)
Euphorbia lorentzii	ARG(BAI, CAT, COR, ERI, JUJ, LPA, LRI, MEN, SAL, SDE, SFE, SJU, SLU, TUC) / URY(Desconocida)
Euphorbia lutulenta	URY(FLA)
Euphorbia macraulonia	CHL(RME)
Euphorbia maculata	ARG(BAI, CHA, COR, COS, ERI, FOR, JUJ, LRI, MIS, SAL, SJU, SLU, SFE, SDE, TUC) / CHL(ATA, COQ, VAL, MAU, BIO, RME) / URY(SJO)
Euphorbia marayensis	ARG(CAT, SAL, SJU)
Euphorbia marginata	ARG(BAI, COR, COS, ERI, LPA, MEN) / BRA(RGS)
Euphorbia meyeniana	CHL(TAR) / PRY(APY, PHA)
Euphorbia nutans	ARG(COS, JUJ)
Euphorbia oranensis	ARG(SAL) / PRY(APY)
Euphorbia ovalleana	CHL(COQ)
Euphorbia pampeana	ARG(BAI) / BRA(RGS) / URY(CAS)
Euphorbia papillosa var. papillosa	ARG(COS, ERI, MIS) / BRA(PAR, RGS, SCA) / PRY(CAU, PAI) / URY(SAO)
Euphorbia papillosa var. cabrerae	ARG(COS, ERI, MIS) / BRA(RGS) / PRY(CAU)
Euphorbia paranensis	BRA(PAR, RGS, SCA)
Euphorbia pedersenii	ARG(COS)
Euphorbia pentadactyla	ARG(CAT, COR, FOR, JUJ, LRI, MIS, SAL, SJU, SLU, SDE) / PRY(PHA)
Euphorbia peperomioides	BRA(PAR, RGS, SCA)
Euphorbia peplus	ARG(BAI, CAT, COR, ERI, JUJ, LPA, LRI, MEN, MIS, NEU, RNE, SAL, SJU, SLU, SFE, TUC) / BRA(PAR, RGS, SCA) / CHL(TAR, ANT, ATA, COQ, VAL, LBO, MAU, BIO, ARA, LLA, RME, JFE, IPA) / URY(MON)
Euphorbia philippiana	CHL(BIO)
Euphorbia platyphyllos	ARG(BAI, RNE) / CHL(VAL, LBO, MAU, BIO, RME) / PRY(PHA)
Euphorbia porphyrantha	CHL(ANT, ATA)
Euphorbia portucasadiana	ARG(COS, FOR) / PRY(PHA)
Euphorbia portulacoides var. acutifolia	ARG(BAI, CAT, CHA, CHU, COR, COS, ERI, JUJ, LPA, MEN, SAL, SLU, TUC)
Euphorbia portulacoides var. major	ARG(BAI, COR, ERI, JUJ, SAL, SLU, TUC)
Euphorbia portulacoides var. portulacoides	ARG(BAI, CAT, CHU, COR, COS, ERI, JUJ, LPA, MEN, NEU, SAL, SLU, SFE, TUC) / CHL(COQ, VAL, LBO, MAU, BIO, ARA, LLA, AIS, MAG, RME) / URY(MON)
Euphorbia potentilloides	ARG(COS, MIS) / BRA(PAR, RGS) / PRY(AMA, CAU, CAA, CAN, CEN, COA, PAI) / URY(RIV)
Euphorbia prostrata	ARG(BAI, CHA, COR, COS, ERI, FOR, SAL, SFE, TUC) / BRA(RGS, SCA) / PRY(GUA, SPE) / URY(ART)
Euphorbia raphilippii	CHL(COQ)
Euphorbia rhabdodes	BRA(RGS)
Euphorbia rochaensis	URY(ROC)
Euphorbia ruiz-lealii	ARG(CAT, LRI, MEN, SAL, SJU)
Euphorbia schickendantzii	ARG(CAT, CHU, LPA, LRI, MEN, NEU, RNE, SCR, SJU)
Euphorbia sciadophila	ARG(CAT, COR, COS, JUJ, LRI, MIS, SAL, SDE, SLU, TUC) / BRA(PAR, RGS, SCA) / PRY(APY, CHO, PAI, SPE) / URY(ART)
Euphorbia selloi	ARG(CHA, COS, ERI, MIS, SFE) / BRA(RGS) / PRY(GUA) / URY(COL, PAY, RIV)
Euphorbia serpens var. microphylla	ARG(BAI, CAT, CHA, COR, COS, ERI, FOR, JUJ, LRI, MEN, MIS, NEU, SAL, SDE, SFE, SLU, TUC) / BRA(RGS) / PRY(APY) / URY(COL, FLA, MON, PAY)
Euphorbia serpens var. serpens	ARG(BAI, CAT, CHA, COR, COS, ERI, FOR, JUJ, LPA, LRI, MEN, MIS, SAL, SDE, SFE, SJU, TUC) / BRA(PAR, RGS, SCA) / CHL(TAR, ANT, COQ, VAL, MAU, BIO, ARA, RME) / PRY(APY, PHA) / URY(FLA, TAC)
Euphorbia serpyllifolia	ARG(CAT, COR, LRI, MEN, SLU, TUC)
Euphorbia spathulata	ARG(BAI, CHU, COS, ERI, LPA, MIS, RNE) / BRA(RGS, SCA) / URY(MON)
Euphorbia stenophylla	ARG(CHA, COS, ERI, FOR, MIS, SFE) / BRA(RGS, SCA) / URY(CLA, LAV, MAL, RIV)
Euphorbia tarapacana	CHL(TAR, ANT)
Euphorbia terracina	CHL(VAL)
Euphorbia thinophila	CHL(ANT, ATA, COQ)
Euphorbia thymifolia	ARG(COS, MIS, SAL) / BRA(Fuera del área del proyecto) / PRY(CEN)
Euphorbia verna	CHL(BIO)
Euphorbia vervoorstii	ARG(CAT, SAL)
Euphrasia adenonota	CHL(ATA, COQ)
Euphrasia andicola	CHL(LBO, MAU, ARA)
Euphrasia antarctica	ARG(JUJ, NEU, SCR, SJU, TDF) / CHL(BIO, ARA, LLA, AIS, MAG)
Euphrasia chrysantha	ARG(NEU, RNE) / CHL(LBO, MAU, BIO, ARA, LLA)
Euphrasia cockayniana	CHL(AIS, MAG)
Euphrasia debilis	CHL(BIO, LLA)
Euphrasia flavicans	CHL(ARA, LLA, AIS)
Euphrasia formosissima	CHL(JFE)
Euphrasia intricata	CHL(BIO)
Euphrasia meiantha	ARG(CHU, MEN, NEU, RNE) / CHL(MAU, BIO, ARA, LLA)
Euphrasia muscosa	CHL(LLA, AIS)
Euphrasia perpusilla	CHL(LLA)
Euphrasia philippii	CHL(BIO, ARA)
Euphrasia subexserta	ARG(MEN, NEU, RNE) / CHL(LBO, MAU, BIO, ARA, LLA, RME)
Euphrasia trifida	ARG(NEU, RNE) / CHL(LBO, BIO, ARA, LLA)
Euphrasia villaricensis	CHL(LLA)
Euplassa cantareirae	BRA(PAR, SCA)
Euplassa nebularis	BRA(RGS, SCA)
Euploca aurata	ARG(CAT, LRI, SAL, SJU, TUC)
Euploca campestris	ARG(CAT, COR, COS, FOR, JUJ, LRI, MEN, SAL, SJU, SLU, SDE, TUC) / PRY(APY, AMA, BOQ)
Euploca cerroleonense	PRY(APY, CHO)
Euploca distantiflora	PRY(CAU)
Euploca dunaensis	PRY(APY, BOQ, NAS, PHA)
Euploca filiformis	ARG(COS, MIS) / BRA(Fuera del área del proyecto) / PRY(AMA, CAN, PAI) / URY(ART)
Euploca fruticosa	ARG(SAL)
Euploca hassleriana	ARG(FOR, SAL) / PRY(CAU, PHA)
Euploca krapovickasii	BRA(RGS)
Euploca margaritensis 	PRY(AMA)
Euploca mendocina	ARG(CAT, COR, LPA, LRI, MEN, MIS, SJU, SLU, SDE, TUC)
Euploca ocellata	ARG(COS, MIS) / BRA(RGS) / PRY(SPE) / URY(ART, RIV, SAO, TAC)
Euploca pallescens	ARG(FOR) / PRY(APY, PHA)
Euploca procumbens	ARG(CHA, COS, ERI, FOR, JUJ, MIS, SAL, TUC) / BRA(Fuera del área del proyecto) / PRY(APY, AMA, BOQ, CAN, CEN, CON, COA, GUA, ÑEE, PAI, PHA, SPE) / URY(SOR)
Euploca salicoides	ARG(COS, ERI, MIS, SAL, SDE) / BRA(PAR, RGS) / PRY(AMA, CAN, COA, PAI, SPE)
Eupodium kaulfussii	ARG(MIS) / BRA(PAR, RGS, SCA)
Euryops chrysanthemoides	ARG(BAI)
Eurystyles actinosophila	ARG(MIS) / BRA(PAR)
Eurystyles cogniauxii	BRA(PAR)
Eurystyles cotyledon	BRA(PAR, RGS, SCA)
Eurystyles lorenzii	BRA(PAR, SCA)
Eurystyles paranaensis	BRA(SCA)
Eustachys bahiensis var. robusta	BRA(PAR, RGS)
Eustachys brevipila	ARG(COS, ERI) / BRA(RGS) / URY(FLA, MAL, PAY, RNO, SAO, SOR, TAC)
Eustachys calvescens	ARG(MIS) / BRA(PAR) / PRY(AMA, CAU, CON, COA, PAI, SPE) / URY(CLA, RIV, TAC)
Eustachys distichophylla	ARG(BAI, CAT, CHA, COR, COS, DFE, ERI, FOR, JUJ, MIS, SAL, SDE, SFE, SLU, TUC) / BRA(PAR, RGS, SCA) / PRY(APY, APA, AMA, CAU, CAA, CAN, CEN, CON, COA, GUA, ITA, MIE, ÑEE, PAI,) / URY(PAY)
Eustachys paranensis	BRA(PAR)
Eustachys paspaloides ssp. caribaea	ARG(BAI, COR, COS, ERI, SFE) / BRA(PAR, RGS) / PRY(APY, CAU, PAI, SPE) / URY(CAS, COL, FLO, FLA, LAV, MAL, RIV, ROC, SAO, SJO, SOR, TAC)
Eustachys retusa	ARG(BAI, CAT, CHA, COR, COS, ERI, FOR, JUJ, LPA, LRI, MEN, MIS, RNE, SAL, SDE, SFE, SLU, TUC) / BRA(PAR, RGS, SCA) / PRY(CEN, COA, ITA) / URY(CLA, COL, MAL, MON, PAY, RIV, ROC, TAC)
Eustachys swalleniana	BRA(PAR, RGS) / URY(CLA)
Eustachys uliginosa	ARG(COS, ERI, MIS) / BRA(PAR, RGS, SCA) / PRY(COA, ITA, PAI) / URY(CLA, FLO, SAO, SJO, TYT)
Euterpe edulis	ARG(MIS) / BRA(PAR, RGS, SCA) / PRY(APA, CAN)
Evolvulus alsinoides	PRY(CEN, COA, PAI)
Evolvulus arizonicus	ARG(CAT, CHA, COR, COS, FOR, JUJ, LRI, SAL, SDE, SFE, SJU, SLU, TUC) / PRY(APY, PHA) / URY(SAO)
Evolvulus aurigenius	BRA(PAR)
Evolvulus barbatus	BRA(PAR, SCA) / PRY(AMA)
Evolvulus cardiophyllus	PRY(COA, PAI)
Evolvulus chamaepitys var. paraguayensis	PRY(AMA)
Evolvulus chrysotrichos	BRA(Fuera del área del proyecto) / PRY(AMA, PAI)
Evolvulus convolvuloides	ARG(CHA, COS, FOR, SAL, TUC) / PRY(APY, PHA)
Evolvulus corumbaensis	BRA(Fuera del área del proyecto) / PRY(AMA, CON)
Evolvulus elegans var. capillaceus	BRA(Fuera del área del proyecto) / PRY(AMA)
Evolvulus filipes	BRA(Fuera del área del proyecto) / PRY(AMA, CEN, COA)
Evolvulus glomeratus ssp. grandiflorus	ARG(COS, ERI) / PRY(CAU, GUA, ÑEE) / URY(PAY, SAO)
Evolvulus glomeratus f. echioides	BRA(PAR, SCA)
Evolvulus hasslerianus	PRY(APA, AMA)
Evolvulus latifolius	ARG(COS) / BRA(Fuera del área del proyecto) / PRY(CEN, COA, GUA, PAI)
Evolvulus linarioides	BRA(Fuera del área del proyecto) / PRY(PHA)
Evolvulus nummularius	ARG(COS, FOR, JUJ, SAL, SDE) / BRA(Fuera del área del proyecto) / PRY(APY, AMA, CON, COA, GUA, PAI, PHA)
Evolvulus pusillus	BRA(PAR, RGS, SCA)
Evolvulus sericeus var. elongatus	ARG(BAI, COR, COS, JUJ, MEN, RNE, SAL, SCR, SLU, TUC) / CHL(RME)
Evolvulus sericeus var. sericeus	ARG(BAI, CAT, COR, COS, ERI, JUJ, LRI, MIS, SAL, SDE, SLU) / BRA(RGS, SCA) / CHL(BIO) / PRY(APY, BOQ, CEN, CON, COA, GUA, ÑEE, PAI) / URY(COL, DUR, FLO, FLA, MAL, MON, PAY, SOR, TAC)
Evolvulus sericeus f. pedunculatus	ARG(ERI)
Evolvulus serpylloides	BRA(PAR)
Evolvulus tenuis var. cinereus	ARG(MIS, SAL) / PRY(CEN, COA, PAI)
Evolvulus tenuis var. tenuis	PRY(COA, GUA, PAI)
Exhalimolobos burkartii	ARG(JUJ, SAL, TUC)
Exhalimolobos pazense	ARG(CAT, JUJ, LRI, MEN, SAL, SJU, SLU, SCR, TUC)
Exhalimolobos weddellii	ARG(BAI, CAT, CHA, COR, COS, ERI, FOR, JUJ, LPA, LRI, MEN, SAL, SCR, SDE, SFE, SJU, SLU, TUC) / URY(ART, COL, RNO, SAO, TAC)
Exodeconus flavus	CHL(TAR)
Exodeconus integrifolius	ARG(CAT) / CHL(TAR, ANT, ATA)
Exodeconus pusillus	CHL(AYP, TAR)
Exostigma notobellidiastrum	ARG(CAT, CHA, COS, FOR, JUJ, MIS, SAL, SFE, TUC) / BRA(PAR, RGS, SCA) / PRY(APA, AMA, CAA, CAN, CEN, COA, GUA, ÑEE, PAI, SPE) / URY(CLA, RIV, TAC, TYT)
Exostigma rivulare	ARG(BAI, COS, MIS, SFE) / BRA(PAR, RGS, SCA) / PRY(APA, CAA, GUA) / URY(MON, RNO)
Exostyles godoyensis	BRA(PAR)
