Jaborosa ameghinoi	ARG(CHU)
Jaborosa bergii	ARG(BAI, CAT, COR, LPA, LRI, RNE, SJU, SLU)
Jaborosa cabrerae	ARG(CAT)
Jaborosa caulescens var. caulescens	ARG(LRI, MEN, SJU) / CHL(TAR, ATA, COQ, VAL, MAU, RME)
Jaborosa caulescens var. bipinnatifida	ARG(CAT, CHU, JUJ, LRI, MEN, SAL, SJU) / CHL(ANT, ATA, COQ, RME)
Jaborosa chubutensis	ARG(CHU)
Jaborosa integrifolia	ARG(BAI, CHA, COR, COS, DFE, ERI, FOR, JUJ, SAL, SFE) / PRY(APY, CEN, CON, PAI, PHA) / URY(RNO)
Jaborosa kurtzii	ARG(LPA, MEN, NEU, RNE)
Jaborosa laciniata	ARG(LRI, MEN, NEU, SJU) / CHL(ATA, COQ, VAL, MAU, RME)
Jaborosa lanigera	ARG(CAT, LRI, SAL)
Jaborosa leucotricha	ARG(CAT, CHU, LRI, MEN, RNE, SJU, TUC)
Jaborosa magellanica	ARG(SCR, TDF) / CHL(AIS, MAG)
Jaborosa odonelliana	ARG(SAL, SDE, TUC)
Jaborosa oxipetala	ARG(CAT, SAL, TUC)
Jaborosa parviflora	ARG(JUJ, SAL) / CHL(TAR, ANT, ATA)
Jaborosa pinnata	CHL(LBO, MAU, RME)
Jaborosa reflexa	ARG(CHU, MEN, NEU, RNE, SCR) / CHL(LBO, MAU, BIO, ARA, RME)
Jaborosa riojana	ARG(CAT, LRI) / CHL(ANT)
Jaborosa rotacea	ARG(CAT, LRI, SAL, TUC)
Jaborosa runcinata	ARG(BAI, COR, DFE, ERI, SFE) / URY(FLA, MAL, MON, SJO)
Jaborosa sativa	ARG(CAT, JUJ, LRI, SAL, TUC)
Jaborosa squarrosa	ARG(JUJ, LRI) / CHL(TAR, ATA)
Jaborosa volkmannii	ARG(NEU) / CHL(BIO, ARA)
Jacaranda brasiliana	BRA(RGS)
Jacaranda caroba	BRA(PAR) / PRY(AMA)
Jacaranda cuspidifolia	ARG(SAL, TUC) / BRA(PAR) / PRY(APY, APA, AMA, CEN, CON, COA, GUA, PAI, PHA)
Jacaranda decurrens	BRA(PAR) / PRY(AMA, CAN)
Jacaranda micrantha	ARG(COS, MIS) / BRA(PAR, RGS, SCA) / PRY(APA, CAN, GUA, ITA, PAI)
Jacaranda mimosifolia	ARG(ERI, JUJ, SAL, TUC) / PRY(APY, COA) / URY(MON)
Jacaranda mutabilis	BRA(Fuera del área del proyecto) / PRY(AMA)
Jacaranda puberula	ARG(COS, MIS) / BRA(PAR, RGS, SCA) / PRY(APA, AMA, GUA)
Jacaratia corumbensis	ARG(CHA, FOR, JUJ, SAL, TUC) / BRA(Fuera del área del proyecto) / PRY(APY, AMA, CEN, CON, COA, PAI, PHA)
Jacaratia spinosa	ARG(COS, MIS) / BRA(PAR, RGS, SCA) / PRY(APA, AMA, CAU, CAA, CAN, CEN, CON, COA, GUA, MIE, PAI, SPE)
Jacquemontia agrestis	ARG(CAT, CHA, COR, COS, ERI, SAL, SLU) / BRA(Fuera del área del proyecto) / PRY(AMA, CEN, PAI)
Jacquemontia anomala	PRY(APA)
Jacquemontia blanchetii	ARG(CAT, CHA, COS, FOR, JUJ, MIS, SAL, SDE, TUC) / BRA(PAR, SCA) / PRY(CEN, COA, GUA, PAI, PHA)
Jacquemontia catarctae	ARG(MIS) / PRY(APA)
Jacquemontia decumbens	ARG(COS, MIS) / PRY(APY, ITA)
Jacquemontia densiflora	ARG(CHA, COS, FOR, JUJ, SAL) / BRA(Fuera del área del proyecto) / PRY(AMA, CEN, PHA)
Jacquemontia estrellenesis	ARG(SAL) / BRA(Fuera del área del proyecto) / PRY(APY)
Jacquemontia evolvuloides	ARG(ERI) / BRA(Fuera del área del proyecto) / PRY(CON, PAI)
Jacquemontia ferruginea	BRA(PAR) / PRY(COA)
Jacquemontia fruticulosa	PRY(COA)
Jacquemontia guaranitica	PRY(AMA)
Jacquemontia heterotricha	ARG(COS, MIS) / BRA(RGS) / PRY(CON, COA)
Jacquemontia holosericea	PRY(AMA, GUA)
Jacquemontia laxiflora	ARG(COS, MIS)
Jacquemontia lorentzii	ARG(JUJ, SAL, TUC) / PRY(APY, COA, PAI)
Jacquemontia martii	PRY(CAA)
Jacquemontia paraguayensis	PRY(CEN, COA, GUA)
Jacquemontia pentanthos	ARG(FOR, JUJ, SAL) / PRY(COA, PAI, PHA)
Jacquemontia rojasiana	PRY(AMA)
Jacquemontia selloi	ARG(COS, MIS) / BRA(PAR) / PRY(APA)
Jacquemontia tamnifolia	ARG(CHA, COS, FOR) / BRA(PAR) / PRY(CEN, COA, PHA)
Jacquemontia turneroides	PRY(AMA)
Jacquiniella globosa	BRA(PAR)
Jaegeria hirta	ARG(BAI, CHA, COS, ERI, FOR, JUJ, MIS, SAL, SFE) / BRA(PAR, RGS, SCA) / PRY(APA, CAU, CAN, CEN, COA) / URY(CLA, COL, RNO, RIV, ROC, SAO, SOR, TAC, TYT)
Janusia guaranitica	ARG(CAT, CHA, COR, COS, ERI, FOR, JUJ, LRI, MIS, SAL, SDE, SFE, SLU, TUC) / BRA(PAR, RGS, SCA) / PRY(APY, AMA, BOQ, CAU, CAN, CEN, CON, COA, GUA, ÑEE, PAI, PHA, SPE) / URY(LAV, MAL)
Janusia mediterranea	BRA(PAR) / PRY(AMA, CAN)
Janusia occhionii	BRA(PAR) / PRY(AMA)
Jarava academica	ARG(COR)
Jarava annua	CHL(TAR, ANT)
Jarava breviseta	ARG(SAL)
Jarava castellanosii	ARG(CAT, JUJ, LRI, MEN, SJU, TUC)
Jarava durifolia	ARG(JUJ, SJU, TUC)
Jarava filifolia	ARG(BAI, MIS) / BRA(RGS) / URY(ART, CLA, COL, FLA, LAV, MAL, MON, SJO, SJO)
Jarava hypsophila	ARG(LPA, MEN, NEU, SLU)
Jarava hystricina	ARG(CAT, JUJ, LRI, SAL, SJU)
Jarava ichu var. ichu	ARG(BAI, CAT, CHA, CHU, COR, JUJ, LPA, LRI, MEN, RNE, SAL, SJU, SLU, SFE, SDE, TUC)
Jarava ichu var. pungens	ARG(CAT, JUJ, SAL) / CHL(TAR, ANT)
Jarava illimanica	ARG(SAL)
Jarava juncoides	ARG(BAI, COR, LPA, RNE, SLU) / URY(MAL, MON)
Jarava leptostachya	ARG(CAT, JUJ, LRI, MEN, SAL, SJU, TUC) / CHL(TAR, ANT)
Jarava media	ARG(CAT, JUJ, LRI, MEN, SAL, SJU, TUC)
Jarava neaei	ARG(CHU, MEN, NEU, RNE, SJU, SCR) / CHL(COQ, VAL, MAU, AIS, RME)
Jarava plumosa	ARG(BAI, CAT, COR, COS, ERI, JUJ, LPA, MEN, RNE, SLU, SFE) / BRA(RGS, SCA) / CHL(COQ, VAL, LBO, MAU, BIO, ARA, RME) / URY(ART, CAS, LAV, MAL, MON, RIV, SJO)
Jarava plumosula	ARG(CAT, JUJ, LRI, SAL, SJU) / CHL(ANT, ATA, COQ, VAL, RME)
Jarava pogonathera	ARG(SJU) / CHL(ANT, ATA, COQ, VAL, MAU, RME)
Jarava polyclada	ARG(CAT, LRI, SAL, SDE, SJU, TUC)
Jarava pseudoichu	ARG(CAT, COR, JUJ, LPA, LRI, SAL, SLU, TUC)
Jarava psylantha	ARG(BAI, CHU, NEU, RNE, SCR) / CHL(MAG)
Jarava pungionata	ARG(CAT, SAL) / CHL(TAR, ANT)
Jarava scabrifolia	ARG(CAT, JUJ, LRI, SAL, SJU, TUC) / CHL(TAR, ANT)
Jarava scirpea	ARG(MEN, NEU, SJU)
Jarava subaristata	ARG(JUJ, SAL, TUC) / CHL(TAR, ANT)
Jarava subplumosa	ARG(SCR)
Jarava tortuosa	CHL(ANT, ATA, COQ)
Jasminum mesnyi	ARG(COR)
Jatropha bornmuelleri	BRA(RGS)
Jatropha breviloba	ARG(COS, FOR) / PRY(APY, AMA, CEN)
Jatropha curcas	ARG(COS, JUJ, MIS, SAL) / PRY(COA)
Jatropha dissecta	PRY(AMA, CAN, COA, PAI)
Jatropha eglandulosa	PRY(AMA)
Jatropha elliptica	PRY(CAU, PAI, SPE)
Jatropha excisa	ARG(CAT, COR, COS, FOR, JUJ, LRI, SAL, SJU, SLU, SFE, SDE, TUC) / PRY(APY)
Jatropha excisa var. pubescens	ARG(COR, FOR) / PRY(APY)
Jatropha gossypiifolia var. gossypiifolia	BRA(PAR, SCA) / PRY(APY, CAU, CEN, MIE)
Jatropha gossypiifolia var. elegans	PRY(AMA)
Jatropha grossidentata	ARG(CHA, FOR, SAL) / PRY(APY, PHA)
Jatropha guaranitica	PRY(APY, APA, AMA, CAU, CAN)
Jatropha hieronymi	ARG(CAT, CHA, FOR, JUJ, LRI, SAL, SJU, SDE, TUC) / PRY(APY, BOQ, CON, PHA)
Jatropha hippocastanifolia	ARG(CAT, COR, LRI, SAL, SJU) / PRY(APY, BOQ, NAS, PHA)
Jatropha intermedia	BRA(SCA) / PRY(CAU, CAA, CAN, COA, ITA, SPE)
Jatropha isabelliae	ARG(COS, MIS) / BRA(RGS) / PRY(CAU, CAN, CEN, COA, MIE, PAI, SPE)
Jatropha macrocarpa	ARG(CAT, FOR, JUJ, LRI, SAL, SLU, SDE, TUC) / PRY(APY)
Jatropha multifida	PRY(PAI)
Jatropha paraguayensis	PRY(APY, PHA)
Jatropha pedersenii	ARG(COS) / PRY(ITA, MIE)
Jatropha peiranoi	ARG(CAT, CHA, COR, FOR, LRI, SAL, SDE, TUC) / PRY(APY, BOQ)
Jatropha puncticulata	PRY(CEN)
Jatropha ribifolia var. ambigua	PRY(APY, PHA)
Jatropha tacumbensis	PRY(CEN)
Jatropha weddelliana	BRA(Fuera del área del proyecto) / PRY(APY, CAU, CON)
Jaumea linearifolia	ARG(BAI) / URY(CAS, MAL, MON, ROC)
Jobinia connivens	BRA(PAR, RGS, SCA) / URY(TYT)
Jobinia fontellana	BRA(PAR)
Jobinia glossostelma	ARG(CAT, TUC)
Jobinia hatschbachii	BRA(PAR)
Jobinia latipes	ARG(MIS) / BRA(RGS, SCA)
Jobinia lindbergii	ARG(MIS) / BRA(PAR, SCA)
Jobinia paranaensis	BRA(PAR, SCA)
Jobinia samuelssonii	ARG(JUJ, TUC)
Jobinia trifurcata	ARG(CAT, COR, JUJ, LRI, SJU, SLU, TUC)
Jodina rhombifolia	ARG(BAI, CAT, CHA, COR, COS, ERI, JUJ, LPA, MEN, RNE, SAL, SDE, SFE, SJU, SLU, TUC) / BRA(RGS, SCA) / PRY(Desconocida) / URY(CAS, DUR, FLA, LAV, MAL, MON, ROC, SAO, TYT)
Johnstonella parviflora	CHL(TAR, ANT, ATA)
Jovellana guentheri	CHL(LLA)
Jovellana punctata	CHL(BIO, ARA)
Jovellana violacea	CHL(BIO, ARA)
Juania australis	CHL(JFE)
Jubaea chilensis	CHL(COQ, VAL, LBO, MAU, RME)
Juglans australis	ARG(JUJ, SAL) / BRA(Fuera del área del proyecto)
Juncus acuminatus var. multiceps	CHL(MAU, BIO, ARA, LLA)
Juncus acutus ssp. leopoldii	ARG(BAI, COR, LPA, LRI, MEN, RNE, SAL, SJU, SLU, SFE, SDE, TUC) / BRA(SCA) / CHL(ANT, ATA, COQ, VAL, LLA, RME) / URY(MON)
Juncus acutus var. decompositus	CHL(ANT, COQ)
Juncus andersonii	URY(MON)
Juncus balticus ssp. mexicanus	ARG(BAI, CAT, CHU, COR, COS, JUJ, LRI, MEN, NEU, RNE, SAL, SJU, SCR, SFE, TDF, TUC) / CHL(ANT, ATA, COQ, VAL, LBO, MAU, ARA, LLA, AIS, MAG, RME)
Juncus balticus ssp. andicola	ARG(BAI, CAT, CHU, JUJ, LRI, MEN, NEU, RNE, SAL, SJU, SLU, SFE, TUC) / CHL(ANT, ATA, COQ, BIO, LLA, RME)
Juncus brasiliensis	BRA(PAR, RGS)
Juncus bufonius var. bufonius	ARG(BAI, CHA, CHU, COR, COS, DFE, ERI, FOR, NEU, RNE, SAL, SLU, SCR, SFE, SDE, TDF, TUC) / BRA(RGS) / CHL(ANT, ATA, COQ, VAL, LBO, MAU, BIO, ARA, LLA, AIS, MAG, RME, JFE) / URY(CAS, MON)
Juncus bufonius var. condensatus	ARG(BAI, CHU, MEN, SCR, TUC) / URY(MON)
Juncus bulbosus	CHL(LLA)
Juncus burkartii	ARG(MEN, NEU, RNE)
Juncus capillaceus	ARG(BAI, CHA, COR, COS, ERI, LRI, SDE, SFE, TUC) / BRA(RGS) / CHL(VAL, LBO, BIO, ARA, LLA, JFE) / URY(COL, FLA, MON)
Juncus capitatus	BRA(RGS) / CHL(MAU, BIO, ARA) / URY(MAL, ROC, TYT)
Juncus cordobensis	ARG(BAI, CAT, CHA, COR, COS, ERI, FOR, SFE, TUC) / BRA(RGS)
Juncus cyperoides	ARG(CHU, NEU, RNE, TUC) / CHL(COQ, VAL, LBO, MAU, BIO, ARA, LLA, AIS, MAG, RME)
Juncus densiflorus	ARG(BAI, CHA, COR, COS, ERI, FOR, MIS, SFE, TUC) / BRA(PAR, RGS, SCA) / PRY(APY, AMA, CAU, CAA, CEN, COA, GUA, ITA, MIE, PAI, PHA, SPE) / URY(FLA)
Juncus dichotomus	ARG(BAI, CAT, CHA, COR, COS, ERI, JUJ, LPA, NEU, SAL, SLU, SFE, SDE, TUC) / BRA(PAR, RGS, SCA) / CHL(MAU, BIO, ARA) / PRY(GUA) / URY(MON)
Juncus diemii	ARG(NEU, RNE) / CHL(BIO, LLA)
Juncus effusus var. effusus	ARG(CAT, CHU, MEN, NEU, RNE, SAL, TDF, TUC) / BRA(PAR, RGS, SCA) / CHL(MAU, BIO, ARA, LLA, AIS) / URY(CLA)
Juncus effusus var. subglomeratus	CHL(LLA, AIS)
Juncus ernesti-barrosii	ARG(CHU, NEU, RNE) / CHL(BIO)
Juncus filiformis	CHL(VAL, MAU, RME)
Juncus imbricatus	ARG(BAI, CAT, CHA, COR, COS, DFE, ERI, JUJ, LPA, MEN, MIS, RNE, SAL, SJU, SLU, SFE, TUC) / BRA(RGS) / CHL(COQ, VAL, LBO, MAU, BIO, ARA, LLA, RME, JFE) / URY(COL, FLA, MON, SOR)
Juncus involucratus	ARG(CHU, MEN, NEU, RNE, SJU)
Juncus kleinii	BRA(SCA)
Juncus kraussii ssp. austerus	ARG(Desconocida) / BRA(SCA) / CHL(LLA) / URY(MON)
Juncus llanquihuensis	ARG(CHU, MEN) / CHL(LLA)
Juncus marginatus	ARG(BAI, CAT, COR, COS, ERI, FOR, JUJ, MIS, SAL, SLU) / BRA(PAR, RGS, SCA) / PRY(CAU, PAI, SPE) / URY(MAL, MON, SJO)
Juncus micranthus	ARG(BAI, COR, COS, ERI, MIS) / BRA(PAR, RGS, SCA) / PRY(AMA, CAU, MIE, PAI) / URY(FLA, ROC)
Juncus microcephalus	ARG(BAI, CAT, CHA, COR, COS, DFE, ERI, FOR, JUJ, LPA, MEN, MIS, NEU, RNE, SAL, SJU, SFE, TUC) / BRA(PAR, RGS, SCA) / CHL(LBO, MAU, BIO, ARA, LLA, AIS, MAG, RME) / PRY(CAU, CEN, GUA, ITA, ÑEE, PAI, SPE) / URY(FLA, MAL, MON, RNO, SJO, SOR, TYT)
Juncus pallescens var. achalensis	ARG(CAT, COR, LRI, MEN, SAL, SJU, SLU, TUC)
Juncus pallescens var. pallescens	ARG(BAI, CAT, CHA, CHU, COR, COS, DFE, ERI, FOR, JUJ, LPA, LRI, MEN, NEU, RNE, SAL, SJU, SLU, SFE, SDE, TUC) / BRA(RGS, SCA) / CHL(ATA, COQ, VAL, MAU, BIO, ARA, LLA, AIS, RME, JFE) / PRY(CEN) / URY(FLO, FLA, PAY, ROC)
Juncus planifolius	CHL(MAU, BIO, ARA, LLA, AIS, JFE)
Juncus procerus	ARG(CHU, NEU, RNE) / CHL(MAU, BIO, ARA, LLA, AIS, MAG, JFE)
Juncus ramboi	BRA(RGS, SCA)
Juncus scheuchzerioides	ARG(CHU, MEN, NEU, SJU, SCR, TDF) / CHL(ATA, COQ, VAL, LBO, LLA, AIS, MAG, RME)
Juncus stipulatus var. stipulatus	ARG(CAT, CHU, COR, JUJ, LRI, MEN, NEU, RNE, SAL, SJU, SLU, SCR, TDF, TUC) / CHL(TAR, ANT, ATA, COQ, VAL, LBO, MAU, BIO, ARA, LLA, AIS, MAG, RME)
Juncus stipulatus var. chilensis	
Juncus tenuis var. congestus	ARG(COR, SFE, SLU) / CHL(MAU, RME)
Juncus tenuis var. tenuis	ARG(BAI, CAT, CHA, COR, COS, ERI, FOR, JUJ, LPA, LRI, MEN, MIS, NEU, SAL, SJU, SLU, SFE, SDE, TUC) / BRA(RGS, SCA) / CHL(MAU) / PRY(CEN, ITA, ÑEE) / URY(Desconocida)
Juncus uruguensis	ARG(BAI, ERI, SAL, SFE) / URY(FLA, MON)
Juncus venturianus	ARG(BAI, CHA, COR, COS, ERI, FOR, SAL, SLU, SFE, TUC) / PRY(CEN) / URY(MON)
Junellia aretioides	ARG(JUJ, SAL) / CHL(TAR)
Junellia azorelloides	ARG(CHU, MEN, SCR)
Junellia ballsii	ARG(JUJ, SAL)
Junellia bisulcata var. bisulcata	ARG(CAT, JUJ, LRI, SAL, TUC)
Junellia bisulcata var. campestris	ARG(COR, SDE)
Junellia bryoides	CHL(TAR)
Junellia caespitosa	ARG(MEN, NEU, RNE, SJU) / CHL(ATA, COQ)
Junellia congesta	ARG(NEU)
Junellia connatibracteata	ARG(BAI, CHU, LPA, MEN, NEU, RNE)
Junellia crithmifolia	ARG(CHU, LPA, LRI, MEN, NEU, RNE, SJU, SLU) / CHL(COQ)
Junellia digitata var. integerrima	ARG(JUJ) / CHL(TAR, ANT)
Junellia digitata var. digitata	ARG(CAT, JUJ, LRI, SAL, SJU, TUC) / CHL(TAR, ANT)
Junellia erinacea	ARG(LRI, MEN, RNE, SJU)
Junellia hookeriana var. hookeriana	ARG(BAI, CAT, COR, LPA, LRI, MEN, NEU, RNE, SAL, SDE, SJU, SLU)
Junellia hookeriana var. catamarcensis	ARG(CAT)
Junellia juniperina	ARG(CAT, LRI, MEN, SAL, SJU, TUC) / CHL(TAR, ANT, RME)
Junellia lavandulaefolia	CHL(COQ, VAL, LBO, MAU, RME)
Junellia micrantha	ARG(CHU, MEN, NEU, RNE, SCR) / CHL(LBO, RME)
Junellia minima	ARG(JUJ, LRI, MEN, SJU, TUC)
Junellia odonellii	ARG(CHU, NEU, SCR) / CHL(MAG)
Junellia origenes	ARG(COR, LRI, MEN, SAL, SJU) / CHL(ANT, ATA, COQ)
Junellia pappigera	ARG(JUJ, SAL) / CHL(ANT)
Junellia patagonica	ARG(CHU, NEU, RNE, SCR)
Junellia pseudojuncea	CHL(ATA, COQ)
Junellia selaginoides var. selaginoides	CHL(ANT, COQ)
Junellia selaginoides var. illapelina	CHL(ATA, COQ)
Junellia seriphioides	ARG(CAT, CHU, JUJ, LPA, LRI, MEN, NEU, RNE, SAL, SJU, SLU) / CHL(TAR, ANT)
Junellia silvestrii	ARG(CHU, SCR) / CHL(MAG)
Junellia spathulata var. glauca	ARG(MEN, NEU) / CHL(COQ, VAL, MAU, RME)
Junellia spathulata var. spathulata	ARG(MEN, NEU) / CHL(LBO, MAU, RME)
Junellia spissa	ARG(CHU, NEU, SCR)
Junellia succulentifolia	ARG(CHU, LPA, NEU, RNE)
Junellia thymifolia	ARG(CHU, MEN, NEU, SCR) / CHL(MAG)
Junellia tonini var. tonini	ARG(CHU, MEN, NEU, RNE, SCR)
Junellia tonini var. mulinoides	ARG(CHU, NEU, RNE, SCR)
Junellia tridactylites	ARG(CHU, MEN, NEU, RNE, SCR) / CHL(MAG)
Junellia trifurcata	CHL(RME)
Junellia ulicina	ARG(CHU, MEN, NEU, RNE, SCR) / CHL(LBO)
Junellia uniflora	ARG(CHU, MEN, NEU, SJU) / CHL(ATA, COQ, VAL, MAU, RME)
Jungia floribunda	ARG(COS, MIS) / BRA(RGS) / PRY(APA, AMA, CAU, CAN, CEN, COA, GUA, ITA, MIE, PAI, SPE) / URY(RIV, ROC, TAC)
Jungia pauciflora	ARG(CAT, JUJ, SAL, TUC)
Jungia polita	ARG(CAT, COR, JUJ, LRI, SAL, SJU, SLU, TUC) / CHL(TAR)
Jungia sellowii	ARG(MIS) / BRA(RGS, SCA)
Jungia sordida	ARG(CAT, JUJ, LRI, SAL, TUC)
Juniperus communis	ARG(CHU, NEU, RNE, SCR)
Justicia aequilabris	PRY(AMA, CON)
Justicia araucariensis	BRA(PAR)
Justicia axillaris	ARG(COR, COS, ERI, MIS, SFE) / BRA(RGS) / PRY(APA, CAU, CAN, COA, PAI) / URY(CLA)
Justicia baenitzii	ARG(JUJ, SAL)
Justicia bradegeeana	BRA(RGS)
Justicia brasiliana	ARG(CHA, COS, FOR, MIS, SFE) / BRA(PAR, RGS, SCA) / PRY(APA, AMA, CAU, CAA, CAN, CEN, CON, COA, GUA, ITA, MIE, ÑEE, PAI, PHA, SPE) / URY(ART, RIV, SAO)
Justicia carnea	ARG(MIS) / BRA(PAR, RGS, SCA) / PRY(APA)
Justicia catharinensis	BRA(SCA)
Justicia chacoënsis	BRA(Fuera del área del proyecto) / PRY(APY)
Justicia comata	ARG(CHA, COS, FOR, JUJ, MIS, SAL, SFE) / BRA(PAR, RGS) / PRY(APA, APY, AMA, BOQ, CAU, CAA, CEN, CON, COA, GUA, ITA, MIE, ÑEE, PAI, PHA, SPE) / URY(ART, RNO)
Justicia corumbensis	ARG(CHA, FOR) / BRA(Fuera del área del proyecto) / PRY(APY, PHA)
Justicia cuspidulata	PRY(AMA, COA)
Justicia dumetorum	ARG(CHA, COR, COS, FOR, SAL) / PRY(APY, AMA, CAN, CEN, CON, COA, PHA)
Justicia dusenii	BRA(PAR, SCA)
Justicia floribunda	ARG(MIS) / BRA(PAR, RGS, SCA)
Justicia gilliesii	ARG(CAT, COR, LRI, MEN, SDE, SJU, SLU, TUC) / BRA(PAR, RGS)
Justicia glaziovii	BRA(Fuera del área del proyecto) / PRY(AMA, CON)
Justicia glutinosa	ARG(SAL) / BRA(Fuera del área del proyecto) / PRY(AMA)
Justicia goudotii	ARG(CAT, CHA, COS, FOR, JUJ, SAL, SDE, SFE, TUC) / PRY(CAN, CEN, CON, GUA, PHA)
Justicia hassleri	BRA(Fuera del área del proyecto) / PRY(COA, PAI)
Justicia hatschbachii var. hatschachii	BRA(PAR)
Justicia hatschbachii var. catharinensis	BRA(SCA)
Justicia hunzikeri	ARG(LRI, SJU, SLU)
Justicia jujuyensis	ARG(JUJ, SAL, SDE, TUC)
Justicia kleinii	BRA(PAR, SCA)
Justicia kuntzei	ARG(JUJ, SAL)
Justicia laevilinguis	ARG(BAI, CHA, COS, ERI, FOR, MIS, SFE) / BRA(PAR, RGS, SCA) / PRY(APY, AMA, CAU, CAA, CAN, CEN, CON, COA, GUA, ITA, ÑEE, PAI, PHA, SPE) / URY(ART, CLA, DUR, MON, RNO, ROC, SJO, SOR, TYT)
Justicia lilloana	ARG(CAT, LRI, MEN, SAL, SJU, TUC)
Justicia lilloi	ARG(CAT, JUJ, SAL, SDE, TUC) / PRY(APY)
Justicia lythroides	ARG(MIS) / BRA(PAR, RGS, SCA) / PRY(APA, CAA, CAN, CON)
Justicia mandonii	ARG(JUJ, SAL, TUC)
Justicia oblonga	ARG(COS, MIS) / BRA(RGS, SCA) / PRY(APA, GUA) / URY(SJO)
Justicia oranensis	ARG(JUJ, SAL, TUC)
Justicia parabolica	BRA(Fuera del área del proyecto)
Justicia paranaensis	BRA(PAR, SCA)
Justicia pectoralis	ARG(FOR) / PRY(APY)
Justicia phyllocalyx	BRA(Fuera del área del proyecto) / PRY(AMA)
Justicia polygaloides	ARG(ERI) / BRA(Fuera del área del proyecto) / PRY(APY, CON, GUA, PAI, PHA, SPE)
Justicia ramulosa	ARG(COS, FOR, JUJ, MIS, SAL) / BRA(PAR) / PRY(APA, AMA, CAA, CAN, CEN, COA, GUA, PAI, SPE)
Justicia reitzii	BRA(SCA)
Justicia riojana	ARG(LRI)
Justicia rusby	BRA(Fuera del área del proyecto) / PRY(APA, AMA, CAU, CAA, CAN, CEN, CON, COA, GUA, PAI, PHA, SPE)
Justicia saltensis	ARG(JUJ, SAL, SDE, TUC) / PRY(APY)
Justicia schenckiana	BRA(SCA)
Justicia squarrosa	ARG(CAT, CHA, COR, JUJ, LRI, SAL, SDE, SLU, TUC) / PRY(APY, PHA)
Justicia tocantina	PRY(APY)
Justicia tweediana	ARG(BAI, CAT, CHA, COR, ERI, JUJ, LRI, SAL, SDE, SFE, SJU, SLU, TUC) / URY(MON, RNO)
Justicia xylosteoides	ARG(CAT, COR, LRI, SAL, SDE, TUC) / PRY(APY)
Justicia yhuensis	ARG(FOR, MIS) / BRA(RGS, SCA) / PRY(AMA, CAU, CON, COA)
