Ocellochloa stolonifera	ARG(CHA, COS, ERI, FOR, MIS, SFE) / BRA(PAR, RGS, SCA) / PRY(APA, CAA, CON, COA, GUA, MIE, ÑEE, PAI, SPE)
Ochagavia andina	CHL(LBO, MAU, BIO)
Ochagavia carnea	CHL(VAL, MAU, BIO, ARA)
Ochagavia elegans	CHL(JFE)
Ochagavia litoralis	CHL(COQ, VAL, LBO)
Ochetophila nana	ARG(CHU, MEN, NEU, RNE, SCR, SJU) / CHL(COQ, VAL, LBO, MAU, BIO, ARA, RME)
Ochetophila trinervis	ARG(CHU, MEN, NEU, RNE, SCR, SJU) / CHL(ATA, COQ, VAL, LBO, MAU, BIO, ARA, AIS, RME)
Ocimum campechianum	ARG(CHA, FOR, JUJ, SAL) / PRY(APY, CAU, CHO, CON, COA, PHA)
Ocimum hassleri	
Ocimum hassleri var. acutatum	
Ocimum nudicaule	ARG(COS, MIS) / BRA(PAR, RGS, SCA) / PRY(APA, CAU, COA, GUA)
Ocimum ovatum	ARG(CHA, COS, FOR, MIS) / BRA(Fuera del área del proyecto) / PRY(APA, AMA, CAU, CAA, CAN, CEN, ÑEE, PHA, SPE)
Ocimum procurrens	BRA(RGS)
Ocimum selloi	ARG(COS, ERI, JUJ, MIS, SAL, SFE) / BRA(PAR, RGS, SCA) / PRY(APA, APY, AMA, CAU, CAA, CEN, CHO, CON, COA, GUA, MIE, PAI, PHA, SPE) / URY(CAS, CLA, MON, PAY, RIV, SAO, SJO)
Ocotea aciphylla	BRA(PAR, SCA)
Ocotea acutifolia	ARG(BAI, COS, ERI, MIS) / BRA(PAR, RGS, SCA) / PRY(AMA, CEN, ITA, ÑEE, PAI) / URY(MON, PAY, RNO, RIV, ROC, SAO, SOR, TAC)
Ocotea bicolor	BRA(PAR)
Ocotea brachybotra	BRA(PAR)
Ocotea catharinensis	BRA(PAR, RGS, SCA) / PRY(SPE)
Ocotea corymbosa	BRA(PAR, SCA) / PRY(AMA, CAA, COA, PAI)
Ocotea daphnifolia	BRA(PAR)
Ocotea densiflora	BRA(Fuera del área del proyecto) / PRY(APY, AMA, CAU, CAN, PAI, SPE)
Ocotea diospyrifolia	ARG(CHA, COS, FOR, MIS) / BRA(PAR, RGS, SCA) / PRY(APY, AMA, CAA, CAN, CEN, COA, ÑEE, PAI, PHA, SPE)
Ocotea dispersa	BRA(PAR, SCA)
Ocotea elegans	BRA(PAR, SCA) / PRY(SPE)
Ocotea glaziovii	BRA(PAR, SCA)
Ocotea indecora	BRA(PAR, RGS)
Ocotea lanata	BRA(PAR, RGS, SCA)
Ocotea lancifolia	ARG(COS, MIS) / BRA(PAR, RGS, SCA) / PRY(APY, APA, AMA, CAU, CAA, CAN)
Ocotea laxa	BRA(PAR, SCA)
Ocotea lobbii	BRA(PAR, SCA)
Ocotea marumbiensis	BRA(PAR, SCA)
Ocotea minarum	BRA(Fuera del área del proyecto) / PRY(APA, COA)
Ocotea nectandrifolia	BRA(PAR, RGS, SCA)
Ocotea notata	BRA(PAR)
Ocotea nunesiana	BRA(PAR, SCA)
Ocotea nutans	BRA(PAR)
Ocotea odorifera	BRA(PAR, RGS, SCA)
Ocotea paranaensis	BRA(PAR)
Ocotea porosa	BRA(PAR, RGS, SCA) / PRY(AMA)
Ocotea porphyria	ARG(CAT, JUJ, SAL, TUC)
Ocotea prolifera	BRA(PAR)
Ocotea puberula	ARG(COS, JUJ, MIS, SAL) / BRA(PAR, RGS, SCA) / PRY(APY, APA, AMA, CAU, CAA, CAN, CEN, COA, GUA, MIE, PAI, SPE) / URY(CLA, RIV, SOR, TAC, TYT)
Ocotea pulchella	ARG(MIS) / BRA(PAR, RGS, SCA) / PRY(APY, AMA, CAA, COA, PAI, SPE) / URY(CLA)
Ocotea silvestris	BRA(PAR, RGS, SCA)
Ocotea spectabilis	BRA(PAR, SCA) / PRY(APA, CEN, COA, ÑEE)
Ocotea tristis	BRA(PAR, RGS, SCA)
Ocotea urbaniana	BRA(SCA)
Ocotea vaccinioides	BRA(PAR)
Ocotea velloziana	BRA(PAR)
Ocotea velutina	BRA(PAR)
Octomeria albopurpurea	BRA(PAR)
Octomeria alexandri	BRA(RGS)
Octomeria alpina	BRA(PAR, SCA)
Octomeria bradei	BRA(PAR)
Octomeria caetensis	BRA(PAR)
Octomeria chamaeleptotes	ARG(MIS) / BRA(PAR, RGS, SCA)
Octomeria chloidophylla	BRA(SCA)
Octomeria concolor	BRA(PAR, RGS, SCA)
Octomeria crassifolia	BRA(PAR, RGS, SCA) / PRY(CAU)
Octomeria crassilabia	BRA(PAR)
Octomeria cucullata	BRA(PAR)
Octomeria decumbens	BRA(PAR)
Octomeria densiflora	BRA(PAR, SCA)
Octomeria diaphana	BRA(PAR, SCA)
Octomeria ementosa	BRA(PAR)
Octomeria fialhoensis	BRA(RGS, SCA)
Octomeria fibrifera	BRA(PAR, RGS)
Octomeria flabellifera	BRA(SCA)
Octomeria gehrtii	BRA(PAR, SCA)
Octomeria glazioviana	BRA(RGS)
Octomeria gracilicaulis	BRA(PAR, RGS, SCA)
Octomeria gracilis var. gracilis	BRA(PAR, RGS, SCA)
Octomeria gracilis var. pauloensis	BRA(PAR)
Octomeria grandiflora	BRA(PAR, RGS, SCA)
Octomeria hatschbachii	BRA(PAR, SCA)
Octomeria iguapensis	BRA(PAR, RGS, SCA)
Octomeria irroarata	BRA(SCA)
Octomeria juncifolia var. juncifolia	BRA(RGS, SCA)
Octomeria juncifolia var. revoluta	BRA(PAR)
Octomeria lichenicola	BRA(PAR, RGS)
Octomeria liliputana	BRA(PAR)
Octomeria linearifolia	BRA(PAR)
Octomeria lithophila	BRA(RGS)
Octomeria micrantha	ARG(MIS) / BRA(RGS, SCA)
Octomeria ochroleuca	BRA(RGS, SCA)
Octomeria octomeriantha	BRA(PAR)
Octomeria oxychela var. oxychela	BRA(PAR, RGS, SCA)
Octomeria oxychela var. gracilis	BRA(PAR, RGS, SCA)
Octomeria palmyrabellae	BRA(PAR, SCA)
Octomeria pinicola	ARG(MIS) / BRA(RGS)
Octomeria praestans	BRA(RGS, SCA)
Octomeria pusilla	BRA(PAR, RGS, SCA)
Octomeria reitzii	BRA(PAR, SCA)
Octomeria rigida	BRA(PAR)
Octomeria riograndensis	BRA(PAR, RGS, SCA)
Octomeria robusta	BRA(RGS, SCA)
Octomeria rodriguezii	BRA(PAR, SCA)
Octomeria rohrii	BRA(SCA)
Octomeria rotundiglossa	BRA(PAR, SCA)
Octomeria sancti-angeli	BRA(RGS)
Octomeria serrana	BRA(PAR, SCA)
Octomeria stellaris	BRA(PAR)
Octomeria tricolor	BRA(RGS)
Octomeria umbonulata	BRA(PAR, RGS, SCA)
Octomeria unguiculata	BRA(RGS)
Ocyroe armata	ARG(CAT, JUJ, LRI, SAL, SJU, TUC) / CHL(ANT)
Odontocarya acuparata	ARG(COS, MIS) / BRA(PAR, RGS, SCA) / PRY(GUA)
Odontocarya asarifolia	ARG(CHA, FOR, MIS, SAL, TUC) / PRY(APY, PAI, PHA)
Odontocarya tamoides var. canescens	BRA(Fuera del área del proyecto) / PRY(AMA)
Odontonema cuspidatum	PRY(APA, CAN, PAI)
Odontorrhynchus castillonii	ARG(CAT, COR, JUJ, TUC)
Odontorrhynchus chilensis	CHL(LLA)
Odontorrhynchus domeykoanus	CHL(VAL)
Odontorrhynchus erosus	CHL(BIO)
Odontorrhynchus variabilis	CHL(LLA)
Oeceoclades maculata	ARG(CHA, COS, FOR, JUJ, MIS, SAL, SFE) / BRA(PAR, RGS, SCA) / PRY(APA, CAU, CAN, COA, GUA, ÑEE, PAI, PHA, SPE)
Oedochloa minarum	ARG(JUJ, MIS, SAL, TUC) / BRA(PAR)
Oedochloa procurrens	ARG(COS, MIS) / BRA(PAR, RGS, SCA) / PRY(AMA, CAU, CAA, CON, COA, GUA, PAI)
Oenanthe crocata	ARG(BAI)
Oenanthe globulosa	ARG(BAI) / URY(MON)
Oenothera acaulis	CHL(COQ, VAL, LBO, MAU, BIO, ARA, LLA, RME)
Oenothera affinis	ARG(BAI, CAT, CHA, COR, COS, DFE, ERI, FOR, JUJ, LPA, LRI, MEN, MIS, SAL, SDE, SFE, SJU, SLU, TUC) / BRA(RGS, SCA) / CHL(ATA, COQ, VAL, RME, JFE) / PRY(APA) / URY(MON, ROC)
Oenothera arequipensis	CHL(ANT)
Oenothera bahia-blancae	ARG(BAI, CHU, LPA, NEU)
Oenothera biennis	ARG(DFE, MEN) / BRA(PAR) / CHL(VAL)
Oenothera catharinensis	BRA(SCA)
Oenothera centaurifolia	ARG(BAI, CHA, COS, ERI, SDE, SFE) / BRA(PAR) / URY(CAS)
Oenothera coquimbensis	CHL(ANT, ATA, COQ, VAL)
Oenothera curtiflora	ARG(COR, SLU)
Oenothera elongata	ARG(CAT)
Oenothera glazioviana	ARG(BAI, COR, DFE, ERI, SFE) / BRA(PAR) / CHL(LBO, LLA) / URY(MON)
Oenothera grisea	CHL(VAL)
Oenothera indecora	ARG(BAI, CAT, CHA, COR, COS, ERI, FOR, JUJ, LRI, MIS, SAL, SDE, SFE, SJU, TUC) / BRA(PAR, RGS, SCA) / PRY(CAN, CEN, GUA, ITA) / URY(ART, CAS, CLA, COL, LAV, MAL, MON, RIV, SAO, SJO, TYT)
Oenothera laciniata	ARG(COR, SLU)
Oenothera lasiocarpa	ARG(CAT, JUJ, LRI, SAL, SJU, TUC)
Oenothera longiflora ssp. longiflora	ARG(BAI, COR, DFE, ERI, SFE) / BRA(RGS) / URY(COL, MON, RNO, ROC, SJO)
Oenothera longiflora ssp. grandiflora	ARG(COS, ERI)
Oenothera longituba	ARG(CAT, JUJ, LRI, SAL, SJU, TUC)
Oenothera magellanica	ARG(BAI, CHU, COR, MEN, NEU, RNE, SCR, SJU, SLU) / CHL(VAL, AIS, MAG, RME)
Oenothera mendocinensis	ARG(BAI, CAT, CHU, COR, LPA, MEN, NEU, RNE, SJU, SLU, SCR)
Oenothera mollissima	ARG(BAI, COR, COS, ERI, MIS, SFE) / BRA(RGS, SCA) / URY(CAS, COL, FLA, MAL, MON, ROC, SJO)
Oenothera montevidensis	URY(CAS, MON)
Oenothera nana	ARG(CAT, JUJ, LRI, SAL, SJU, TUC) / CHL(TAR)
Oenothera odorata	ARG(BAI, CHU, COR, LPA, MEN, NEU, RNE, SCR, SJU) / CHL(AIS, MAG)
Oenothera parodiana	ARG(BAI, CHA, COR, COS, ERI, FOR, LPA, MIS, SDE, SFE, SLU, TUC) / BRA(RGS, SCA) / URY(ART, CAS, CLA, COL, DUR, FLO, FLA, MAL, MON, PAY, RIV, SAO, SOR, TAC)
Oenothera pedunculifolia	ARG(CAT, TUC)
Oenothera peruana	CHL(TAR)
Oenothera picensis ssp. cordobensis	ARG(CAT, COR, JUJ, SAL, SDE, SLU, TUC)
Oenothera picensis ssp. bonariensis	ARG(BAI, NEU, RNE, SLU)
Oenothera picensis ssp. picensis	ARG(MEN, SJU) / CHL(ANT, ATA, COQ, VAL, LBO, BIO, RME, JFE)
Oenothera punae	ARG(CAT, JUJ, LRI, SAL, SJU, TUC)
Oenothera ravenii ssp. ravenii	ARG(COS, ERI, MIS, SFE) / BRA(PAR, RGS, SCA) / PRY(CEN, COA, PAI) / URY(CLA, LAV, MON, ROC, SAO)
Oenothera ravenii ssp. chilensis	CHL(VAL, BIO, ARA, LLA)
Oenothera rivadaviae	ARG(BAI, CHU, NEU, SCR)
Oenothera rosea	ARG(BAI, COR, ERI, JUJ, MEN, SAL, SFE, TUC) / CHL(COQ, VAL, LBO, MAU, BIO, ARA, RME, JFE, IPA) / URY(MON)
Oenothera sandiana	CHL(TAR)
Oenothera santarii	ARG(COR, MEN, SJU, SLU)
Oenothera scabra	ARG(CAT, JUJ, LRI, SAL, TUC)
Oenothera siambonensis	ARG(CAT, COR, JUJ, LRI, SAL, TUC)
Oenothera stricta ssp. stricta	ARG(BAI, MEN, NEU, RNE, SFE) / CHL(ATA, COQ, VAL, LBO, MAU, BIO, ARA, LLA, AIS, MAG, RME, IPA)
Oenothera stricta ssp. altissima	ARG(CHU, NEU, RNE)
Oenothera suffrutescens	BRA(RGS)
Oenothera tafiensis ssp. parviflora	ARG(TUC)
Oenothera tafiensis ssp. tafiensis	ARG(CAT, COR, JUJ, LRI, SAL, TUC)
Oenothera versicolor	ARG(CAT, JUJ, LRI, SAL, TUC)
Oenothera villaricae	ARG(CHU, NEU, RNE) / CHL(ARA, LLA)
Oenothera villosa ssp. villosa	ARG(COR, MEN, SJU)
Oldenlandia brachypetala	CHL(BIO, AIS)
Oldenlandia corymbosa	BRA(SCA)
Oldenlandia dusenii	BRA(PAR, RGS, SCA)
Oldenlandia salzmannii	ARG(BAI, CHA, CHU, COS, ERI, MIS, NEU) / BRA(PAR, RGS, SCA) / CHL(MAU, BIO, ARA, LLA) / PRY(APA, CAU, CAA, CEN, COA, MIE, ÑEE, PAI) / URY(CLA, COL, LAV, MAL, MON, RNO, ROC, SJO, SOR, TAC, TYT)
Olfersia cervina	BRA(PAR, RGS, SCA)
Oligocladus patagonicus	ARG(LPA, MEN, NEU, RNE)
Olsynium biflorum	ARG(SCR, TDF) / CHL(MAG)
Olsynium bodenbenderi	ARG(MEN)
Olsynium chrysochromum	CHL(COQ, RME)
Olsynium filifolium	ARG(SCR, TDF)
Olsynium frigidum	ARG(MEN, NEU) / CHL(VAL, LBO, MAU, BIO, ARA, RME)
Olsynium junceum ssp. junceum	ARG(BAI, CAT, CHU, JUJ, MEN, NEU, RNE, SAL, SCR, SJU, TDF) / CHL(ATA, COQ, VAL, LBO, MAU, BIO, ARA, LLA, MAG, RME)
Olsynium junceum ssp. colchaguense	CHL(LBO, MAU)
Olsynium junceum ssp. depauperatum	CHL(COQ, LBO, MAU, BIO, ARA, LLA)
Olsynium lyckholmi	ARG(SCR, TDF) / CHL(AIS, MAG)
Olsynium nigricans	CHL(COQ, LBO, MAU, BIO, ARA)
Olsynium obscurum	ARG(TDF) / CHL(AIS, MAG)
Olsynium philippii ssp. illapelinum	CHL(COQ, VAL, LBO, RME)
Olsynium philippii ssp. philippii	CHL(COQ, VAL, LBO, RME)
Olsynium scirpoideum ssp. luridum	ARG(CHU, NEU, RNE) / CHL(BIO)
Olsynium scirpoideum ssp. scirpoideum	CHL(TAR, ANT, ATA, COQ, VAL, LBO, MAU, BIO, ARA, RME)
Olsynium scirpoideum ssp. leucanthum	CHL(VAL, LBO, RME)
Olsynium scirpoideum ssp. scirpeum	CHL(BIO)
Olsynium trinerve	CHL(TAR)
Olyra ciliatifolia	ARG(COS, MIS) / BRA(PAR, SCA) / PRY(APA, CAA, CAN, PAI)
Olyra fasciculata	ARG(JUJ, MIS, SAL, TUC) / BRA(PAR, SCA) / PRY(APA)
Olyra glaberrima	BRA(PAR, RGS, SCA) / PRY(AMA)
Olyra humilis	ARG(COS, MIS) / BRA(PAR, RGS, SCA) / PRY(APA, AMA, CAA)
Olyra latifolia	ARG(COS, MIS) / BRA(PAR, RGS, SCA) / PRY(AMA, CAA, CAN)
Ombrophytum subterraneum	ARG(CAT, JUJ, SAL, TUC) / CHL(ANT)
Omphalodes linifolia	CHL(ARA)
Oncidium bifolium var. majus	ARG(FOR, JUJ, SAL, TUC) / BRA(Desconocida)
Oncidium blancheti var. mixtum	BRA(PAR)
Oncidium crispum	BRA(PAR)
Oncidium emaculatum	BRA(SCA)
Oncidium fimbriatum	ARG(COS, MIS) / BRA(PAR, RGS, SCA) / PRY(CAA, CEN, GUA, PAI)
Oncidium flexuosum var. radiatum	BRA(SCA) / PRY(COA)
Oncidium hookeri f. albescens	BRA(SCA)
Oncidium longipes var. monophyllum	BRA(PAR) / PRY(APA) / URY(MON)
Oncidium maculosum	ARG(FOR) / BRA(Fuera del área del proyecto)
Oncidium pontagrossense	BRA(PAR)
Oncidium sodiroi	BRA(PAR)
Oncidium trulliferum	BRA(PAR, RGS, SCA)
Oncidium varicosum var. vexillarium	BRA(PAR) / PRY(COA)
Oncidium verrucosissimum	ARG(COS, FOR, MIS) / BRA(PAR) / PRY(APA, GUA)
Oncorachis macrantha	BRA(Fuera del área del proyecto) / PRY(AMA)
Ononis mitissima	URY(MON)
Onopordum acanthium	ARG(BAI, CHA, CHU, COR, DFE, LPA, LRI, MEN, NEU, RNE, SLU, SCR) / BRA(RGS) / CHL(ARA, RME) / URY(MON)
Onopordum nervosum	ARG(COR)
Onoseris alata	ARG(JUJ, SAL, TUC)
Onoseris hastata	ARG(JUJ, SAL)
Onuris alismatifolia	ARG(SCR, TDF) / CHL(MAG)
Onuris graminifolia	ARG(CHU, NEU, RNE, SCR) / CHL(MAG)
Onuris hatcheriana	ARG(SCR) / CHL(MAG)
Onuris papillosa	ARG(SCR, TDF) / CHL(MAG)
Onuris spegazziniana	ARG(CHU, RNE, SCR) / CHL(MAG)
Operculina alata var. pubescens	BRA(Fuera del área del proyecto) / PRY(CON)
Ophioderma palmata	ARG(MIS) / BRA(PAR, RGS, SCA)
Ophioglossum crotalophoroides ssp. crotalophoroides	ARG(BAI, CAT, CHA, COR, COS, ERI, JUJ, LPA, MIS, NEU, RNE, SAL, SLU, TUC) / BRA(RGS) / CHL(VAL, MAU, BIO, ARA, LLA, RME) / PRY(CEN, COA) / URY(ART, CAS, CLA, MON, SJO, TAC)
Ophioglossum fernandezianum	CHL(JFE)
Ophioglossum melipillense	ARG(CAT, JUJ, SLU, TUC) / CHL(VAL, LBO, MAU, RME)
Ophioglossum nudicaule var. nudicaule	ARG(CHA, COS, ERI, FOR, JUJ, MIS, SAL, SFE, TUC) / BRA(RGS, SCA) / PRY(APY, CEN, CHO, COA, ITA, PHA) / URY(MON)
Ophioglossum opacum	ARG(CHU, SCR, TDF) / CHL(MAG)
Ophioglossum reticulatum	ARG(BAI, CHA, COS, FOR, JUJ, MIS, SAL, TUC) / BRA(PAR, RGS, SCA) / PRY(COA) / URY(RIV)
Ophioglossum vulgatum	ARG(CHU, NEU, RNE) / CHL(LLA, AIS)
Ophiopogon japonicus	ARG(COR)
Ophryosporus anomalus	CHL(TAR, ANT)
Ophryosporus axilliflorus	ARG(CAT, COR, JUJ, LRI, SAL, SLU, TUC)
Ophryosporus burkartii	ARG(JUJ)
Ophryosporus charua	ARG(CAT, COR, JUJ, LRI, SAL, SJU, SLU, TUC)
Ophryosporus floribundus	CHL(ANT)
Ophryosporus hoppii	CHL(TAR, ANT)
Ophryosporus johnstonii	CHL(ATA)
Ophryosporus lorentzii	ARG(JUJ, SAL, TUC)
Ophryosporus macrodon	ARG(JUJ, SAL, TUC)
Ophryosporus origanoides	CHL(TAR)
Ophryosporus paradoxus	CHL(ATA, COQ, VAL, RME)
Ophryosporus pinifolius	CHL(TAR)
Ophryosporus piquerioides	ARG(JUJ, SAL, TUC)
Ophryosporus regnellii	BRA(PAR, SCA)
Ophryosporus triangularis	CHL(TAR, ANT, ATA, COQ)
Oplismenopsis najada	ARG(BAI, COS, DFE, ERI, SFE) / URY(COL)
Oplismenus hirtellus ssp. hirtellus	ARG(CAT, CHA, COS, ERI, FOR, JUJ, MIS, SAL, SFE, TUC) / BRA(PAR, RGS, SCA) / PRY(APA, CEN, COA, GUA, PAI, PHA, SPE) / URY(ROC)
Oplismenus hirtellus ssp. setarius	ARG(BAI, CAT, CHA, COS, ERI, JUJ, MIS, SAL, SFE, TUC) / BRA(PAR, RGS, SCA) / PRY(APA, CAU, CAN, CEN, CON, COA, GUA, MIE, ÑEE, PAI, SPE) / URY(MAL)
Oplonia jujuyensis	ARG(JUJ, SAL)
Opuntia anacantha var. anacantha	ARG(FOR, JUJ, SAL) / PRY(PHA)
Opuntia anacantha var. kiska-loro	ARG(CAT, CHA, COS, ERI, FOR, SAL, SDE)
Opuntia anacantha var. retrorsa	ARG(CHA, COR, COS, ERI, FOR, JUJ, LRI, SAL, SDE, SFE, TUC) / PRY(APY, BOQ, ÑEE, PAI, PHA) / URY(PAY, RNO)
Opuntia anacantha var. utkilio	ARG(COS, ERI, SAL) / PRY(APY)
Opuntia arechavaletae	ARG(BAI, ERI) / BRA(PAR, RGS, SCA) / URY(MAL, ROC)
Opuntia aurantiaca	ARG(BAI, ERI) / URY(MON)
Opuntia bonaerensis	ARG(BAI, COR, ERI, LPA, SFE)
Opuntia colubrina	ARG(CHA, FOR) / PRY(APY)
Opuntia discolor	ARG(CHA, FOR, JUJ, SDE) / PRY(APY)
Opuntia elata var. cardiosperma	ARG(CHA, COS, FOR, SFE, SDE) / PRY(APY, CEN, CON, COA, ÑEE, PHA, SPE)
Opuntia elata var. elata	ARG(BAI, CHA, COR, COS, ERI, FOR, LPA, MEN, SAL, SFE, TUC) / BRA(RGS) / PRY(APY, BOQ, CEN, ÑEE, PAI, PHA, SPE) / URY(CAS, MAL, PAY, SAO)
Opuntia elata var. obovata	ARG(BAI, COR, COS, ERI, LPA, SFE) / URY(MAL, SJO)
Opuntia ficus-indica f. ficus-indica	ARG(BAI, CAT, CHA, COR, COS, ERI, FOR, JUJ, LPA, LRI, MEN, SAL, SDE, SFE, SJU, SLU, TUC) / BRA(SCA) / PRY(APY)
Opuntia ficus-indica f. amyclaea	ARG(CAT, COR, ERI, JUJ, LRI, SAL, SDE)
Opuntia megapotamica	ARG(BAI, CAT, COR, ERI, LPA, RNE, SLU, SFE) / BRA(RGS) / URY(ART, CAS, CLA, COL, CLA, FLO, FLA, LAV, MAL, MON, PAY, RNO, RIV, ROC, SAO, SJO, SJO, TAC, TYT)
Opuntia megapotamica var. salagria	ARG(BAI, CAT, COR, ERI, LPA, SLU, SFE, SDE)
Opuntia megapotamica var. chadihuensis	ARG(BAI)
Opuntia monacantha	BRA(PAR, RGS, SCA)
Opuntia penicilligera	ARG(BAI, LPA, MEN, NEU, RNE)
Opuntia quimilo	ARG(CAT, CHA, COR, FOR, JUJ, LRI, SAL, SDE, SFE, TUC) / PRY(APY, BOQ, CON)
Opuntia robusta	ARG(SAL)
Opuntia salmiana	ARG(CAT, COR, ERI, JUJ, SAL, SDE, SFE, SLU) / PRY(APY)
Opuntia schickendantzii	ARG(CAT, JUJ, LRI, SAL, TUC)
Opuntia spinulifera	ARG(ERI)
Opuntia stenarthra	ARG(CHA, COS, ERI, FOR, SFE) / PRY(APY, CEN, CON, COA, ÑEE, PHA, SPE)
Opuntia sulphurea var. hildmannii	ARG(JUJ, SAL)
Opuntia sulphurea var. pampeana	ARG(BAI, COR, LPA, SDE, SFE) / URY(RNO)
Opuntia sulphurea var. sulphurea	ARG(CAT, CHA, COR, LRI, MEN, NEU, RNE, SAL, SJU, TUC)
Opuntia ventanensis	ARG(BAI)
Oreobolus obtusangulus	ARG(NEU, RNE, SCR, TDF) / CHL(BIO, ARA, LLA, AIS, MAG, JFE)
Oreocereus australis	CHL(TAR)
Oreocereus celsianus	ARG(JUJ)
Oreocereus hempelianus	CHL(TAR)
Oreocereus leucotrichus	CHL(TAR, ANT)
Oreocereus trollii	ARG(JUJ)
Oreocereus variicolor	CHL(TAR, ANT)
Oreomyrrhis andicola	ARG(CAT, COR, JUJ, SAL, TUC)
Oreomyrrhis hookeri	ARG(SCR, TDF) / CHL(MAG)
Oreopanax capitatus	BRA(PAR)
Oreopanax fulvum	BRA(PAR, SCA)
Oreopanax kuntzei	ARG(JUJ, SAL)
Oreopolus glacialis	ARG(CHU, MEN, NEU, RNE, SCR, TDF) / CHL(LBO, MAU, BIO, ARA, LLA, AIS, MAG, RME)
Oriastrum acerosum var. acerosum	ARG(SJU) / CHL(ATA, COQ, VAL, RME)
Oriastrum acerosum var. dasycarpum	ARG(SJU) / CHL(COQ)
Oriastrum achenohirsutum	ARG(SJU) / CHL(ATA)
Oriastrum apiculatum	ARG(SJU) / CHL(COQ, VAL, LBO, MAU, BIO, RME)
Oriastrum chilense	ARG(MEN) / CHL(COQ, RME)
Oriastrum dioicum	ARG(CAT, JUJ, LRI, SAL, SJU, TUC) / CHL(ANT, COQ, RME)
Oriastrum gnaphalioides	ARG(CAT, LRI, SAL, SJU) / CHL(ANT, ATA, COQ, VAL, RME)
Oriastrum lycopodioides	ARG(MEN, SJU) / CHL(COQ, VAL, LBO)
Oriastrum minutum	ARG(CAT, MEN, SAL, SJU) / CHL(ANT, ATA, COQ, VAL)
Oriastrum pentacaenoides	ARG(MEN, SJU)
Oriastrum pulvinatum var. pulvinatum	ARG(CAT, JUJ, LRI, MEN, SAL, SJU, TUC) / CHL(TAR, ANT, ATA, COQ)
Oriastrum pulvinatum var. polymallum	ARG(CAT, LRI, MEN, SAL, SJU) / CHL(COQ)
Oriastrum pusillum	CHL(COQ, VAL, RME)
Oriastrum revolutum	ARG(CAT, JUJ, LRI, SAL, SJU) / CHL(TAR, ANT, ATA)
Oriastrum sphaeroidale	ARG(LRI, SAL, SJU) / CHL(ANT, ATA, COQ)
Oriastrum stuebelii var. abbreviatum	ARG(CAT, JUJ, SAL, TUC)
Oriastrum stuebelii var. argentinum	ARG(CAT, JUJ, LRI, SAL, TUC)
Oriastrum tarapacensis	CHL(TAR)
Oriastrum werdermannii	CHL(COQ)
Orites myrtoidea	ARG(NEU) / CHL(MAU, BIO, ARA)
Ormosia arborea	BRA(PAR, RGS, SCA)
Ormosia fastigiata	BRA(PAR)
Ornithocephalus brachystachyus	BRA(RGS)
Ornithocephalus myrticola	BRA(PAR, RGS, SCA)
Ornithophora radicans	BRA(PAR, RGS, SCA)
Ornithopus compressus	CHL(BIO)
Ornithopus micranthus	ARG(COS, ERI, SFE) / BRA(RGS) / URY(CAS, CLA, DUR, FLA, MAL, MON, ROC, SJO, TAC, TYT)
Ornithopus pinnatus	CHL(BIO)
Ornithopus sativus	CHL(BIO)
Orobanche chilensis	ARG(BAI, CAT, CHU, LPA, MEN, NEU, RNE) / CHL(ATA, COQ, RME)
Orobanche minor	CHL(MAU, BIO)
Orobanche ramosa	CHL(BIO, ARA, RME)
Orobanche tarapacana	CHL(TAR)
Ortachne breviseta	ARG(CHU, NEU, RNE) / CHL(LLA)
Ortachne rariflora	ARG(RNE, TDF) / CHL(LLA, AIS, MAG)
Orthoclada laxa	BRA(SCA)
Orthopappus angustifolius	ARG(CHA, COS, ERI, FOR, JUJ, MIS, SAL, SFE, TUC) / BRA(PAR, RGS, SCA) / PRY(APA, APY, AMA, CAU, CAN, CEN, CON, COA, GUA, PAI, PHA, SPE) / URY(TAC)
Orthosia congesta	BRA(PAR, SCA) / PRY(APA)
Orthosia dusenii	BRA(PAR, SCA)
Orthosia guilleminiana	ARG(COR, JUJ, SAL, TUC)
Orthosia loandensis	BRA(PAR)
Orthosia scoparia	ARG(CHA, FOR, MIS) / BRA(PAR, RGS, SCA) / PRY(PAI)
Orthosia urceolata	ARG(MIS) / BRA(PAR, RGS, SCA)
Orthosia virgata	ARG(BAI, CHA, COR, COS, ERI, FOR, MIS, SFE) / BRA(PAR, RGS, SCA) / PRY(APY, AMA, BOQ, GUA, PAI) / URY(LAV, ROC)
Orthrosanthus occissapungus	ARG(JUJ, SAL)
Oryza latifolia	ARG(CHA, COS, ERI, FOR, SFE) / BRA(PAR, SCA) / PRY(APY, BOQ, CON, COA, ÑEE, PHA)
Oryza rufipogon	ARG(BAI, MIS) / BRA(Fuera del área del proyecto) / PRY(Desconocida)
Oryza sativa	BRA(RGS, SCA) / CHL(LBO, MAU, BIO, RME)
Osmorhiza chilensis	ARG(CHU, MEN, NEU, RNE, SCR, TDF) / CHL(COQ, VAL, LBO, MAU, BIO, ARA, LLA, AIS, MAG, RME)
Osmorhiza depauperata	ARG(CHU, NEU, RNE, SCR, TDF) / CHL(BIO, MAG)
Osmorhiza glabrata	ARG(MEN, NEU) / CHL(LBO, MAU, BIO, ARA, RME)
Osmorhiza mexicana	ARG(CAT, COR, JUJ, SAL, TUC)
Osmunda gracilis	BRA(RGS, SCA)
Osmunda spectabilis	ARG(BAI, CHA, COS, ERI, MIS, SAL) / BRA(PAR, RGS, SCA) / PRY(APA, AMA, CAU, CAN, CEN, CON, COA, GUA, SPE) / URY(CAS, CLA, LAV, MON, RNO, ROC)
Osmundastrum cinnamomeum	ARG(COS) / BRA(PAR, RGS, SCA) / PRY(APA, AMA, CAU, COA, SPE) / URY(RIV)
Ossaea amygdaloides	BRA(PAR, RGS, SCA) / PRY(CAN)
Ossaea angustifolia	BRA(PAR, SCA)
Ossaea confertiflora	BRA(PAR, SCA)
Ossaea flaccida	BRA(RGS)
Ossaea fragilis	BRA(SCA)
Ossaea marginata	ARG(MIS) / BRA(PAR, SCA) / PRY(APA, CAU, CAA, CAN, CEN, COA, GUA, PAI)
Ossaea meridionalis	BRA(PAR, SCA) / PRY(APA)
Ossaea sanguinea	BRA(PAR, SCA)
Osvaldoa valida	ARG(COS, ERI) / BRA(SCA) / URY(PAY)
Otachyrium versicolor	ARG(COS, MIS) / BRA(PAR, SCA) / PRY(APA, AMA, CAU, CEN, CON, COA, GUA, ITA, PAI, SPE)
Otholobium glandulosum	CHL(COQ, VAL, LBO, MAU, BIO, ARA, LLA, RME)
Otholobium higuerilla	ARG(COR, JUJ, SAL, TUC)
Otholobium pubescens	CHL(TAR)
Ottelia brasiliensis	ARG(COS, MIS) / BRA(PAR) / PRY(APA, APY, AMA, CAU, CAA, CAN)
Ottonia frutescens	BRA(SCA)
Ottonia propinqua f. propinqua	BRA(PAR, SCA)
Ottonia propinqua f. longiracemosa	BRA(SCA)
Ouratea claudei	BRA(PAR)
Ouratea paraguayensis	PRY(AMA, CON, SPE)
Ouratea parviflora	BRA(PAR, RGS)
Ouratea salicifolia	BRA(PAR)
Ouratea sellowii	BRA(PAR)
Ouratea spectabilis	BRA(PAR)
Ouratea vaccinioides	BRA(PAR, SCA)
Ourisia alpina	ARG(MEN, NEU, RNE) / CHL(MAU, BIO, ARA, LLA)
Ourisia breviflora ssp. breviflora	ARG(SCR, TDF) / CHL(AIS, MAG)
Ourisia breviflora ssp. uniflora	ARG(NEU, RNE) / CHL(BIO, LLA)
Ourisia coccinea ssp. coccinea	ARG(NEU) / CHL(BIO, ARA, LLA, AIS)
Ourisia coccinea ssp. elegans	CHL(COQ, BIO, ARA, LLA)
Ourisia fragrans	ARG(NEU, RNE) / CHL(LLA)
Ourisia fuegiana	ARG(SCR, TDF) / CHL(AIS, MAG)
Ourisia microphylla	ARG(MEN, NEU) / CHL(MAU, BIO)
Ourisia muscosa	CHL(TAR)
Ourisia polyantha	CHL(LBO, RME)
Ourisia pulchella	ARG(SAL)
Ourisia pygmaea	ARG(CHU, NEU, RNE) / CHL(BIO, ARA, LLA)
Ourisia ruelloides	ARG(CHU, NEU, RNE, SCR, TDF) / CHL(LBO, MAU, BIO, ARA, LLA, AIS, MAG)
Ourisia serpyllifolia	CHL(VAL, MAU, RME)
Ovidia andina	ARG(CHU, NEU, RNE) / CHL(MAU, BIO, ARA, LLA, AIS)
Oxalis adenophylla	ARG(CHU, MEN, NEU, RNE, SCR) / CHL(LBO, MAU, BIO, ARA, LLA, AIS, RME)
Oxalis alstonii	BRA(PAR, SCA)
Oxalis arbuscula	CHL(ANT, ATA)
Oxalis arenaria	CHL(COQ, VAL, LBO, MAU, BIO, ARA, LLA, MAG, RME)
Oxalis argentina	ARG(CAT, JUJ, LRI, SAL, TUC)
Oxalis articulata ssp. articulata	ARG(BAI, COR, DFE, ERI, LPA, MEN, MIS, SFE, TUC) / BRA(RGS) / URY(CAS, FLO, LAV, MAL, MON, ROC, SOR)
Oxalis articulata ssp. rubra	ARG(BAI, COR, DFE, ERI, MEN, SJU, SFE, TUC) / BRA(PAR, RGS, SCA) / URY(ART, CAS, COL, MON, SAO, SOR, TAC)
Oxalis atacamensis	CHL(ANT, ATA)
Oxalis aureoflava	CHL(MAU, BIO, ARA, LLA, AIS)
Oxalis barrelieri	BRA(PAR, SCA)
Oxalis benjaminii	PRY(APY, CAU)
Oxalis bifrons ssp. bifrons	ARG(COS) / BRA(PAR, RGS)
Oxalis bifrons ssp. littoralis	BRA(RGS)
Oxalis bipartita ssp. bipartita	ARG(BAI, CHA, COS, ERI, MIS, SFE) / BRA(PAR, RGS, SCA) / PRY(GUA, MIE) / URY(TAC)
Oxalis bipartita ssp. pabstii	ARG(MIS) / BRA(SCA)
Oxalis bisecta	BRA(PAR, SCA)
Oxalis bisfracta	ARG(CAT, JUJ, SAL, TUC) / CHL(BIO)
Oxalis brasiliensis	ARG(BAI, COS, ERI, MIS) / BRA(RGS) / URY(CAS, COL, DUR, FLA, LAV, MAL, MON, PAY, RNO, ROC, SAO, SJO, SOR, TAC, TYT)
Oxalis bulbocastanum	CHL(TAR, ANT, ATA)
Oxalis caesia	CHL(ANT)
Oxalis calachaccensis	ARG(SAL, TUC)
Oxalis campanensis	CHL(VAL)
Oxalis chachahuensis	ARG(MEN)
Oxalis cinerea	ARG(MEN) / CHL(COQ, VAL, LBO, MAU, ARA, AIS, RME)
Oxalis clandestina	CHL(LBO, MAU, BIO, ARA, LLA)
Oxalis colchaguensis	CHL(LBO)
Oxalis compacta ssp. berteroana	ARG(MEN, NEU, RNE) / CHL(COQ, VAL, LBO, MAU, RME)
Oxalis compacta ssp. compacta	ARG(CHU, LRI, MEN, NEU, RNE, SCR, SJU) / CHL(ANT, ATA, COQ, VAL, LBO, MAU, BIO, RME)
Oxalis confertissima	BRA(SCA)
Oxalis conorrhiza	ARG(BAI, CAT, CHA, COR, COS, ERI, FOR, JUJ, LPA, MEN, MIS, SAL, SDE, SFE, SJU, SLU, TUC) / BRA(PAR, RGS, SCA) / PRY(APY, APA, AMA, CAU, CEN, CON, COA, MIE, PHA) / URY(ART, CAS, CLA, COL, DUR, FLO, MON, PAY, RNO, RIV, SAO, SJO, SOR, TAC)
Oxalis corniculata var. atropurpurea	ARG(BAI, COS, ERI, MEN) / CHL(JFE) / URY(MON)
Oxalis corniculata var. corniculata	ARG(BAI, CHA, COS, ERI, FOR, JUJ, LPA, MEN, SAL, SJU, SFE, TDF) / BRA(PAR, RGS, SCA) / CHL(COQ, VAL, LBO, MAU, BIO, ARA, LLA, MAG, RME, JFE, IPA) / PRY(APA, CEN, COA, GUA) / URY(ART, CLA, MAL, MON, PAY, SOR)
Oxalis cotagaitensis	ARG(JUJ, SAL)
Oxalis cratensis var. cratensis	BRA(Fuera del área del proyecto) / PRY(AMA, CON)
Oxalis cratensis var. paraguayensis	BRA(Fuera del área del proyecto) / PRY(APY, AMA, CAU, CON, SPE)
Oxalis cytisoides	ARG(MIS) / BRA(PAR, RGS, SCA)
Oxalis debilis var. corymbosa	ARG(BAI, CAT, CHA, COS, DFE, ERI, MIS, SAL, SJU, SFE, TUC) / BRA(PAR, RGS, SCA) / PRY(CEN) / URY(MON, SJO)
Oxalis debilis var. debilis	ARG(COS, JUJ, MIS) / BRA(PAR, RGS, SCA) / PRY(APA, CAA, CEN, GUA, MIE) / URY(DUR)
Oxalis dumetorum	CHL(VAL, LBO, MAU, BIO, ARA, LLA)
Oxalis enneaphylla	ARG(SCR, TDF) / CHL(MAG)
Oxalis eremobia	CHL(ANT, ATA)
Oxalis ericoides	CHL(ANT)
Oxalis eriocarpa	ARG(BAI, COS, ERI, MIS) / BRA(RGS) / PRY(ITA) / URY(CAS, CLA, COL, DUR, FLA, LAV, MAL, MON, PAY, RIV, ROC, SAO, SOR, TAC)
Oxalis eriolepis	ARG(JUJ, SAL)
Oxalis erosa f. erosa	ARG(CHA, FOR, JUJ, SAL, SDE, TUC) / BRA(Fuera del área del proyecto) / PRY(APY, CON)
Oxalis erosa f. rosea	PRY(CON)
Oxalis erythrorhiza	ARG(CHU, JUJ, LRI, MEN, NEU, RNE, SJU) / CHL(ANT, ATA, COQ, LBO, MAU, RME)
Oxalis famatinae ssp. famatinae	ARG(CAT, JUJ, LRI, NEU, SAL, SJU, TUC)
Oxalis famatinae ssp. sanjuaninae	ARG(LRI, SJU)
Oxalis floribunda ssp. floribunda	ARG(BAI, COS, ERI, LPA, MIS, SFE) / BRA(PAR, RGS, SCA) / PRY(COA, GUA, MIE, PAI) / URY(CLA, DUR, FLA, LAV, MON, RNO, RIV, SAO, SJO, SOR, TAC)
Oxalis floribunda ssp. ostenii	ARG(BAI, COS, ERI, MIS, SFE) / BRA(RGS, SCA) / PRY(COA, MIE) / URY(ART, MON, PAY, RIV, SAO, SOR, TAC, TYT)
Oxalis frutescens	ARG(CAT, FOR, JUJ, MIS, SAL, TUC) / BRA(Fuera del área del proyecto) / PRY(APY, CON, PHA)
Oxalis geralensis	ARG(MIS) / BRA(PAR, RGS, SCA)
Oxalis gigantea	CHL(ANT, ATA, COQ)
Oxalis grisea var. mattogrossensis	BRA(Fuera del área del proyecto) / PRY(AMA, CAU, CON)
Oxalis gyrorhiza	CHL(VAL, LBO, MAU, BIO, ARA, LLA)
Oxalis hedysarifolia	BRA(SCA) / PRY(AMA)
Oxalis hepatica	BRA(PAR)
Oxalis hispidula	ARG(BAI, CHA, COS, ERI, FOR, MIS, SFE) / BRA(PAR, RGS, SCA) / PRY(APY, CAU, CAA, CEN, COA, MIE, PHA, SPE) / URY(CAS, CLA, DUR, FLA, LAV, MAL, PAY, RNO, SAO, SJO)
Oxalis holosericea	ARG(NEU) / CHL(LBO, MAU, BIO)
Oxalis hyalotricha	ARG(BAI, COS, MIS) / BRA(PAR) / PRY(APA, AMA)
Oxalis hypsophila	ARG(CAT, LRI, MEN, SJU) / CHL(ANT, ATA, COQ, VAL, LBO, RME)
Oxalis incana	CHL(RME)
Oxalis irreperta	BRA(PAR, SCA)
Oxalis johnstonii	CHL(ANT, ATA)
Oxalis laciniata	ARG(CHU, SCR, TDF) / CHL(MAG)
Oxalis lasiopetala	ARG(BAI, CAT, COR, COS, ERI, JUJ, LPA, MIS, RNE, SAL, TUC) / BRA(RGS) / PRY(MIE) / URY(ART, CAS, CLA, COL, FLA, LAV, MAL, MON, PAY, RIV, SAO, SJO, SOR, TAC, TYT)
Oxalis latifolia ssp. latifolia	BRA(PAR, SCA)
Oxalis latifolia ssp. schraderiana	ARG(SAL)
Oxalis laxa var. hispidissima	ARG(MEN, NEU) / CHL(ANT, ATA, COQ, VAL, LBO, RME)
Oxalis laxa var. laxa	CHL(ANT, COQ, VAL, LBO, MAU, BIO, RME)
Oxalis leucophylla	CHL(ATA)
Oxalis linarantha	ARG(COS, MIS) / BRA(PAR, RGS, SCA) / PRY(APA, GUA, PAI)
Oxalis lindneri	ARG(CAT, COS, ERI, SFE)
Oxalis loricata	ARG(SCR, TDF) / CHL(AIS, MAG)
Oxalis macrorrhiza	ARG(MEN)
Oxalis magellanica	ARG(NEU, RNE, SCR, TDF) / CHL(ARA, LLA, AIS, MAG)
Oxalis matancillae	CHL(ANT)
Oxalis megalorrhiza	CHL(TAR, ANT, ATA, COQ, VAL, LBO, MAU, BIO, RME)
Oxalis micrantha	ARG(CHU, MEN, NEU, RNE) / CHL(ANT, ATA, COQ, VAL, LBO, MAU, BIO, ARA, LLA, RME, JFE)
Oxalis mira	CHL(COQ)
Oxalis monticola	URY(MAL, MON)
Oxalis morenoensis	CHL(ANT)
Oxalis morronei	ARG(SCR)
Oxalis muscoides	ARG(JUJ, MEN, SJU)
Oxalis myriophylla	BRA(PAR, RGS, SCA)
Oxalis nahuelhuapiensis	ARG(CHU, NEU, RNE) / CHL(ARA, RME)
Oxalis neuwiedii ssp. pardoensis	BRA(PAR)
Oxalis niederleiniana	ARG(COS, MIS) / BRA(PAR)
Oxalis niederleinii	ARG(BAI, CAT, COR, COS, ERI, FOR, JUJ, MIS, SAL, SDE, SFE, TUC) / BRA(PAR, RGS, SCA) / PRY(APA, CEN, GUA, MIE, PAI) / URY(CAS, CLA, COL, FLO, FLA, LAV, MAL, MON, PAY, RNO, RIV, SAO, SJO, SOR, TAC, TYT)
Oxalis nubigena	ARG(CAT, LRI, SAL, TUC)
Oxalis odonellii	BRA(SCA)
Oxalis ornithopus	CHL(ANT, ATA)
Oxalis ovalleana	CHL(ANT, ATA, COQ)
Oxalis pachyrrhiza	ARG(CAT, JUJ, SAL, TUC) / CHL(ANT, ATA, COQ, VAL, MAU, RME)
Oxalis paludosa	ARG(BAI, COS, ERI, MIS, SFE) / BRA(RGS) / PRY(CEN, COA, ÑEE, PAI) / URY(ART, CLA, DUR, PAY, RNO, ROC, SAO, SOR, TAC)
Oxalis paranaensis	BRA(PAR)
Oxalis pedunculata	ARG(MEN)
Oxalis penicillata	ARG(MEN) / CHL(VAL, LBO, RME)
Oxalis perdicaria	ARG(BAI, COS, ERI, MEN, MIS, NEU, SFE) / BRA(RGS) / CHL(COQ, VAL, LBO, MAU, BIO, ARA, LLA, RME) / URY(ART, CAS, CLA, COL, DUR, FLA, LAV, MAL, MON, PAY, RNO, RIV, SJO, SOR)
Oxalis pes-caprae	ARG(BAI, MEN, SJU) / BRA(Fuera del área del proyecto) / CHL(COQ, VAL, BIO, LLA) / URY(MON)
Oxalis pinguiculacea	ARG(JUJ)
Oxalis platylepis	ARG(JUJ, SAL)
Oxalis potamophila	ARG(MIS) / BRA(PAR, RGS, SCA)
Oxalis praetecta	BRA(PAR)
Oxalis pseudoviolacea	ARG(JUJ, SAL)
Oxalis psoraleoides ssp. insipida	ARG(SAL) / BRA(Fuera del área del proyecto) / PRY(APY)
Oxalis pycnophylla	ARG(JUJ, MEN, SAL, SJU) / CHL(ANT)
Oxalis refracta	ARG(BAI, COS, ERI, LPA, MIS, SFE) / BRA(RGS) / URY(COL, LAV, MAL, MON, RNO, RIV, ROC, SAO, SJO, SOR, TAC)
Oxalis renifolia	BRA(Fuera del área del proyecto) / PRY(AMA, CAN, CON, SPE)
Oxalis rhombeo-ovata ssp. rhombeo-ovata	ARG(MIS) / BRA(PAR, SCA) / PRY(APA, AMA)
Oxalis rhombeo-ovata ssp. sustenta	BRA(PAR)
Oxalis ricardii	CHL(ANT)
Oxalis rigida	ARG(CHU, MEN, NEU, RNE) / CHL(ANT, ATA, COQ, LBO, RME)
Oxalis riparia	BRA(PAR)
Oxalis rosea	CHL(COQ, VAL, LBO, MAU, BIO, ARA, LLA, AIS, RME)
Oxalis rupestris	BRA(PAR, SCA) / PRY(CEN, COA) / URY(Desconocida)
Oxalis sarmentosa	BRA(PAR, RGS)
Oxalis sellowiana f. sellowiana	ARG(BAI, ERI) / BRA(RGS) / URY(CAS, COL, FLO, FLA, MAL)
Oxalis sellowiana f. alba	ARG(COS, ERI) / BRA(RGS) / URY(ART, CAS, CLA, RIV, ROC, TYT)
Oxalis sellowii var. rosea	ARG(COS, MIS) / BRA(Fuera del área del proyecto) / PRY(CAU, CAN, CON, COA, GUA, MIE, PAI, SPE)
Oxalis sellowii var. sellowii	ARG(COS, MIS) / BRA(PAR) / PRY(APY, APA, CAU, CAA, CAN, CEN, COA, GUA, ITA, MIE, PAI, SPE)
Oxalis sellowii var. alba	PRY(CAN, SPE)
Oxalis serpens var. serpens	BRA(PAR, RGS)
Oxalis serpens var. catharinensis	BRA(PAR, SCA)
Oxalis sleumeri	ARG(CAT, SAL)
Oxalis spiralis ssp. membranifolia	ARG(CAT, JUJ, SAL, TUC)
Oxalis squamata	ARG(MEN, NEU, SJU) / CHL(VAL, LBO, MAU, BIO, RME)
Oxalis squarrosa	CHL(COQ)
Oxalis strictula	CHL(VAL, LBO)
Oxalis subacaulis	ARG(CAT, MEN, SJU)
Oxalis subvillosa	ARG(MIS) / BRA(PAR, SCA)
Oxalis tacorensis	CHL(TAR, ANT)
Oxalis telmatica	BRA(RGS, SCA)
Oxalis tenerrima	ARG(JUJ, MIS, SAL, TUC) / BRA(PAR, RGS, SCA)
Oxalis tortuosa	CHL(COQ, VAL, LBO, JFE)
Oxalis triangularis ssp. papilionacea	ARG(CAT, COS, FOR, JUJ, MIS, SAL, SDE, SFE, TUC) / BRA(PAR, RGS, SCA) / PRY(APY, AMA, CEN, CON, COA, GUA, PAI, PHA, SPE)
Oxalis triangularis ssp. triangularis	ARG(COS, MIS, SJU) / BRA(PAR, RGS, SCA) / PRY(APY, CEN, COA, GUA, PAI, PHA, SPE)
Oxalis trollii	ARG(CAT, JUJ, SAL, TUC)
Oxalis tuberosa	ARG(JUJ, SAL, TUC)
Oxalis valdiviensis	ARG(CHU, NEU, RNE) / CHL(VAL, LBO, MAU, BIO, ARA, LLA)
Oxalis virgosa	CHL(ATA, COQ, VAL)
Oxalis yacutulensis	ARG(CAT, JUJ, LRI, SAL, SDE, TUC)
Oxybasis glauca	ARG(COR, SDE, TDF) / CHL(AIS, MAG, IPA)
Oxybasis macrosperma	ARG(BAI, CHU, JUJ, RNE, SJU, SLU, SCR, SFE, TDF) / CHL(ANT, VAL, LBO, MAU, LLA, AIS, RME) / PRY(PHA) / URY(CAS, MON, SJO)
Oxybasis rubra	
Oxybasis urbica	CHL(JFE)
Oxycaryum cubense f. cubense	ARG(CHA, COS, FOR) / BRA(SCA) / PRY(APY, CEN, PHA) / URY(ROC)
Oxycaryum cubense f. paraguayense	ARG(BAI, CHA, COS, DFE, ERI, FOR, SFE) / BRA(RGS) / PRY(APY, CEN, PHA) / URY(RNO, TAC)
Oxychloë andina	ARG(CAT, JUJ, LRI, SAL, SJU, TUC) / CHL(TAR, ANT, ATA, COQ, RME)
Oxychloë bisexualis	ARG(MEN, SAL, SJU) / CHL(COQ, RME)
Oxychloë castellanosii	ARG(CAT, LRI, SJU)
Oxychloë haumaniana	ARG(LRI, SJU) / CHL(ATA, COQ)
Oxychloë mendocina	ARG(MEN)
Oxypetalum acerosum	PRY(CAU)
Oxypetalum aequaliflorum	BRA(PAR) / PRY(CAU, CON)
Oxypetalum alpinum var. pallidum	BRA(PAR, RGS, SCA)
Oxypetalum appendiculatum	ARG(COS, MIS) / BRA(PAR, RGS, SCA) / PRY(APA, CAU, CAN, GUA, SPE)
Oxypetalum arenicola	ARG(BAI)
Oxypetalum argentinum	ARG(CHA, COR, COS, ERI, SFE) / BRA(RGS)
Oxypetalum arnottianum	ARG(CAT, CHA, COR, COS, ERI, FOR, JUJ, MIS, SAL, SLU, SFE, SDE, TUC) / BRA(PAR, RGS, SCA) / PRY(APY, CAN, SPE) / URY(MON)
Oxypetalum aurantiacum	BRA(PAR) / PRY(APA, AMA, CAU) / URY(Desconocida)
Oxypetalum balansae	ARG(BAI, CHA, COS, ERI, FOR, JUJ, MIS, SAL, SFE) / BRA(PAR, SCA) / PRY(CAN, CEN, CON, COA, GUA, ÑEE, PAI, PHA, SPE)
Oxypetalum banskii	BRA(PAR, RGS, SCA)
Oxypetalum barberoanum	ARG(FOR, SAL) / PRY(APY)
Oxypetalum brachystemma	ARG(JUJ, SAL, TUC)
Oxypetalum brachystephanum	PRY(COA)
Oxypetalum capitatum ssp. capitatum	ARG(CAT, CHA, COS, FOR, JUJ, MIS, SAL, SDE, SFE, TUC) / BRA(PAR, RGS, SCA) / PRY(CAA, CEN, COA, GUA, PAI) / URY(FLA)
Oxypetalum capitatum ssp. angustum	BRA(PAR, SCA)
Oxypetalum capitatum ssp. mirabile	ARG(COS, FOR) / BRA(PAR, RGS, SCA) / PRY(CON, GUA, PAI, SPE)
Oxypetalum ceratostemma	PRY(CAU)
Oxypetalum charrua	ARG(MIS) / BRA(RGS)
Oxypetalum chodatianum	ARG(COS) / BRA(PAR) / PRY(APA, CAA, CAN)
Oxypetalum coalitum	BRA(RGS)
Oxypetalum coccineum	ARG(BAI, CAT, CHA, COR, ERI, JUJ, LRI, SAL, SLU, TUC) / BRA(RGS)
Oxypetalum coeruleum	BRA(RGS) / URY(RIV, TAC)
Oxypetalum commersonianum	ARG(BAI, ERI, MIS) / BRA(RGS) / URY(FLA)
Oxypetalum confusum	ARG(COS, MIS) / BRA(PAR, RGS, SCA)
Oxypetalum cordifolium ssp. pedicellatum	BRA(PAR, SCA)
Oxypetalum corymbosum	ARG(COS) / BRA(PAR) / PRY(AMA)
Oxypetalum crispum	ARG(BAI, CHA, COR, COS, ERI, FOR, LPA, MIS, SFE) / BRA(PAR, RGS) / PRY(AMA, CAU, CAA, CAN, CEN, CON, COA, GUA, PAI, PHA) / URY(COL)
Oxypetalum dusenii	BRA(PAR, SCA)
Oxypetalum erectum ssp. campestre	BRA(PAR, SCA)
Oxypetalum erianthum	ARG(CHA, COS, FOR, MIS, SFE) / BRA(PAR) / PRY(CEN, CON, COA, GUA, PAI)
Oxypetalum fiebrigii	ARG(JUJ, SAL)
Oxypetalum filamentosum	PRY(COA)
Oxypetalum foliosum	BRA(SCA)
Oxypetalum fontellae	ARG(COS)
Oxypetalum glabrescens	PRY(CAU)
Oxypetalum globosum	ARG(SAL)
Oxypetalum gracile	ARG(COS)
Oxypetalum hilarianum	ARG(CHA, FOR) / BRA(PAR, RGS, SCA)
Oxypetalum hoehnei	BRA(PAR, SCA)
Oxypetalum humile	ARG(CHA, COS, FOR, MIS, SFE) / PRY(CEN, MIE, PAI)
Oxypetalum incanum	ARG(COS, MIS) / BRA(RGS) / PRY(CAU, CAN)
Oxypetalum insigne var. insigne	BRA(SCA)
Oxypetalum insigne var. bresolinii	BRA(SCA)
Oxypetalum insigne var. burchellii	BRA(PAR, SCA)
Oxypetalum insigne var. glabrum	BRA(RGS)
Oxypetalum joergensenii	ARG(COS, MIS) / BRA(RGS)
Oxypetalum karstenianum	ARG(CHA, COS, FOR, MIS, SFE) / BRA(PAR, RGS)
Oxypetalum kleinii	BRA(SCA)
Oxypetalum lineare	BRA(PAR, RGS, SCA) / PRY(APA)
Oxypetalum longipedunculatum	ARG(SAL, TUC)
Oxypetalum lynchianum	ARG(CHA, COS)
Oxypetalum macrolepis	ARG(CHA, COS, MIS, SFE) / BRA(PAR, RGS) / PRY(CEN, COA, MIE, SPE) / URY(CAS, ROC, TYT)
Oxypetalum malmei	BRA(PAR)
Oxypetalum marginatum	BRA(Fuera del área del proyecto) / PRY(CAN, SPE)
Oxypetalum martii var. martii	BRA(PAR, RGS)
Oxypetalum martii var. nanum	PRY(CAU)
Oxypetalum microphyllum	ARG(COS, ERI, MIS) / URY(ART, COL, PAY, RNO, RIV, SAO, SJO, SOR, TAC)
Oxypetalum molle	ARG(MIS) / BRA(PAR, RGS, SCA) / PRY(APA)
Oxypetalum morilloanum	BRA(SCA)
Oxypetalum muticum	BRA(PAR, RGS) / PRY(CAU)
Oxypetalum nigricans	URY(LAV, MON)
Oxypetalum nitidum	BRA(PAR)
Oxypetalum oblanceolatum	BRA(PAR)
Oxypetalum obtusifolium	BRA(PAR, SCA)
Oxypetalum ophiuroideum	PRY(CAN)
Oxypetalum ostenii	ARG(MIS)
Oxypetalum pachyglossum	BRA(PAR, SCA)
Oxypetalum pachygynum	BRA(PAR) / PRY(APA, AMA, CAN, COA, SPE)
Oxypetalum pannosum var. pannosum	ARG(COS, MIS) / BRA(PAR, RGS, SCA) / PRY(APA, CAU, CAA) / URY(MON, RIV, TAC)
Oxypetalum pannosum var. macranthum	BRA(PAR, RGS)
Oxypetalum parviflorum var. parviflorum	ARG(CHA, SAL) / BRA(PAR, RGS, SCA) / PRY(CON) / URY(CLA, MAL, PAY, RNO, RIV, SAO, SOR, TAC, TYT)
Oxypetalum parviflorum var. kuhlmannii	ARG(COS) / BRA(SCA) / PRY(APA)
Oxypetalum pubescens	ARG(CAT, JUJ, SAL, SDE, TUC)
Oxypetalum radinsii	ARG(MIS)
Oxypetalum rariflorum	BRA(PAR)
Oxypetalum reflexum	BRA(Fuera del área del proyecto) / PRY(AMA)
Oxypetalum reitzii	BRA(SCA)
Oxypetalum rojasianum	PRY(AMA)
Oxypetalum schulzii	ARG(BAI, CHA, COR, COS, ERI, FOR) / URY(ART, MON, RNO)
Oxypetalum solanoides	ARG(BAI, CHA, COR, COS, ERI, FOR, MIS, SFE) / BRA(RGS, SCA) / PRY(Desconocida) / URY(CAS, MON, PAY, SAO, SJO, SOR)
Oxypetalum stenophyllum	BRA(PAR)
Oxypetalum stipatum	ARG(COS, MIS) / BRA(RGS) / PRY(APA)
Oxypetalum subcapitatum	ARG(CHA) / PRY(CAN)
Oxypetalum sublanatum	ARG(MIS) / BRA(PAR, SCA)
Oxypetalum suboppositum	BRA(PAR) / PRY(CAU)
Oxypetalum sylvestre	ARG(BAI, COS, ERI, MIS, SFE) / BRA(RGS) / URY(SAO)
Oxypetalum teyucuarense	ARG(MIS)
Oxypetalum tomentosum var. parvifolium	BRA(PAR, SCA)
Oxypetalum tomentosum var. tomentosum	BRA(RGS, SCA) / URY(MAL, MON, ROC)
Oxypetalum tubatum	BRA(PAR, SCA)
Oxypetalum tucumanense	ARG(JUJ, TUC)
Oxypetalum warmingii	BRA(PAR)
Oxypetalum wightianum	BRA(PAR, RGS, SCA) / PRY(APA, CAU, CAN)
Oxyphyllum ulicinum	CHL(ANT, ATA)
Oxytheca dendroidea ssp. chilensis	ARG(MEN, SJU) / CHL(ANT, ATA, COQ, VAL, RME)
Oziroë acaulis	ARG(JUJ) / CHL(TAR)
Oziroë argentinensis	ARG(CAT, CHA, COR, COS, JUJ, SAL, TUC) / PRY(CON)
Oziroë arida	CHL(COQ, VAL, LBO, MAU, BIO, ARA, RME)
Oziroë biflora	CHL(TAR, ANT, ATA, COQ, VAL, LBO, RME)
Oziroë pomensis	ARG(JUJ, SAL) / CHL(TAR)
