Sabicea villosa	BRA(PAR, SCA)
Sabulina acutiflora	CHL(VAL, LBO, MAU, BIO, RME)
Sabulina altoandina	ARG(JUJ, SAL)
Sacciolepis myuros	PRY(AMA, CEN, COA, PAI)
Sacciolepis vilvoides	ARG(CHA, COS, ERI, MIS) / BRA(PAR, RGS, SCA) / PRY(AMA, CEN, CON, COA, ITA, MIE, PAI) / URY(Desconocida)
Saccoloma brasiliensis	BRA(PAR, SCA)
Saccoloma elegans	BRA(SCA)
Saccoloma inaequale	ARG(MIS) / BRA(PAR, SCA)
Sacoila argentina	ARG(CAT, CHA, COR, JUJ, LRI, MIS) / PRY(APY)
Sacoila duseniana	BRA(PAR, SCA)
Sacoila hassleri	BRA(PAR) / PRY(AMA)
Sacoila lanceolata	ARG(BAI, CAT, CHA, COR, COS, ERI, FOR, JUJ, MIS, SAL, SDE, SFE, SJU, SLU, TUC) / BRA(PAR, RGS, SCA) / PRY(APA, APY, AMA, CAU, CAN, CEN, COA, GUA, ÑEE, PAI, PHA, SPE)
Sacoila pedicellata	ARG(CHA, COR, SAL) / BRA(PAR) / PRY(AMA, SPE)
Sacoila riograndensis	BRA(RGS)
Sacoila secundiflora	ARG(JUJ, SAL, TUC)
Sageretia lehmanii	ARG(FOR, MIS) / PRY(AMA, CAU, CAA, CEN, CON, COA, GUA, MIE, PAI, PHA, SPE)
Sagina apetala var. apetala	ARG(BAI, COS, ERI) / CHL(VAL, LBO, MAU, BIO, ARA, RME) / PRY(SPE) / URY(MON)
Sagina apetala var. pachyrrhiza	CHL(RME)
Sagina apetala var. valdiviana	CHL(LLA)
Sagina chilensis	ARG(BAI, COS) / CHL(LBO, RME, JFE) / URY(MAL)
Sagina humifusa	ARG(BAI, COS, ERI, SFE) / BRA(RGS) / URY(Desconocida)
Sagina procumbens	ARG(BAI, CHU, MEN, NEU, RNE, SCR, TDF) / CHL(BIO, ARA, LLA, AIS, MAG)
Sagittaria guayanensis	ARG(CHA, COR, COS, FOR) / BRA(Fuera del área del proyecto) / PRY(AMA, CEN, COA, PAI, SPE)
Sagittaria montevidensis ssp. chilensis	CHL(VAL, MAU, BIO, ARA, LLA)
Sagittaria montevidensis ssp. montevidensis	ARG(BAI, CHA, COR, COS, ERI, FOR, JUJ, MIS, SAL, SFE, TUC) / BRA(PAR, RGS, SCA) / CHL(LLA) / PRY(APY, AMA, CAU, CAA, CEN, CON, COA, GUA, ITA, MIE, ÑEE, PAI, PHA, SPE) / URY(CAS, CLA, COL, DUR, FLA, PAY, ROC, SAO, SJO, SOR, TAC, TYT)
Sagittaria rhombifolia	ARG(COS) / BRA(PAR, SCA) / CHL(LLA) / PRY(AMA, CAN, CEN, ÑEE)
Salacia crassifolia	BRA(Fuera del área del proyecto) / PRY(CAU, CAN, SPE)
Salacia elliptica	BRA(PAR, SCA) / PRY(CEN, CON, MIE)
Salix alba	ARG(BAI) / CHL(BIO)
Salix babylonica	ARG(BAI, MEN) / CHL(ATA, COQ, RME)
Salix caprea	ARG(RNE)
Salix fragilis	ARG(BAI, CHU, ERI, JUJ, LPA, MEN, NEU, RNE) / URY(CAS)
Salix humboldtiana var. humboldtiana	ARG(BAI, CAT, CHA, CHU, COR, COS, DFE, ERI, FOR, JUJ, LPA, NEU, RNE, SAL, SJU, SFE, SDE, TUC) / BRA(PAR, RGS) / CHL(TAR, ANT, ATA, COQ, VAL, LBO, MAU, BIO, ARA, MAG, RME) / PRY(CEN, ÑEE, PAI, SPE) / URY(CAS, DUR, FLA, MAL, MON, PAY, RIV, ROC, SAO, SOR, TAC, TYT)
Salix humboldtiana var. martiana	ARG(COS, FOR) / BRA(PAR, SCA) / PRY(CEN, COA, PAI) / URY(Desconocida)
Salix viminalis	ARG(RNE) / CHL(LBO, MAU, BIO, LLA)
Salmea scandens	ARG(JUJ, SAL, TUC) / PRY(GUA, PAI, SPE)
Salpichlaena volubilis	BRA(PAR, SCA) / PRY(AMA)
Salpichroa origanifolia	ARG(BAI, CAT, CHA, COR, COS, DFE, ERI, FOR, JUJ, LPA, LRI, RNE, SAL, SJU, SLU, SFE, TUC) / BRA(RGS, SCA) / CHL(VAL, BIO) / PRY(AMA, CEN, ÑEE, PAI) / URY(ROC)
Salpichroa ramosissima	ARG(JUJ)
Salpichroa scandens	ARG(CAT, JUJ, SAL, TUC) / CHL(TAR)
Salpichroa tristis var. tristis	ARG(CAT, JUJ, SAL, TUC)
Salpichroa tristis var. lehmanni	ARG(JUJ) / CHL(TAR)
Salpiglossis sinuata	ARG(MEN, NEU) / CHL(COQ, VAL, LBO, MAU, BIO, ARA, LLA, RME)
Salpiglossis spinescens	CHL(ATA, COQ)
Salpinga margaritacea	BRA(PAR, SCA)
Salsola kali var. tragus	ARG(BAI, MEN)
Salsola kali var. hirsuta	ARG(BAI, LPA, MEN, NEU, RNE)
Salsola kali var. kali	ARG(BAI, CAT, CHU, COR, LPA, LRI, MEN, NEU, RNE, SAL, SCR) / CHL(COQ, VAL, LBO, MAU, BIO, ARA, LLA, RME) / URY(MAL)
Salsola soda var. pumila	ARG(BAI)
Salsola soda var. soda	ARG(BAI)
Salta triflora	ARG(CHA, FOR, JUJ, SAL, SDE, TUC) / BRA(Fuera del área del proyecto) / PRY(APY, BOQ, CHO, CON, NAS, PHA)
Salvia alba	ARG(JUJ, SAL)
Salvia aliciae	BRA(PAR)
Salvia aridicola	PRY(AMA, CAU, CAN, ÑEE)
Salvia atrocyanea	ARG(JUJ, SAL)
Salvia borjensis	ARG(COS) / BRA(RGS)
Salvia brevipes	ARG(COS, ERI, MIS) / BRA(Fuera del área del proyecto) / PRY(MIE)
Salvia caaguazuensis	PRY(CAU)
Salvia calolophos	ARG(COR, JUJ, SAL, SJU)
Salvia campicola	PRY(PAI)
Salvia cardiophylla	ARG(BAI, CHA, COS, ERI, FOR, JUJ, SFE, SDE) / BRA(PAR) / PRY(APY, CAN, CEN, CON, COA, GUA, MIE, PAI, PHA) / URY(SAO)
Salvia coccinea	ARG(BAI, COR, COS, MIS, SDE, TUC) / BRA(PAR)
Salvia congestiflora	BRA(RGS, SCA)
Salvia cordata	BRA(RGS)
Salvia curta	BRA(PAR)
Salvia cuspidata ssp. gilliesii	ARG(CAT, COR, JUJ, LPA, LRI, MEN, SAL, SDE, SJU, SLU, TUC) / CHL(TAR, ANT)
Salvia durifolia	ARG(MIS) / PRY(AMA, CEN, COA, GUA, MIE)
Salvia exserta	ARG(COR, JUJ, SAL, TUC)
Salvia guaranitica	ARG(BAI, COR, COS, ERI, MIS, SAL, TUC) / BRA(PAR, RGS, SCA) / CHL(VAL) / PRY(APA, AMA, CAU, CAA, CAN, GUA, PAI) / URY(MON, PAY, SAO)
Salvia hilarii	BRA(PAR)
Salvia lachnostachys	BRA(PAR, SCA)
Salvia melissiflora	BRA(PAR, RGS, SCA)
Salvia microphylla	ARG(BAI, CAT, COR, DFE)
Salvia minarum	BRA(PAR) / PRY(AMA, CAN)
Salvia nervosa	ARG(CHA, COS, FOR, MIS) / BRA(PAR, RGS) / PRY(APA, AMA, CAU, CAA, CAN, CEN, COA, GUA, ITA, MIE, PAI, SPE)
Salvia officinalis	ARG(BAI, LPA) / BRA(PAR)
Salvia ovalifolia var. ovalifolia	ARG(COS, MIS) / BRA(RGS) / PRY(CAA, ITA)
Salvia ovalifolia var. villosa	ARG(ERI) / BRA(RGS) / URY(ART, CLA, DUR, FLO, FLA, PAY, RNO, RIV, SOR)
Salvia ovalifolia var. nitidula	ARG(COS, MIS) / BRA(RGS) / PRY(MIE)
Salvia pachypoda	PRY(CAU, MIE, SPE)
Salvia pallida	ARG(BAI, CHA, COR, COS, DFE, ERI, FOR, LPA, MIS, SAL, SFE) / BRA(RGS) / PRY(COA, PHA) / URY(SAO)
Salvia paposana	CHL(ANT)
Salvia paraguariensis	PRY(CAU)
Salvia personata	ARG(CAT, JUJ, SAL, TUC)
Salvia procurrens	ARG(BAI, DFE, ERI) / BRA(PAR, RGS, SCA) / URY(CAS, CLA, MAL, MON, RIV, SJO)
Salvia propinqua	BRA(Desconocida)
Salvia reflexa	ARG(COR)
Salvia regnelliana	BRA(PAR, RGS)
Salvia reitzii	BRA(SCA)
Salvia rhombifolia	CHL(TAR, ANT)
Salvia rosmarinoides	ARG(COS, MIS) / BRA(RGS) / PRY(CAN, MIE) / URY(SAO)
Salvia rypara	ARG(CAT, JUJ, SAL, TUC)
Salvia scoparia	BRA(PAR, SCA)
Salvia segtinophylla	PRY(AMA, CAU, CAN)
Salvia splendens	ARG(BAI, DFE, TUC) / BRA(PAR, SCA)
Salvia stachydifolia	ARG(CAT, JUJ, SAL, TUC)
Salvia subrotunda	ARG(COS, MIS) / BRA(PAR, RGS) / PRY(APA, PAI)
Salvia tenuiflora	BRA(SCA)
Salvia tubiflora	CHL(ANT, ATA)
Salvia uliginosa	ARG(BAI, CHA, COS, DFE, ERI, MIS, SFE) / BRA(PAR, RGS, SCA) / URY(FLA, MON, SAO, SJO)
Salvia verbenaca	ARG(BAI, COR, LPA, MEN) / CHL(RME) / URY(MON)
Salvinia adnata	ARG(COS) / BRA(Fuera del área del proyecto)
Salvinia auriculata	ARG(COS, ERI, SFE) / BRA(PAR, RGS, SCA) / CHL(VAL) / PRY(APY, BOQ, CHO, ÑEE) / URY(ART, ROC)
Salvinia biloba	ARG(BAI, COS, ERI, FOR, SAL, SFE) / BRA(PAR, RGS, SCA) / PRY(APY, ÑEE, PHA) / URY(ART, CAS, CLA, MON, RNO, SJO)
Salvinia minima	ARG(BAI, COS, ERI, SAL, SFE) / BRA(RGS, SCA) / PRY(CAN, ÑEE) / URY(CLA, COL, DUR, FLA, MAL, MON, RNO, SAO, TYT)
Samanea tubulosa	ARG(SAL) / PRY(AMA, CON, COA)
Sambucus australis	ARG(BAI, CHA, COR, COS, ERI, FOR, MIS, SFE) / BRA(PAR, RGS, SCA) / PRY(CEN, GUA, ITA, PAI) / URY(MON, ROC, TYT)
Sambucus nigra ssp. peruviana	ARG(CAT, JUJ, LRI, NEU, SAL, TUC)
Sambucus nigra ssp. nigra	ARG(CHU, NEU, RNE, TDF) / CHL(MAU, BIO, ARA, LLA, MAG)
Samolus latifolius	CHL(VAL, LBO, BIO, ARA, LLA)
Samolus repens	CHL(BIO, ARA, LLA, AIS, MAG, IPA)
Samolus spathulatus	ARG(CHU, NEU, SCR, TDF) / CHL(MAG)
Samolus subnudicaulis	ARG(COR, SLU) / BRA(RGS, SCA) / URY(MAL)
Samolus valerandi	ARG(BAI, CAT, CHA, COR, COS, ERI, FOR, JUJ, LPA, LRI, MEN, RNE, SAL, SCR, SDE, SFE, SJU, SLU, TUC) / BRA(RGS, SCA) / CHL(ATA, COQ, VAL, RME) / PRY(CEN, SPE) / URY(COL, MAL, MON)
Sanderella discolor	ARG(JUJ, SAL) / BRA(PAR, RGS)
Sanderella radicans	BRA(PAR)
Sanderella riograndensis	ARG(MIS) / BRA(RGS)
Sanguisorba minor	ARG(LPA, NEU, RNE) / CHL(COQ, VAL, MAU, BIO, ARA, RME)
Sanicula crassicaulis	ARG(CHU, MEN, NEU) / CHL(COQ, VAL, LBO, MAU, BIO, ARA, LLA, RME, JFE)
Sanicula graveolens	ARG(CHU, MEN, NEU, RNE, SCR) / CHL(COQ, VAL, LBO, MAU, BIO, ARA, AIS, RME)
Sanvitalia versicolor	ARG(CAT, COR, JUJ, LRI, SAL, SDE, TUC)
Sapindus saponaria	ARG(CAT, CHA, COS, FOR, MIS, SAL, SFE, TUC) / BRA(PAR) / CHL(TAR, IPA) / PRY(APY, CEN, CON, COA, GUA, PAI, PHA)
Sapium glandulosum	ARG(CAT, FOR, JUJ, MIS, SAL, SDE, TUC) / BRA(PAR, RGS, SCA) / PRY(APA, COA, ITA) / URY(MON, ROC, SOR, TAC, TYT)
Sapium haematospermum	ARG(BAI, CAT, CHA, COR, COS, DFE, ERI, FOR, JUJ, MIS, SAL, SDE, SFE, TUC) / BRA(Fuera del área del proyecto) / PRY(APY, AMA, BOQ, CAU, CAA, CEN, CON, COA, ÑEE, PAI, PHA) / URY(MON, PAY, SAO)
Sapium obovatum	BRA(Fuera del área del proyecto) / PRY(AMA, CAN)
Saponaria officinalis	ARG(BAI, CAT, CHU, COR, ERI, LRI, MEN, NEU, RNE, SAL, SJU, SLU, SFE, TUC) / CHL(VAL, MAU, BIO, ARA, LLA, RME) / URY(CAS, FLA, RNO)
Saranthe eichleri	BRA(PAR, SCA) / PRY(APA, CAN)
Saranthe leptostachya	BRA(PAR)
Sarcocornia ambigua	BRA(Fuera del área del proyecto) / URY(ROC)
Sarcocornia andina	ARG(SAL) / CHL(ANT)
Sarcocornia fruticosa	CHL(TAR, ANT, ATA, COQ, VAL, LBO, BIO, ARA, LLA, MAG, JFE)
Sarcocornia magellanica	ARG(SCR) / CHL(MAG)
Sarcocornia neei	ARG(BAI, CAT, CHU, COR, MEN, RNE, SJU, SFE, SDE, TUC) / CHL(ANT, ATA, COQ, VAL, LBO, MAU, BIO, LLA)
Sarcocornia perennis	PRY(BOQ)
Sarcocornia pulvinata	ARG(JUJ, SAL) / CHL(TAR, ANT)
Sarcodraba andina	ARG(LRI, SJU)
Sarcodraba dusenii	ARG(SCR) / CHL(MAG)
Sarcodraba karraikensis	ARG(SCR)
Sarcodraba subterranea	ARG(SCR)
Sarcoglottis acaulis	BRA(PAR, SCA)
Sarcoglottis alexandri	BRA(PAR)
Sarcoglottis biflora	BRA(RGS)
Sarcoglottis catharinensis	BRA(SCA)
Sarcoglottis fasciculata	ARG(MIS) / BRA(PAR) / PRY(GUA)
Sarcoglottis grandiflora	ARG(CHA, COS, FOR, JUJ, MIS) / BRA(PAR, SCA) / PRY(CAA)
Sarcoglottis homalogastra	ARG(MIS) / BRA(PAR)
Sarcoglottis magdalenensis	ARG(COS, MIS) / BRA(Fuera del área del proyecto)
Sarcoglottis tirolensis	PRY(ITA)
Sarcoglottis uliginosa	ARG(COS, MIS) / BRA(PAR, RGS, SCA) / PRY(AMA, CAU, CAN)
Sarcoglottis ventricosa	ARG(MIS) / BRA(Fuera del área del proyecto)
Sarcomphalus joazeiro	ARG(FOR) / BRA(Fuera del área del proyecto) / PRY(APY, CEN, CON, COA, ÑEE, SPE)
Sarcomphalus mistol	ARG(CAT, CHA, COR, COS, ERI, FOR, JUJ, LRI, SAL, SJU, SLU, SFE, SDE, TUC) / BRA(Fuera del área del proyecto) / PRY(APY, BOQ, CHO, CON, NAS, PHA)
Sarcorhachis schwackei	BRA(PAR)
Sarcotoxicum salicifolium	ARG(CHA, FOR, JUJ, SAL, SDE) / PRY(APY, BOQ, CHO, NAS, PHA)
Sarmienta scandens	CHL(COQ, MAU, BIO, ARA, LLA, AIS)
Sarracenella pubescens	BRA(PAR, RGS, SCA)
Sauroglossum nitidum	ARG(CAT, SDE) / BRA(RGS)
Sauroglossum sellilabre	ARG(JUJ, SAL, TUC) / PRY(COA)
Sauvagesia capillaris	BRA(PAR)
Sauvagesia erecta	ARG(COS, MIS) / BRA(PAR, RGS, SCA) / PRY(APA, AMA, CAU, CAN, COA, GUA, ITA, ÑEE, PHA, SPE)
Sauvagesia racemosa	ARG(MIS) / BRA(PAR) / PRY(APA, AMA, CAU, CAA, CAN, COA, SPE)
Sauvagesia vellozii	BRA(PAR, SCA)
Savia dictyocarpa	BRA(PAR, SCA)
Saxegothaea conspicua	ARG(CHU, NEU, RNE) / CHL(MAU, BIO, ARA, LLA)
Saxifraga magellanica	ARG(CHU, COR, JUJ, MEN, NEU, RNE, SLU, SCR, TDF) / CHL(MAU, BIO, ARA, AIS, MAG)
Saxifraga umbrosa	CHL(MAG)
Saxifragella bicuspidata	ARG(TDF) / CHL(MAG)
Saxifragodes albowiana	ARG(SCR, TDF) / CHL(AIS, MAG)
Scabiosa atropurpurea	ARG(BAI, COR, COS, ERI, JUJ, MEN, SAL, SFE, SJU, TUC) / CHL(ANT, COQ, VAL, MAU, BIO, ARA, RME, JFE) / URY(LAV, MON, PAY)
Scaevola plumierii	BRA(PAR, SCA)
Scandix pecten-veneris	ARG(ERI) / CHL(MAU, BIO, ARA, RME)
Scaphyglottis emarginata	BRA(PAR, SCA)
Scaphyglottis modesta	BRA(PAR, RGS, SCA)
Scaphyglottis reflexa	BRA(PAR)
Sceptridium australe	ARG(BAI, COR, SLU, TUC)
Sceptridium negeri	ARG(NEU, RNE)
Sceptridium schaffneri	ARG(CAT, JUJ, SAL, TUC)
Schaefferia argentinensis	ARG(BAI, CHA, COS, ERI, FOR, JUJ, MIS, SAL, SFE, TUC) / PRY(APY, CON, GUA, PHA, SPE) / URY(ART, RIV, SAO)
Schaueria azaleiflora	ARG(JUJ, SAL)
Schedonorus pratensis	ARG(BAI, DFE, MEN, RNE, SLU, TDF)
Schefflera angustissima	BRA(PAR, SCA)
Schefflera morototoni	ARG(CHA, COS, FOR, MIS) / BRA(PAR, RGS) / PRY(CAA, CAN)
Schickendantziella trichosepala	ARG(JUJ, SAL, TUC)
Schidorrhynchos andinum	ARG(CAT, LRI, SAL) / BRA(PAR, RGS, SCA)
Schindleria densiflora	PRY(CAN)
Schinopsis balansae	ARG(CHA, COS, ERI, FOR, SDE, SFE) / BRA(Fuera del área del proyecto) / PRY(APY, APA, CON, ÑEE, PAI, PHA, SPE)
Schinopsis boqueronensis	PRY(PHA)
Schinopsis brasiliensis	BRA(Fuera del área del proyecto) / PRY(APY)
Schinopsis cornuta	PRY(APY)
Schinopsis glabra	BRA(Fuera del área del proyecto) / PRY(APY)
Schinopsis heterophylla	ARG(CHA, FOR) / PRY(APY)
Schinopsis lorentzii	ARG(CAT, CHA, COR, FOR, JUJ, LRI, SAL, SFE, SDE, TUC) / PRY(APY, BOQ, CHO, NAS, PHA)
Schinus areira	ARG(CAT, COR, JUJ, LPA, LRI, MEN, MIS, SAL, SJU, SLU, TUC) / BRA(RGS) / CHL(TAR, ANT, ATA, COQ, VAL, RME) / PRY(APA, AMA, CEN, ITA) / URY(MON, PAY, SJO, TAC, TYT)
Schinus bumelioides	ARG(CAT, COR, ERI, JUJ, LRI, MEN, SAL, SDE, SFE, SJU, SLU, TUC)
Schinus engleri var. engleri	BRA(PAR, RGS, SCA) / URY(LAV, RIV, ROC, TAC)
Schinus engleri var. uruguayensis	ARG(BAI, COR, COS, ERI, SFE) / BRA(RGS) / URY(CAS, COL, FLA, LAV, MAL, PAY, RIV, ROC, SJO, SOR, TAC, TYT)
Schinus fasciculatus var. fasciculatus	ARG(BAI, CAT, CHA, CHU, COR, COS, ERI, FOR, JUJ, LPA, MEN, SAL, SJU, SFE, SDE, TUC) / PRY(APY, CEN, CON, ÑEE, PHA)
Schinus ferox	ARG(MIS) / BRA(RGS, SCA) / PRY(AMA) / URY(CLA)
Schinus gracilipes	ARG(CAT, JUJ, SAL, TUC)
Schinus johnstonii	ARG(BAI, CHU, COR, LPA, MEN, NEU, RNE, SJU, SLU, SCR, SDE)
Schinus kauselii	CHL(VAL, MAU, RME)
Schinus latifolius	CHL(COQ, VAL, LBO, MAU, RME)
Schinus lentiscifolius	ARG(MIS) / BRA(PAR, RGS, SCA) / PRY(AMA, SPE) / URY(CLA, LAV, MON, RIV, SOR, TAC, TYT)
Schinus longifolius var. paraguariensis	ARG(ERI) / PRY(AMA) / URY(ART, RIV, SAO)
Schinus longifolius var. longifolius	ARG(BAI, CHA, COR, COS, ERI, FOR, MIS, SFE, SLU) / BRA(PAR, RGS, SCA) / PRY(AMA, CEN, CON, ITA) / URY(ART, CAS, CLA, COL, DUR, FLA, LAV, MON, PAY, RNO, RIV, ROC, SAO, SJO, SOR, TAC, TYT)
Schinus marchandii	ARG(CHU, NEU, RNE, SCR) / CHL(AIS)
Schinus meyeri	ARG(SAL)
Schinus molle var. rusbyi	CHL(TAR)
Schinus molle var. molle	ARG(BAI, COR, COS, ERI, JUJ, MIS, SAL, SFE) / BRA(PAR, RGS) / CHL(TAR, ANT, ATA) / PRY(CAU, GUA, ITA, MIE) / URY(ART, CLA, LAV, PAY, RNO, RIV, ROC, SAO, TAC, TYT)
Schinus montanus	CHL(VAL, LBO, RME)
Schinus myrtifolius	ARG(JUJ, SAL)
Schinus odonellii	ARG(MEN, NEU, RNE) / CHL(MAG)
Schinus patagonicus var. crenuloides	CHL(MAU, BIO, ARA)
Schinus patagonicus var. patagonicus	ARG(CHU, MEN, NEU, RNE) / CHL(MAU, BIO, ARA, LLA, AIS)
Schinus pearcei	CHL(ATA)
Schinus piliferus var. piliferus	ARG(CAT, COR, JUJ, LRI, SAL, SDE, SLU, TUC)
Schinus piliferus var. boliviensis	ARG(CAT, COR, JUJ, LRI, SAL, SDE, TUC)
Schinus piliferus var. cabrerae	ARG(CAT, SAL, TUC)
Schinus polygamus var. polygamus	ARG(LRI, MEN, SJU) / CHL(ATA, COQ, VAL, LBO, MAU, BIO, ARA, LLA, RME)
Schinus polygamus var. parviflorus	CHL(ATA, COQ, VAL, MAU, BIO, ARA, LLA, RME)
Schinus praecox	ARG(COR, LPA, SLU)
Schinus ramboi	BRA(RGS)
Schinus roigii	ARG(CHU, MEN, NEU, RNE)
Schinus sinuatus	ARG(COS, ERI, SFE)
Schinus spinosus	BRA(PAR)
Schinus terebinthifolius var. acutifolius	ARG(MIS) / BRA(PAR, SCA) / PRY(CAA, COA, PAI)
Schinus terebinthifolius var. terebinthifolius	BRA(PAR, RGS, SCA) / PRY(APA, AMA, CAA, CAN)
Schinus terebinthifolius var. rhoifolius	BRA(PAR)
Schinus terebinthifolius var. pohlianus	ARG(COS, MIS) / BRA(PAR, RGS, SCA) / PRY(APA, CAU, CAA, CAN, CEN, GUA, ITA, MIE, SPE)
Schinus velutinus	CHL(VAL, LBO, MAU, RME)
Schinus venturii	ARG(SAL)
Schinus weinmannifolius var. dubius	ARG(COS, MIS) / BRA(RGS) / PRY(COA, GUA, PAI) / URY(CLA, DUR, MAL, MON, PAY, RIV, SAO, SJO, TAC)
Schinus weinmannifolius var. hassleri	PRY(AMA, CAU, CAA, CAN, CON, SPE)
Schinus weinmannifolius var. riedelianus	ARG(COS, ERI, MIS) / BRA(PAR, RGS) / PRY(AMA, CAU, CAN, CEN, COA, GUA, PAI, SPE) / URY(MAL, MON, PAY, SOR)
Schinus weinmannifolius var. weinmannifolius	ARG(COS, MIS) / BRA(PAR, RGS, SCA) / PRY(APA, APY, AMA, CAU, CAN, CEN, CON, COA, GUA, PAI, SPE) / URY(CAS, CLA, MAL, MON, PAY, SOR)
Schismus arabicus	ARG(BAI, CHU, LPA, MEN, NEU, RNE, SLU, SCR) / CHL(COQ, VAL)
Schismus barbatus	ARG(BAI, CHU, LPA, MEN, RNE) / CHL(COQ, VAL, RME)
Schistocarpha eupatorioides	ARG(JUJ, SAL)
Schistogyne mosenii	ARG(MIS) / BRA(PAR, RGS, SCA)
Schizachyrium bimucronatum	ARG(COS, ERI, MIS) / BRA(RGS) / PRY(AMA, CAU, CEN, COA, GUA, PAI, SPE)
Schizachyrium brevifolium	ARG(SAL)
Schizachyrium condensatum	ARG(BAI, CHA, COR, COS, DFE, ERI, FOR, JUJ, MIS, SAL, SLU, SFE, TUC) / BRA(PAR, RGS, SCA) / PRY(APA, AMA, CAU, CAN, GUA, PAI, PHA) / URY(MAL, RIV, TAC)
Schizachyrium glaziovii	ARG(CAT, CHA, COR, COS, ERI, FOR, JUJ, LPA, MIS, SAL, SLU, SFE, SDE, TUC) / BRA(PAR, RGS) / PRY(APA, APY, AMA, CAU, CAN, CON, GUA, MIE, PAI) / URY(ART, CLA, RIV, ROC, SAO, TAC)
Schizachyrium gracilipes	ARG(COS, MIS) / BRA(PAR, RGS, SCA) / PRY(APA, CEN, GUA, MIE) / URY(RIV, TAC)
Schizachyrium hatschbachii ssp. saltense	ARG(SAL)
Schizachyrium hatschbachii ssp. hatschbachii	ARG(MIS) / BRA(PAR, RGS, SCA)
Schizachyrium lactiflorum	ARG(COS) / BRA(PAR, RGS) / PRY(AMA, CAU, CAN, CEN, CON, COA, GUA, PAI, SPE)
Schizachyrium microstachyum	ARG(BAI, CAT, CHA, COR, COS, ERI, FOR, JUJ, LRI, MIS, SAL, SLU, SFE, SDE, TUC) / BRA(PAR, RGS, SCA) / PRY(APA, APY, AMA, BOQ, CAU, CAA, CAN, CEN, CON, COA, GUA, PAI, PHA) / URY(ART, CAS, CLA, COL, FLA, MAL, MON, RIV, ROC, SAO, SJO, TAC, TYT)
Schizachyrium paucispiculatum	ARG(JUJ, SAL, TUC)
Schizachyrium plumigerum	ARG(BAI, CHA, COR, COS, ERI, FOR, LPA, SAL, SLU, SFE, SDE, TUC) / BRA(RGS) / PRY(APY) / URY(ART, CAS, CLA, COL, MAL, MON, RIV, ROC, SJO, TAC)
Schizachyrium salzmannii var. aristatum	ARG(CAT, COR, COS, ERI, LRI, MIS, SLU, SDE) / BRA(RGS, SCA) / PRY(APA, AMA, CAU, COA, GUA, PAI, SPE) / URY(CAS, COL, LAV, MAL, MON, PAY, SAO, SJO, SJO, TAC, TYT)
Schizachyrium salzmannii var. salzmannii	BRA(Fuera del área del proyecto) / PRY(APA, AMA, CAU, CEN, CON, GUA)
Schizachyrium sanguineum	ARG(COR, COS, ERI, MIS, SAL, TUC) / BRA(PAR, RGS) / CHL(VAL, BIO, RME) / PRY(APA, APY, AMA, CAU, CEN, CON, COA, GUA, PAI) / URY(LAV, MAL, PAY, TAC, TYT)
Schizachyrium scabriflorum	ARG(COS, MIS) / BRA(RGS) / PRY(AMA, CEN, MIE, PAI)
Schizachyrium spicatum	ARG(BAI, CAT, COR, COS, ERI, FOR, JUJ, LPA, MEN, MIS, RNE, SAL, SJU, SLU, SFE, SDE, TUC) / BRA(PAR, RGS, SCA) / PRY(APY, AMA, BOQ, GUA) / URY(ART, CLA, CLA, FLA, LAV, MAL, MON, PAY, RNO, RIV, SAO, SJO, TAC)
Schizachyrium tenerum var. hirtiglume	ARG(COR, JUJ, SAL) / BRA(SCA)
Schizachyrium tenerum var. tenerum	ARG(COR, COS, ERI, JUJ, MIS, SAL, TUC) / BRA(PAR, RGS, SCA) / PRY(CAU, CEN, GUA, PAI) / URY(ART, CLA, LAV, PAY, RIV, TAC)
Schizaea elegans	BRA(PAR, SCA)
Schizaea fistulosa	ARG(TDF) / CHL(LLA, AIS, MAG)
Schizanthus alpestris	CHL(COQ, VAL, RME)
Schizanthus candidus	CHL(ATA, COQ)
Schizanthus grahamii	ARG(MEN, NEU) / CHL(VAL, LBO, MAU, BIO, RME)
Schizanthus hookeri	ARG(NEU) / CHL(COQ, VAL, LBO, MAU, BIO, ARA, RME)
Schizanthus integrifolius	CHL(ATA, COQ)
Schizanthus lacteus	CHL(ANT, ATA)
Schizanthus laetus	CHL(TAR, ANT, ATA)
Schizanthus litoralis	CHL(ANT, ATA, COQ, VAL)
Schizanthus parvulus	CHL(COQ)
Schizanthus pinnatus	CHL(COQ, VAL, LBO, MAU, BIO, ARA, LLA, RME)
Schizanthus porrigens	CHL(COQ, VAL, RME)
Schizanthus tricolor	CHL(VAL, RME)
Schizolobium parahyba	BRA(PAR, RGS, SCA)
Schizopetalon arcuatum	CHL(ATA)
Schizopetalon bipinnatifidum	CHL(ATA, COQ)
Schizopetalon biseriatum	CHL(ATA)
Schizopetalon brachycarpum	CHL(RME)
Schizopetalon corymbosum	CHL(COQ)
Schizopetalon dentatum	CHL(ATA, VAL, RME)
Schizopetalon maritimum	CHL(ATA, COQ)
Schizopetalon rupestre	ARG(LRI, MEN, SJU) / CHL(ATA, COQ)
Schizopetalon tenuifolium	CHL(ATA)
Schizopetalon walkeri	CHL(COQ, VAL)
Schkuhria degenerica	ARG(JUJ)
Schkuhria pinnata	ARG(BAI, CAT, CHA, COR, COS, ERI, JUJ, LPA, LRI, MEN, RNE, SAL, SJU, SLU, SFE, SDE, TUC) / CHL(COQ) / PRY(AMA, CEN) / URY(COL)
Schlechtendalia luzulaefolia	ARG(BAI, ERI) / BRA(PAR, RGS) / URY(CLA, LAV, MAL, MON, ROC)
Schlegelia parviflora	BRA(PAR, SCA)
Schnella angulosa	BRA(PAR, SCA)
Schnella microstachya	ARG(COS, MIS) / BRA(PAR, RGS, SCA) / PRY(APA, AMA, CAU, SPE)
Schoenoplectus americanus	ARG(BAI, CAT, CHU, COR, ERI, JUJ, LRI, MEN, RNE, SAL, SJU, SFE, TUC) / CHL(TAR, ANT, VAL, MAU, BIO, LLA) / URY(CAS, DUR, MON, SOR)
Schoenoplectus californicus var. tereticulmis	ARG(CAT, CHA, CHU, NEU, RNE, SCR) / CHL(LLA, AIS, MAG)
Schoenoplectus californicus var. spoliatus	ARG(CHU, MEN, NEU, RNE) / CHL(LLA, AIS)
Schoenoplectus californicus var. californicus	ARG(BAI, CAT, CHA, CHU, COR, COS, DFE, ERI, FOR, JUJ, LPA, MEN, NEU, RNE, SAL, SCR, SDE, SFE, SJU, SLU, TDF, TUC) / BRA(PAR, RGS, SCA) / CHL(TAR, ANT, ATA, COQ, VAL, LBO, MAU, BIO, ARA, AIS, MAG, RME, IPA) / PRY(APY, CEN, CHO, COA, ÑEE, PHA) / URY(CAS, CLA, COL, FLO, LAV, MON, SJO, SOR)
Schoenoplectus mucronatus	CHL(MAU, BIO)
Schoenoplectus pungens var. longispicatus	ARG(BAI, COR, DFE, ERI, LPA, RNE, SFE, SLU) / CHL(COQ) / URY(FLA)
Schoenoplectus pungens var. badius	ARG(BAI, CAT, CHU, COR, DFE, JUJ, MEN, SAL, SFE, TUC) / CHL(ATA, MAU, LLA) / URY(COL, FLA, MON, SJO, SOR)
Schoenoplectus pungens var. pungens	ARG(BAI, CAT, COR, ERI, JUJ, LRI, MEN, RNE, SAL, SJU, TUC) / CHL(TAR, ANT, ATA, COQ, VAL, MAU, BIO, LLA, RME)
Schoenoplectus supinus	ARG(COS) / BRA(SCA) / PRY(APY)
Schoenoplectus tabernaemontani	ARG(BAI, CHA, COR, COS, ERI, FOR, SAL, SDE, SFE, TUC) / BRA(SCA) / PRY(APY) / URY(COL, MON)
Schoenus andinus	ARG(CHU, NEU, RNE, SCR, TDF) / CHL(MAU, BIO, ARA, LLA, MAG)
Schoenus antarcticus	ARG(SCR, TDF) / CHL(AIS, MAG)
Schoenus lymansmithii	BRA(SCA)
Schoenus nigricans	URY(MON)
Schoenus nitens ssp. krausei	ARG(CHU) / CHL(BIO, LLA)
Schoenus rhynchosporoides	ARG(RNE, TDF) / CHL(MAU, LLA, AIS, MAG)
Schoepfia brasiliensis	ARG(MIS) / BRA(PAR, SCA)
Schoepfia lucida	BRA(SCA)
Schreiteria macrocarpa	ARG(TUC)
Schubertia grandiflora	ARG(CHA, COS, FOR, MIS, SFE) / BRA(Fuera del área del proyecto) / PRY(AMA, CAN, COA, MIE, ÑEE, PAI, SPE)
Schubertia schreiteri	ARG(JUJ, SAL) / PRY(PAI)
Schultesia australis	ARG(CHA, COS, FOR, MIS) / BRA(PAR, RGS, SCA) / PRY(AMA, CAU, CEN, GUA) / URY(RIV)
Schultesia guianensis	ARG(MIS) / PRY(COA)
Schultesia heterophylla	PRY(AMA)
Schwartzia brasiliensis	BRA(PAR, SCA)
Schwenckia americana var. angustifolia	BRA(Fuera del área del proyecto) / PRY(AMA)
Schwenckia americana var. americana	ARG(CHA, COS, FOR, JUJ, MIS, SAL) / BRA(PAR) / PRY(AMA, CAA, CEN, COA, PAI, PHA)
Schwenckia curviflora	BRA(PAR, RGS, SCA) / URY(MAL)
Schwenckia grandiflora	ARG(COS, MIS) / BRA(PAR)
Schwenckia juncoides	BRA(PAR) / PRY(CAN)
Schwendenera tetrapyxis	BRA(PAR)
Sciaphila schwackeana	BRA(SCA)
Scirpus angustisquamis	CHL(ARA, LLA)
Scirpus chubutensis	ARG(CHU, NEU)
Scirpus giganteus	ARG(BAI, CHA, COS, DFE, ERI, FOR) / BRA(RGS, SCA) / PRY(COA, PAI) / URY(CAS, COL, FLO, FLA, MON, RNO, ROC, SJO, SOR)
Scirpus melanocaulos	CHL(LBO, LLA)
Scirpus spegazzinianus	ARG(SCR) / CHL(MAG)
Scleranthus annuus	ARG(BAI, CHU, COR, LPA, NEU, RNE) / CHL(MAU, BIO, ARA) / URY(COL)
Scleria bracteata	BRA(PAR, SCA) / PRY(AMA)
Scleria ciliata	ARG(COS, ERI, MIS) / BRA(PAR, RGS, SCA) / PRY(ITA, SPE)
Scleria colorata	BRA(PAR)
Scleria composita	ARG(COS, MIS) / BRA(RGS) / PRY(CAU, CAA, CEN, GUA)
Scleria distans	ARG(COS, ERI, MIS) / BRA(PAR, RGS, SCA) / PRY(AMA, CAU, CAA, CAN, COA, GUA, MIE, PAI, PHA, SPE) / URY(CAS, COL, MAL, MON, RNO, ROC, SJO)
Scleria filiculmis	BRA(SCA)
Scleria flagellum-nigrorum	ARG(CHA, COS) / PRY(AMA, MIE, PHA)
Scleria lacustris	PRY(AMA)
Scleria latifolia	ARG(COS, MIS) / BRA(PAR, RGS, SCA) / PRY(APA, AMA, CAA, CAN, CEN, COA, GUA, MIE, PAI, SPE)
Scleria leptostachya	ARG(COS, MIS) / BRA(PAR, RGS, SCA) / PRY(APA, AMA, CAU) / URY(MON, PAY, RNO, ROC, SOR)
Scleria macrophylla	PRY(APY)
Scleria melaleuca	ARG(CHA, COS, FOR, MIS) / BRA(PAR, RGS, SCA) / PRY(APA, AMA, CAU, CAA, CAN, CEN, CON, COA, GUA, ITA, MIE, ÑEE, PAI, PHA, SPE)
Scleria melanomphala	ARG(MIS) / BRA(Fuera del área del proyecto) / PRY(APA, AMA, CAU, SPE)
Scleria microcarpa	BRA(SCA) / PRY(AMA, COA, SPE)
Scleria mitis	BRA(Fuera del área del proyecto) / PRY(AMA, CAN)
Scleria myricocarpa	BRA(PAR)
Scleria obtusa	PRY(CON)
Scleria panicoides	ARG(MIS) / BRA(PAR, RGS, SCA) / PRY(APA, CAN, COA, GUA, ITA)
Scleria plusiophylla	ARG(MIS) / BRA(PAR, RGS, SCA) / PRY(APA, AMA, CAU, CAA, CAN, CEN, CON, COA, GUA, ITA, PAI)
Scleria reticularis	ARG(COS, MIS) / BRA(RGS)
Scleria scabra	PRY(APY, AMA)
Scleria secans	ARG(MIS) / BRA(PAR, RGS, SCA) / PRY(APA, AMA, CAU, CAN, CEN, COA, GUA, PAI)
Scleria sellowiana	ARG(CHA, COS, ERI, FOR, MIS, SFE) / BRA(PAR, RGS, SCA) / PRY(APA, CAU, CAN, GUA, PAI) / URY(CAS, CLA, FLA, MON, PAY, RNO, SAO, SJO, TAC, TYT)
Scleria uleana	BRA(PAR, RGS, SCA)
Scleria variegata	ARG(MIS) / BRA(PAR)
Scleria virgata	BRA(Fuera del área del proyecto)
Sclerochloa dura	ARG(BAI)
Sclerophylax adnatifolia	ARG(CAT, JUJ, LRI, SAL, SJU, TUC)
Sclerophylax arnottii	ARG(CAT, LRI, MEN, SJU, SLU)
Sclerophylax caducifructus	ARG(CAT, SAL, SJU)
Sclerophylax cocuccii	ARG(CAT, LRI, SAL)
Sclerophylax cuyanus	ARG(MEN, SJU)
Sclerophylax cynocrambe	ARG(CAT, LRI)
Sclerophylax difulvioi	ARG(SLU)
Sclerophylax hunzikeri	ARG(COR, LRI)
Sclerophylax kurtzii	ARG(LRI, SJU, SLU)
Sclerophylax lorentzianus	ARG(COS, ERI) / URY(RNO)
Sclerophylax ruiz-lealii	ARG(MEN, SJU)
Sclerophylax spinescens	ARG(BAI, CHA, COR, COS, ERI, FOR, SFE) / PRY(APY, PHA)
Sclerophylax tenuicaulis	ARG(CAT, LRI, SAL, TUC)
Sclerophylax trispermus	ARG(CAT, CHA, COR, FOR, JUJ, LRI, SAL, SDE, SLU, TUC)
Scleropogon brevifolium	ARG(CAT, MEN, SAL, SJU)
Scolymus hispanicus	ARG(BAI, DFE, ERI, SFE) / CHL(VAL)
Scoparia aemilii	ARG(BAI, CHA, DFE, SFE) / PRY(APY, BOQ, COA, PHA)
Scoparia dulcis	ARG(CHA, COS, ERI, FOR, JUJ, MIS, SAL, SDE, SFE, TUC) / BRA(PAR, RGS, SCA) / PRY(APY, CAN, CEN, COA, ÑEE, PAI, PHA) / URY(ART, SAO)
Scoparia elliptica	BRA(PAR, SCA)
Scoparia ericacea	ARG(CHA, COS, ERI, FOR, JUJ, MIS, SAL, SFE, TUC) / BRA(RGS) / PRY(COA, PHA) / URY(ART, RNO, RIV, SOR, TAC)
Scoparia hassleriana	ARG(COS, MIS) / BRA(RGS) / PRY(CEN, COA, PAI)
Scoparia montevidensis	ARG(BAI, CAT, CHA, COR, COS, DFE, ERI, FOR, JUJ, LPA, MIS, SAL, SDE, SFE, SLU, TUC) / BRA(PAR, RGS, SCA) / PRY(APY, BOQ, CAU, CAA, CEN, CON, ÑEE, PHA) / URY(ART, CAS, CLA, COL, FLA, LAV, MAL, PAY, RNO, RIV, ROC, SAO, SJO, SOR, TAC, TYT)
Scoparia pinnatifida	BRA(PAR, SCA) / PRY(CEN, ÑEE)
Scoparia praedensa	ARG(SAL)
Scorzonera laciniata	ARG(BAI, SCR)
Scrophularia auriculata	CHL(MAU, ARA, RME)
Scutellaria breviflora	ARG(JUJ, MIS, SAL, TUC) / BRA(SCA)
Scutellaria eplingii	ARG(SAL)
Scutellaria nummulariifolia	ARG(CHU, RNE, SCR, TDF) / CHL(AIS, MAG)
Scutellaria platensis	ARG(BAI, ERI, MIS) / BRA(RGS, SCA) / URY(COL, SAO, SJO)
Scutellaria racemosa	ARG(BAI, CAT, CHA, COR, COS, ERI, FOR, JUJ, MEN, MIS, SAL, SDE, SFE, SLU, TUC) / BRA(PAR, RGS, SCA) / CHL(VAL, MAU, BIO, ARA, LLA, RME) / PRY(APY, CAU, CAN, CEN, CON, COA, ITA, MIE, ÑEE, PAI, PHA) / URY(ART, CAS, CLA, FLA)
Scutellaria uliginosa	ARG(MIS) / BRA(PAR, SCA) / PRY(CAN, CEN, PAI)
Scutellaria valdiviana	CHL(MAU, BIO, LLA)
Scutellaria woodii	ARG(JUJ, SAL)
Scutia arenicola	BRA(PAR, SCA)
Scutia buxifolia	ARG(BAI, CHA, COS, ERI, FOR, JUJ, MIS, SAL, SFE, TUC) / BRA(PAR, RGS, SCA) / URY(DUR, FLA, MAL, MON, PAY, RIV, ROC, SAO, SOR, TAC, TYT)
Scuticaria hadwenii	BRA(SCA)
Scyphanthus elegans	CHL(COQ, VAL, LBO, MAU, BIO, ARA, RME)
Sebastiania argutidens	BRA(RGS, SCA)
Sebastiania brasiliensis	ARG(BAI, CAT, CHA, COS, ERI, FOR, JUJ, MIS, SAL, SFE, TUC) / BRA(PAR, RGS, SCA) / PRY(APA, APY, AMA, CAU, CAA, CAN, CEN, CHO, CON, COA, GUA, ITA, ÑEE, PAI, PHA, SPE) / URY(MAL, PAY, RIV, SAO, SOR, TAC)
Sebastiania commersoniana	ARG(BAI, COR, COS, ERI, JUJ, MIS, SAL, TUC) / BRA(PAR, RGS, SCA) / PRY(APA, CAA, CAN, COA, ÑEE, PAI) / URY(COL, CLA, MAL, PAY, RIV, ROC, SAO, SJO, TAC, TYT)
Sebastiania edwalliana	BRA(Fuera del área del proyecto) / PRY(COA, GUA, PAI)
Sebastiania longispicata	PRY(AMA)
Sebastiania pachyphylla	PRY(CAN)
Sebastiania pusilla	URY(ART, PAY, SAO)
Sebastiania schottiana	ARG(BAI, COS, ERI, MIS) / BRA(PAR, RGS, SCA) / PRY(CAU, CAN, PAI) / URY(PAY, RIV, ROC, SAO, SOR)
Sebastiania serrata	ARG(FOR, MIS) / BRA(PAR, RGS) / PRY(AMA, CAA, CEN, COA, PAI) / URY(COL, RIV, SAO, TAC)
Sebastiania serrulata	BRA(Fuera del área del proyecto) / PRY(AMA, ITA, PAI, SPE) / URY(RIV, TAC)
Sebastiania subsessilis	ARG(MIS) / BRA(PAR) / PRY(CAA)
Sebastiania subulata	BRA(Fuera del área del proyecto) / PRY(COA, PAI)
Sebastiania ypanemensis	BRA(Fuera del área del proyecto) / PRY(PAI)
Secondatia densiflora	BRA(Fuera del área del proyecto) / PRY(AMA, CAN)
Securidaca lanceolata	BRA(PAR, RGS, SCA) / PRY(APA, PAI, SPE)
Securidaca macrocarpa	BRA(PAR, SCA)
Securidaca ovalifolia	ARG(SAL) / BRA(Fuera del área del proyecto) / PRY(AMA, CON, COA, GUA, PAI)
Securidaca rivinaefolia	BRA(PAR)
Sedum acre	ARG(CHU, NEU, RNE, SCR, TDF) / CHL(ARA, LLA, MAG)
Sedum cymatopetalum	ARG(CAT, COR, JUJ, LRI, MEN, SAL, SJU, SLU, TUC)
Sedum jujuyense	ARG(JUJ)
Sedum thartii	ARG(COR)
Seemannia gymnostoma	ARG(CAT, JUJ, SAL, TUC)
Seemannia nematanthodes	ARG(JUJ, SAL)
Seguieria aculeata	ARG(CHA, COS, FOR, JUJ, MIS, SAL) / BRA(PAR, RGS, SCA) / PRY(APA, AMA, CAU, CAN, CEN, CON, COA, GUA, ÑEE, PAI, PHA, SPE)
Seguieria americana	BRA(Fuera del área del proyecto) / PRY(Desconocida)
Seguieria langsdorffii	BRA(PAR, SCA)
Seguieria paraguayensis	ARG(CHA, COS, FOR) / BRA(Fuera del área del proyecto) / PRY(CEN, COA, PAI)
Selaginella apoda	CHL(LLA)
Selaginella contigua	BRA(PAR, SCA)
Selaginella convoluta	ARG(SAL) / BRA(Fuera del área del proyecto) / PRY(APY, COA, PAI)
Selaginella decomposita	BRA(PAR, RGS, SCA)
Selaginella erectifolia	BRA(SCA)
Selaginella flexuosa	BRA(PAR, SCA)
Selaginella kraussiana	BRA(RGS, SCA)
Selaginella macrostachya	BRA(SCA)
Selaginella marginata	ARG(BAI, COS, ERI, MIS) / BRA(PAR, RGS, SCA) / PRY(APA, CAU, CAN, GUA) / URY(ART, LAV, MAL, MON, RIV, TAC)
Selaginella microphylla	ARG(CAT, COR, JUJ, LRI, MIS, SAL, SLU, SDE, TUC) / BRA(RGS, SCA) / PRY(COA, PAI) / URY(LAV, TYT)
Selaginella muscosa	ARG(BAI, COS, ERI, MIS, SFE) / BRA(PAR, RGS, SCA) / PRY(CAN, PAI) / URY(MON, RNO)
Selaginella novae-hollandiae	ARG(CAT, JUJ, SAL, TUC)
Selaginella parviarticulata	PRY(PAI)
Selaginella peruviana	ARG(BAI, CHA, COR, JUJ, LRI, MEN, SAL, SLU, TUC)
Selaginella sellowii	ARG(CHA, COR, COS, ERI, JUJ, LRI, MIS, SAL, SLU, SFE, SDE, TUC) / BRA(RGS) / PRY(APY, COA, PHA) / URY(COL, MAL, MON)
Selaginella suavis	BRA(SCA)
Selaginella sulcata	ARG(MIS, SAL, TUC) / BRA(PAR, RGS, SCA) / PRY(APA, CAN, MIE)
Selaginella tenuissima	BRA(RGS, SCA)
Selaginella valida	BRA(PAR)
Selenicereus setaceus	BRA(PAR) / PRY(APY, AMA, CEN, CON, PAI, PHA)
Selkirkia berteroi	CHL(JFE)
Selliera radicans	CHL(ATA, COQ, VAL, LBO, MAU, BIO, ARA, LLA, AIS, RME)
Sellocharis paradoxa	BRA(RGS)
Semialarium paniculatum	BRA(PAR) / PRY(AMA, CAN, CON, COA, PHA, SPE)
Senecio × lulioi	ARG(BAI, COS, ERI)
Senecio acanthifolius	ARG(CHU, NEU, RNE, SCR, TDF) / CHL(LLA, AIS, MAG)
Senecio achalensis	ARG(COR)
Senecio adamantinus	BRA(PAR, SCA)
Senecio adenophyllus	ARG(JUJ, SAL) / CHL(TAR, ANT)
Senecio adenotrichius	CHL(COQ, VAL, RME)
Senecio adrianicus	ARG(MEN, SJU)
Senecio alcicornis	CHL(ATA, COQ)
Senecio algens	ARG(CAT, JUJ, SAL, SJU, TUC) / CHL(TAR, ANT)
Senecio alloeophyllus var. glaberrimus	ARG(SCR, TDF)
Senecio alloeophyllus var. alloephyllus	ARG(SCR, TDF) / CHL(MAG)
Senecio almeidae	CHL(ANT, ATA)
Senecio altoandinus	ARG(JUJ)
Senecio ambatensis	ARG(CAT)
Senecio ameghinoi	ARG(CHU)
Senecio anconquijae f. discoideus	ARG(TUC)
Senecio anconquijae f. anconquijae	ARG(CAT, TUC)
Senecio angulatus	ARG(BAI, DFE, SDE)
Senecio angustissimus	ARG(CHU, NEU, RNE) / CHL(MAU, BIO, ARA)
Senecio anthemidiphyllus	ARG(LRI, MEN, SJU) / CHL(ATA, COQ, VAL, LBO, BIO, RME)
Senecio antofagastanus	CHL(ANT)
Senecio apensis	PRY(AMA, CAU, CAN, CON)
Senecio aquaticus ssp. barbareifolius	CHL(ARA)
Senecio aquilaris	ARG(JUJ)
Senecio arechavaletae	ARG(BAI) / URY(MON, ROC)
Senecio argillosus	URY(MON)
Senecio argophylloides var. rupestris	ARG(CAT, LRI)
Senecio argophylloides var. argophylloides	ARG(CAT, LRI, SAL, TUC)
Senecio argyreus	ARG(CHU, NEU, RNE, SCR, TDF) / CHL(BIO, ARA, LLA, AIS, MAG)
Senecio aristianus	CHL(COQ, VAL)
Senecio arleguianus	CHL(COQ)
Senecio arnicoides	CHL(VAL, LBO, BIO, ARA, LLA, RME)
Senecio arnottii	ARG(NEU, SCR, TDF) / CHL(LLA, MAG)
Senecio aspericaulis	ARG(MEN, NEU) / CHL(MAU, BIO)
Senecio asplenifolius	ARG(CAT, LRI, MEN, TUC)
Senecio atacamensis	ARG(CAT, LRI, SAL) / CHL(TAR, ANT)
Senecio australandinus	ARG(SCR)
Senecio baccharidifolius	ARG(NEU) / CHL(MAU, BIO, ARA, LLA)
Senecio bahioides	CHL(ATA, COQ, VAL, RME)
Senecio balsamicus	CHL(ATA)
Senecio barbarae	ARG(JUJ, SAL) / CHL(ANT)
Senecio barrosianus	CHL(MAU)
Senecio beaufilsii	ARG(CHU, NEU, SCR) / CHL(MAG)
Senecio behnii	CHL(TAR)
Senecio belenensis	ARG(CAT)
Senecio benaventianus	CHL(COQ)
Senecio bergii	ARG(BAI, CHU, NEU, RNE)
Senecio berteroi	CHL(JFE)
Senecio boelckei	ARG(CHU, NEU, RNE, SCR)
Senecio bonariensis	ARG(BAI, CAT, CHA, COR, COS, DFE, ERI, JUJ, MEN, SJU, SLU, SFE) / BRA(RGS, SCA) / URY(CAS, CLA, COL, FLO, FLA, MON, SJO, SOR)
Senecio botijae	CHL(ANT)
Senecio brachycodon	BRA(PAR)
Senecio brachylobus	CHL(ATA, COQ)
Senecio bracteolatus var. valderramae	ARG(CHU, NEU, RNE) / CHL(BIO, ARA, LLA, MAG)
Senecio bracteolatus var. luteus	ARG(NEU)
Senecio bracteolatus var. bracteolatus	ARG(CHU, NEU, RNE, SCR) / CHL(ARA)
Senecio brasiliensis var. incanus	ARG(CHA) / URY(MAL, MON)
Senecio brasiliensis var. brasiliensis	ARG(CHA, COS, MIS, SFE) / BRA(PAR, RGS, SCA) / PRY(APA, CAU, CAA, CAN, ITA, MIE) / URY(MAL, MON)
Senecio brasiliensis var. tripartitus	ARG(BAI, COS, ERI, MIS, SFE) / BRA(RGS) / PRY(APA, CAU, CAA, CAN, ITA, MIE) / URY(CAS, COL, MAL, MON, SJO, SOR)
Senecio bravensis	ARG(BAI)
Senecio breviscapus	ARG(CAT, JUJ, LRI, MEN, SAL, SJU, TUC) / CHL(TAR, ANT, ATA, COQ, VAL, RME)
Senecio bridgesii	CHL(COQ, VAL, RME)
Senecio brunonianus	CHL(ATA, COQ, VAL)
Senecio buglossus	CHL(BIO, ARA, LLA)
Senecio burkartii	ARG(CAT, SAL, TUC)
Senecio bustillosianus var. borchersii	CHL(VAL, RME)
Senecio bustillosianus var. bustillosianus	CHL(VAL, LBO, RME)
Senecio cachinalensis var. cachinalensis	CHL(ANT, ATA)
Senecio cachinalensis var. copiapinus	CHL(ATA)
Senecio cajonensis	ARG(CAT)
Senecio calchaquinus	ARG(TUC)
Senecio calingastensis	ARG(SJU)
Senecio calocephalus	CHL(BIO, ARA, LLA)
Senecio canchahuinganquensis	ARG(NEU)
Senecio candidans	ARG(TDF) / CHL(BIO, LLA, AIS, MAG)
Senecio candollei	ARG(CAT, JUJ, LRI, SAL, TUC) / CHL(TAR)
Senecio caparoënsis	BRA(SCA)
Senecio carbonensis	ARG(RNE)
Senecio catamarcensis	ARG(CAT, JUJ, LRI, SAL)
Senecio ceratophylloides	ARG(BAI, COR, LPA, RNE, SLU) / BRA(RGS) / URY(CAS, MAL, MON)
Senecio cerberoanus var. lanatus	CHL(COQ)
Senecio cerberoanus var. cerberoanus	CHL(ATA, COQ, VAL)
Senecio chamomillifolius	CHL(ATA)
Senecio chañaralensis	CHL(ATA, COQ)
Senecio chilensis f. discoideus	ARG(CHU, NEU) / CHL(MAU)
Senecio chilensis var. chilensis	ARG(CHU, NEU, RNE) / CHL(VAL, MAU, BIO, ARA, LLA, RME)
Senecio chilensis var. argophyllus	ARG(NEU) / CHL(MAU, BIO, ARA)
Senecio chillanensis	CHL(BIO, ARA)
Senecio chionophilus	ARG(CHU, NEU, RNE, SCR) / CHL(BIO, ARA, LLA)
Senecio chipauquilensis	ARG(RNE)
Senecio chrysanthemum	ARG(SCR)
Senecio chrysanthemum var. discoideus	ARG(SCR)
Senecio chrysocomoides	ARG(CHU, SCR) / CHL(AIS)
Senecio chrysolepis	ARG(CAT, SAL, SJU) / CHL(ANT, ATA)
Senecio cisplatinus	ARG(COS, ERI, MIS) / BRA(RGS) / URY(RIV)
Senecio clarioneifolius	ARG(MEN) / CHL(COQ, VAL, LBO, MAU, RME)
Senecio clivicola var. pampae	ARG(CAT, JUJ, SAL, TUC)
Senecio clivicola var. clivicola	ARG(JUJ, SAL)
Senecio coluhuapiensis	ARG(CHU)
Senecio comberi	ARG(NEU)
Senecio conyzaefolius	BRA(RGS, SCA)
Senecio coquimbensis	CHL(COQ)
Senecio corcovadensis	ARG(CHU)
Senecio coronopodiphyllus	ARG(MEN) / CHL(COQ, LBO, RME)
Senecio corrugatus	CHL(JFE)
Senecio coscayanus	CHL(TAR)
Senecio covasii	ARG(MEN, NEU) / CHL(MAU, RME)
Senecio covuncensis	ARG(NEU)
Senecio crassiflorus var. maritimus	BRA(RGS, SCA) / URY(MON, ROC)
Senecio crassiflorus var. crassiflorus	ARG(BAI, COR, ERI) / BRA(RGS, SCA) / URY(CAS, COL, MAL, MON, ROC, SJO)
Senecio crassiflorus var. subceratophyllus	BRA(RGS) / URY(CAS, MAL, MON)
Senecio cremeiflorus	ARG(CAT, JUJ, SAL, TUC)
Senecio cremnicola	ARG(LRI)
Senecio cremnophilus	ARG(SJU)
Senecio crepidifolius	ARG(CAT, SAL, SJU)
Senecio crepidioides	CHL(ATA, COQ, VAL)
Senecio crithmoides	ARG(CHU, MEN, NEU, RNE, SJU) / CHL(COQ, VAL, MAU, BIO, ARA, LLA, RME)
Senecio crusoei	CHL(JFE)
Senecio cryptocephalus	ARG(CHU, SCR)
Senecio ctenophyllus	CHL(TAR, ANT)
Senecio cumingii var. bracteosus	CHL(COQ, VAL)
Senecio cumingii var. cumingii	CHL(COQ, VAL, RME)
Senecio cuneatus	ARG(SCR) / CHL(AIS, MAG)
Senecio cylindrocephalus	ARG(CAT, LRI, SAL, SJU, TUC)
Senecio darwinii	ARG(NEU, TDF) / CHL(LLA, AIS, MAG)
Senecio davilae	CHL(VAL, RME)
Senecio deferens	ARG(CAT, FOR, JUJ, LRI, SAL, SDE, TUC) / PRY(APY, BOQ, PHA)
Senecio delicatulus	ARG(CAT)
Senecio depressus	ARG(MEN, NEU) / CHL(LBO, MAU)
Senecio desiderabilis	BRA(PAR, RGS, SCA)
Senecio desideratus	ARG(SCR)
Senecio diaguita	ARG(LRI, SAL, SJU)
Senecio dichotomus	CHL(ANT)
Senecio diemii	ARG(CHU, NEU, RNE)
Senecio digitatus	ARG(JUJ, SAL) / CHL(TAR, ANT)
Senecio divaricoides	ARG(NEU)
Senecio donianus	ARG(MEN, SJU) / CHL(COQ, VAL, RME)
Senecio dryophyllus	ARG(JUJ, SAL) / CHL(TAR, ANT)
Senecio eightsii	ARG(TDF)
Senecio elquiensis	CHL(COQ)
Senecio epiphyticus	ARG(JUJ, SAL)
Senecio eriophyton	ARG(LRI, MEN, SJU) / CHL(ANT, ATA, COQ)
Senecio erraticus	CHL(LLA)
Senecio eruciformis var. brachycephalus	ARG(MEN, NEU) / CHL(COQ, VAL, MAU, RME)
Senecio eruciformis var. eruciformis	ARG(MEN) / CHL(COQ, VAL, MAU, BIO, RME)
Senecio espinosae	CHL(MAU)
Senecio evacoides	ARG(JUJ, SAL)
Senecio evenius	CHL(JFE)
Senecio expansus	ARG(JUJ, SAL)
Senecio fabrisii	ARG(CAT, SAL)
Senecio famatinensis	ARG(LRI)
Senecio farinifer	CHL(COQ, VAL, MAU, RME)
Senecio ferruglii	ARG(CHU)
Senecio filaginoides var. lobulatus	ARG(CAT, CHU, JUJ, LPA, LRI, MEN, NEU, RNE, SAL, SJU, SCR, TUC)
Senecio filaginoides	ARG(BAI, CAT, CHU, COR, JUJ, LPA, LRI, MEN, NEU, RNE, SAL, SJU, SLU, SCR, TDF, TUC) / CHL(BIO, MAG)
Senecio fistulosus var. fistulosus	ARG(CHU, MEN) / CHL(COQ, VAL, LBO, MAU, BIO, ARA, LLA, AIS, RME)
Senecio fistulosus var. ochroleucus	ARG(CHU, MEN, NEU) / CHL(COQ, VAL, BIO, LLA)
Senecio flagellifolius	ARG(CAT, SAL, TUC)
Senecio fragantissimus	ARG(SLU)
Senecio francisci	ARG(MEN) / CHL(COQ, VAL, LBO, MAU, RME)
Senecio friesii	ARG(JUJ, SAL, SJU)
Senecio ganganensis	ARG(CHU, NEU, SJU)
Senecio garaventai	CHL(COQ, VAL)
Senecio gayanus	CHL(LBO, MAU, RME)
Senecio gilliesii var. dasycarpus	ARG(CHU, RNE)
Senecio gilliesii var. gilliesii	ARG(CHU, MEN, NEU, RNE) / CHL(LBO, MAU, BIO)
Senecio glaber	ARG(CHU, MEN, NEU, RNE) / CHL(COQ, VAL, LBO, MAU, BIO, ARA, LLA, AIS, RME)
Senecio glabratus	CHL(ATA, COQ, VAL)
Senecio glandulifer	ARG(CHA, COS, ERI, FOR)
Senecio glandulosus	ARG(CAT, MEN)
Senecio gnidioides var. gilvus	ARG(NEU, RNE) / CHL(BIO, ARA, LLA)
Senecio gnidioides var. gnidioides	ARG(MEN, NEU, RNE, SCR) / CHL(BIO, ARA, MAG)
Senecio goldsackii	ARG(BAI, CHU, COR, LPA, MEN, NEU, RNE, SJU, SLU)
Senecio grandis	BRA(PAR)
Senecio grandjotii	ARG(MEN) / CHL(RME)
Senecio grindeliifolius	ARG(MEN) / CHL(RME)
Senecio grossidens	BRA(PAR, SCA) / PRY(PAI, PHA)
Senecio gunckelii	CHL(LBO, MAU, RME)
Senecio haenkeanus	CHL(TAR)
Senecio haenkei	ARG(SAL, SJU) / CHL(ANT, ATA, COQ)
Senecio hakeifolius var. vidalii	CHL(ATA, COQ)
Senecio hakeifolius var. hakeifolius	CHL(COQ, VAL, LBO, RME)
Senecio haloragis var. glandulosus	CHL(MAU)
Senecio haloragis var. haloragis	CHL(LBO, MAU, BIO)
Senecio hatcherianus	ARG(NEU, RNE, SCR)
Senecio helgae	ARG(JUJ, SAL) / CHL(ANT)
Senecio hemmendorffii	BRA(PAR, SCA)
Senecio heteroschizus	BRA(RGS) / URY(PAY)
Senecio heterotrichus	ARG(BAI, COS, ERI, MIS, SFE) / BRA(RGS, SCA) / URY(ART, CAS, COL, MAL, MON, RIV)
Senecio hickenii	ARG(MEN, SJU) / CHL(COQ, VAL)
Senecio hieracium	ARG(CHU, NEU, RNE) / CHL(MAU, BIO, ARA, LLA, AIS, MAG)
Senecio hieronymi	ARG(CAT, CHA, COR, JUJ, LRI, MEN, SAL, SJU, TUC) / PRY(APA, CAN, CEN, PAI)
Senecio hilairianus	BRA(SCA)
Senecio hirsutulus	CHL(COQ, VAL)
Senecio hirtus	CHL(ANT, ATA)
Senecio hjertingii	ARG(MEN)
Senecio hoehnei	BRA(PAR)
Senecio hualtaranensis	ARG(LRI, SLU)
Senecio huitrinicus	ARG(NEU)
Senecio humifusus	ARG(TDF) / CHL(MAG)
Senecio humillimus	ARG(JUJ) / CHL(TAR)
Senecio icoglossoides	URY(CAS, MON, SJO, SOR)
Senecio icoglossus var. icoglossus	BRA(PAR, RGS, SCA) / URY(SAO)
Senecio icoglossus var. splendens	ARG(COS, ERI, MIS) / BRA(RGS) / PRY(COA, PAI)
Senecio illapelinus	ARG(SJU) / CHL(COQ, VAL)
Senecio illinitus	CHL(ANT, COQ, VAL, MAU, RME)
Senecio infimus	ARG(JUJ, SAL)
Senecio invalidus	CHL(LBO)
Senecio irgangii	BRA(RGS)
Senecio isernii	CHL(ATA, COQ)
Senecio jacobeiformis	CHL(ANT, COQ)
Senecio jaffuelii	ARG(MEN, SJU) / CHL(RME)
Senecio jarae	ARG(CAT, JUJ, LRI, MEN, SAL, SJU, TUC) / CHL(TAR, ANT)
Senecio jilesii	CHL(COQ)
Senecio jobii	ARG(MEN, NEU, SCR)
Senecio johnstonianus	CHL(ATA)
Senecio jorquerae	CHL(ATA)
Senecio jujuyensis	ARG(JUJ)
Senecio julianus	ARG(SCR)
Senecio jungei	CHL(COQ)
Senecio jürgensii	BRA(PAR, RGS, SCA)
Senecio keshua	ARG(JUJ, SAL)
Senecio kingii var. kingii	ARG(CHU, MEN, NEU, RNE, SJU, SCR, TDF) / CHL(VAL, LBO, MAU, BIO, ARA, LLA, AIS, MAG, RME)
Senecio krapovickasii	ARG(LRI)
Senecio kunturinus	ARG(SAL, TUC)
Senecio laetevirens	ARG(MEN) / CHL(VAL, RME)
Senecio laevicaulis	CHL(LBO, MAU, RME)
Senecio landbeckii	CHL(LBO, MAU)
Senecio langei	BRA(PAR, SCA)
Senecio lanifer	BRA(PAR, SCA) / PRY(AMA, CAU, PAI)
Senecio lanosissimus	ARG(LRI, SJU)
Senecio laseguei	ARG(SCR, TDF) / CHL(MAG)
Senecio lastarrianus	CHL(LBO, MAU, BIO)
Senecio laucanus	CHL(TAR)
Senecio leptocaulos	CHL(ATA, COQ, VAL, LBO)
Senecio leptolobus	BRA(RGS, SCA) / URY(CLA, TAC, TYT)
Senecio leptoschizus	BRA(PAR, SCA)
Senecio leucomallus var. incisus	ARG(SCR, TDF) / CHL(MAG)
Senecio leucomallus var. leucomallus	ARG(SCR, TDF) / CHL(MAG)
Senecio leucopeplus	ARG(BAI)
Senecio leucophyton	ARG(NEU) / CHL(MAU)
Senecio leucostachys	ARG(CAT, CHU, COR, LPA, LRI, MEN, NEU, RNE, SJU)
Senecio leucus	ARG(SAL)
Senecio lilloi	ARG(LRI)
Senecio limosus	BRA(PAR, SCA)
Senecio linaresensis	CHL(MAU)
Senecio linariifolius var. linariifolius	ARG(CHU, MEN, NEU, RNE) / CHL(LBO, MAU, BIO, ARA)
Senecio linariifolius var. subtomentosus	ARG(RNE)
Senecio linariifolius var. aclonetus	CHL(MAU, BIO)
Senecio linariifolius var. heliophytoides	ARG(CHU, NEU) / CHL(MAU, ARA, LLA, AIS, RME)
Senecio linearilobus	BRA(PAR)
Senecio lithostaurus	ARG(MEN, NEU) / CHL(RME)
Senecio littoralis	ARG(TDF)
Senecio looseri	ARG(MEN, SJU) / CHL(COQ, VAL, RME)
Senecio lorentziella	ARG(LRI, MEN, SJU) / CHL(COQ, VAL, RME)
Senecio lorentzii	ARG(CAT, JUJ, SAL, TUC)
Senecio luridus	CHL(ATA)
Senecio maculatus	ARG(CAT, SAL, TUC)
Senecio madagascariensis	ARG(BAI, COR, COS, DFE, ERI, FOR, JUJ, LPA, MEN, SAL, SFE, SDE, TUC) / BRA(RGS) / URY(CAS, MON, RNO, ROC, SAO)
Senecio madariagae	CHL(TAR, ANT)
Senecio maeviae	ARG(MEN, NEU)
Senecio magellanicus	ARG(SJU, SCR, TDF) / CHL(AIS, MAG)
Senecio manguensis	ARG(MEN, SJU)
Senecio mapuche	CHL(VAL, RME)
Senecio martinensis	ARG(CHU, RNE, SCR) / CHL(AIS, MAG)
Senecio masafuerae	CHL(JFE)
Senecio masatierrae	CHL(JFE)
Senecio mattfeldianus	BRA(SCA) / URY(CAS, MAL, MON)
Senecio maulinus	CHL(MAU)
Senecio megaoreinus	ARG(RNE)
Senecio melanopotamicus	ARG(BAI, CHU, LPA, MEN, RNE)
Senecio mesembrynus	CHL(AIS, MAG)
Senecio microcephalus var. angustifolius	ARG(NEU, RNE) / CHL(LLA)
Senecio microcephalus var. microcephalus	ARG(MEN, NEU, RNE) / CHL(LLA)
Senecio microphyllus	ARG(MEN, SJU) / CHL(COQ, VAL, LBO, MAU, RME)
Senecio micropifolius	CHL(ANT, ATA, COQ)
Senecio microtis	CHL(ATA)
Senecio minutifolius	CHL(ATA, COQ, VAL, RME)
Senecio miser	ARG(CHU, RNE, SCR, TDF) / CHL(MAG)
Senecio montevidensis	ARG(BAI, CAT, COR, ERI, LPA, RNE, SAL, SJU, SLU, SFE, TUC) / BRA(RGS) / URY(CAS, MON)
Senecio monttianus	CHL(COQ, LBO, MAU, RME)
Senecio munnozii	CHL(COQ)
Senecio murinus	CHL(ATA, COQ, VAL)
Senecio murorum	CHL(COQ, RME)
Senecio mustersii var. dentatus	ARG(RNE, SCR)
Senecio mustersii var. mustersii	ARG(CHU, RNE, SCR)
Senecio myriophyllus	CHL(ANT, ATA, COQ)
Senecio neaei var. neaei	ARG(CHU, MEN, NEU, RNE, SCR) / CHL(BIO, ARA, AIS)
Senecio neaei var. incisus	ARG(CHU, MEN, SCR) / CHL(MAG)
Senecio nemiae	ARG(RNE)
Senecio niederleinii	ARG(LRI)
Senecio nigrescens	CHL(MAU, BIO)
Senecio nublensis	CHL(BIO, ARA)
Senecio nutans	ARG(CAT, JUJ, LRI, SAL, TUC) / CHL(TAR, ANT)
Senecio obesus	ARG(MEN, NEU, RNE)
Senecio obtectus	ARG(MEN) / CHL(LBO, RME)
Senecio octolepis var. saltensis	ARG(CAT, JUJ, SAL, SJU, TUC)
Senecio octolepis var. octolepis	ARG(CAT, JUJ, SAL)
Senecio odonellii	ARG(MEN)
Senecio oleosus	BRA(PAR, SCA)
Senecio oligoleucus	URY(MON)
Senecio oligophyllus	BRA(RGS, SCA) / PRY(AMA)
Senecio olivaceobracteatus	CHL(TAR, ANT)
Senecio oreinus	ARG(MEN, SJU) / CHL(ATA, COQ)
Senecio oreophilus	BRA(SCA)
Senecio oreophyton	ARG(CAT, LRI, MEN, SAL, SJU) / CHL(ANT, ATA, COQ)
Senecio ostenii var. balaenicus	URY(MAL)
Senecio ostenii var. ostenii	ARG(BAI) / URY(MAL)
Senecio otaeguianus	CHL(VAL)
Senecio otites	ARG(CHU, NEU, RNE) / CHL(MAU, BIO, ARA, LLA, AIS)
Senecio otopterus	ARG(CAT, JUJ, SAL, TUC)
Senecio oxyphyllus	ARG(COS, ERI) / BRA(RGS) / URY(CLA, RIV)
Senecio pachyphyllos	ARG(MEN, NEU, RNE) / CHL(LBO, MAU, BIO, ARA, RME)
Senecio pampeanus	ARG(BAI, CAT, COR, COS, ERI, JUJ, LPA, LRI, MEN, RNE, SAL, SLU, SFE, TUC)
Senecio pappii	CHL(ANT)
Senecio paraguariensis	ARG(CHA, COS, MIS) / BRA(SCA) / PRY(CEN, COA, PAI)
Senecio paranensis	BRA(PAR, SCA)
Senecio parodii	ARG(NEU, RNE) / CHL(BIO, ARA, LLA)
Senecio patagonicus var. patagonicus	ARG(CHU, NEU, RNE, SCR, TDF) / CHL(AIS, MAG)
Senecio patagonicus var. andersonii	ARG(CHU, SCR, TDF) / CHL(AIS, MAG)
Senecio patagonicus var. alyssoides	ARG(CHU, SCR, TDF) / CHL(AIS, MAG)
Senecio patagonicus var. lobatifolius	ARG(CHU, SCR, TDF) / CHL(MAG)
Senecio paucidentatus var. paucidentatus	CHL(COQ, VAL)
Senecio paucidentatus var. limbardioides	CHL(VAL)
Senecio paulensis	BRA(PAR, SCA)
Senecio pelquensis	ARG(SCR)
Senecio pemehuensis	CHL(BIO, ARA)
Senecio pentaphyllus	CHL(LBO, RME)
Senecio perezii f. perezii	ARG(MEN, NEU, RNE)
Senecio perezii f. integerrima	ARG(MEN, NEU)
Senecio peripotamus	CHL(COQ)
Senecio peteroanus	ARG(MEN, NEU, RNE, SJU, SCR) / CHL(MAU, ARA)
Senecio petrophyus	CHL(JFE)
Senecio pfisteri	CHL(TAR, ANT)
Senecio philippicus	CHL(ANT)
Senecio philippii	ARG(NEU, RNE, TDF) / CHL(LLA, AIS, MAG)
Senecio phylicifolius	CHL(BIO, ARA)
Senecio phylloleptus	CHL(TAR)
Senecio pichineuquensis var. pichineuquensis	ARG(MEN, NEU)
Senecio pichineuquensis var. albus	ARG(NEU)
Senecio pilquensis	ARG(NEU) / CHL(BIO, ARA, LLA)
Senecio pinachensis	ARG(NEU)
Senecio pinnatus var. simplicifolius	ARG(BAI, ERI, LPA, SLU, SFE)
Senecio pinnatus var. pinnatus	ARG(BAI, CAT, CHA, CHU, COR, COS, ERI, FOR, LPA, LRI, MEN, NEU, RNE, SAL, SJU, SLU, SFE, SDE, TUC) / BRA(PAR, RGS, SCA) / PRY(CEN, PHA) / URY(CAS, COL, MON, RNO, TAC)
Senecio pissisi	ARG(LRI, SJU) / CHL(COQ)
Senecio planiflorus	CHL(COQ, VAL, LBO, MAU, RME)
Senecio platensis	BRA(RGS, SCA) / URY(MON, ROC, SJO)
Senecio poeppigii var. poeppigii	ARG(CHU, NEU, RNE, SCR) / CHL(MAU, BIO, ARA, LLA, MAG)
Senecio poeppigii var. discoideus	ARG(NEU)
Senecio pogonias	ARG(MEN, SJU)
Senecio polygaloides	ARG(MEN) / CHL(COQ, VAL, LBO, MAU, BIO, ARA, AIS, RME)
Senecio polyphyllus	ARG(NEU) / CHL(LBO, MAU, BIO, ARA)
Senecio portalesianus var. lanuginosus	CHL(BIO, ARA)
Senecio portalesianus var. portalesianus	ARG(CHU, MEN, NEU, RNE) / CHL(BIO, ARA, LLA, AIS, MAG)
Senecio portulacoides	CHL(COQ)
Senecio potosianus	ARG(JUJ)
Senecio prenanthifolius	ARG(NEU, RNE) / CHL(LBO, ARA, LLA)
Senecio promatensis	BRA(RGS)
Senecio proteus var. proteus	CHL(ATA, COQ)
Senecio proteus var. geissei	CHL(ATA, COQ)
Senecio pseudalmeidae	CHL(ANT)
Senecio pseudaspericaulis	ARG(NEU)
Senecio pseuderucoides	CHL(RME)
Senecio pseudodepressus	ARG(SJU)
Senecio pseudotites	ARG(CAT, LRI, SAL, TUC)
Senecio pterophorus	ARG(BAI, CHA, COS, ERI, FOR, MIS, SFE, SDE) / BRA(PAR, RGS, SCA) / PRY(APY, AMA, BOQ, CAU, CAA, CAN, CEN, COA, GUA, ITA, MIE, ÑEE, PAI, PHA, SPE) / URY(PAY, RNO, SAO, SJO)
Senecio pubescens	CHL(COQ)
Senecio puchii	ARG(CAT, JUJ, SAL, TUC) / CHL(TAR, ANT)
Senecio pulcher f. pulcher	ARG(BAI) / BRA(PAR, RGS, SCA) / URY(CAS, MAL, MON, ROC)
Senecio pulcher f. albiflorus	BRA(RGS)
Senecio pulicarioides var. auriculatus	BRA(RGS)
Senecio pulicarioides var. pulicarioides	BRA(PAR, RGS)
Senecio pumilus	ARG(MEN, NEU)
Senecio punae	ARG(JUJ, SAL)
Senecio pycnanthus	CHL(MAU)
Senecio ragonesei	ARG(LRI, MEN, SJU)
Senecio rahmeri var. rahmeri	ARG(CAT, LRI, SAL) / CHL(ANT, ATA)
Senecio rahmeri var. sericeus	ARG(LRI)
Senecio ramboanus	BRA(RGS, SCA)
Senecio reedi	ARG(MEN)
Senecio reicheanus	CHL(TAR)
Senecio reitzianus	BRA(SCA)
Senecio renjifoanus	ARG(CHU, MEN, NEU) / CHL(RME)
Senecio repollensis	ARG(NEU)
Senecio retanensis	ARG(COR, SLU)
Senecio ricardii	CHL(ATA)
Senecio riograndensis	BRA(RGS)
Senecio riojanus var. riojanus	ARG(LRI, RNE, SJU)
Senecio riojanus var. radiatus	ARG(CHU, LPA, LRI, MEN, NEU, RNE, SJU, SLU)
Senecio rudbeckiiefolius	ARG(CAT, JUJ, LRI, SAL, SJU, SLU, TUC)
Senecio rufescens	ARG(JUJ, SAL, TUC) / CHL(MAU)
Senecio ruiz-lealii	ARG(MEN)
Senecio saltensis	ARG(CHA, COR, COS, ERI, SAL, SDE, SFE) / URY(RNO)
Senecio sanagastae	ARG(CAT, LRI, SJU)
Senecio sandwithii	ARG(NEU)
Senecio santelicis	ARG(CAT, JUJ, LRI, SAL, SJU) / CHL(ANT, ATA)
Senecio santiagoensis	CHL(RME)
Senecio saxicola	CHL(ATA)
Senecio schoenemannii	CHL(MAU)
Senecio schreiteri	ARG(CAT, SAL, SJU, TUC)
Senecio scopulorum	CHL(BIO)
Senecio scorzonerifolius	ARG(CAT, JUJ, LRI, SAL) / CHL(TAR, ANT)
Senecio sectilis	ARG(CAT, COR, LRI, MEN, SAL, SJU, SLU, SDE, TUC)
Senecio segethii	ARG(SJU) / CHL(ATA, COQ)
Senecio selloi	ARG(BAI, ERI) / BRA(RGS) / URY(CAS, COL, MON, ROC, SAO, SJO, SOR)
Senecio sericeonitens	ARG(CHU, NEU, RNE, SCR, TDF) / CHL(ARA, AIS, MAG)
Senecio serranus	BRA(PAR, RGS)
Senecio serratifolius	ARG(CAT, JUJ, SAL) / CHL(TAR, ANT)
Senecio sinuatilobus	CHL(COQ, VAL, LBO, MAU, RME)
Senecio skottsbergii var. skottsbergii	ARG(CHU, NEU, SCR) / CHL(AIS, MAG)
Senecio skottsbergii var. anomalus	CHL(AIS)
Senecio smithii	ARG(CHU, NEU, RNE, SCR, TDF) / CHL(ARA, LLA, AIS, MAG)
Senecio socompae	ARG(SAL) / CHL(ANT)
Senecio sorianoi	ARG(CHU, MEN, NEU)
Senecio steparius	ARG(NEU)
Senecio stigophlebius	BRA(SCA)
Senecio subarnicoides	BRA(RGS, SCA)
Senecio subauritus	CHL(BIO, ARA)
Senecio subpanduratus	ARG(CHU, TDF)
Senecio subpubescens	ARG(NEU, RNE) / CHL(MAU, BIO, ARA, MAG)
Senecio subulatus var. subulatus	ARG(BAI, CAT, CHU, JUJ, LPA, LRI, MEN, NEU, RNE, SJU, SLU, TUC)
Senecio subulatus var. erectus	ARG(BAI, CAT, CHU, JUJ, LPA, LRI, MEN, NEU, RNE, SAL, SJU, SLU, TUC)
Senecio subulatus var. salsus	ARG(CAT, JUJ, LRI, MEN, RNE, SAL, SJU, SLU, TUC) / CHL(TAR, ANT)
Senecio subumbellatus	ARG(CHU, MEN, NEU, RNE) / CHL(VAL, LBO, MAU, BIO, ARA, LLA, RME)
Senecio sundtii	ARG(CAT, LRI, SJU) / CHL(ANT)
Senecio sylvaticus	ARG(CHU, NEU, RNE) / CHL(ARA, LLA, AIS)
Senecio tacuaremboensis	URY(TAC)
Senecio talquinus	CHL(MAU)
Senecio tandilensis	ARG(BAI)
Senecio tehuelches	ARG(CHU, NEU, RNE, SCR) / CHL(AIS)
Senecio thurifer	CHL(JFE)
Senecio tilcarensis	ARG(JUJ)
Senecio tinctolobus	CHL(ATA, COQ)
Senecio tocomarensis	ARG(SAL, SJU)
Senecio toroanus	ARG(CAT, LRI, MEN, SJU)
Senecio trafulensis	ARG(CHU, NEU, RNE, SCR)
Senecio tricephalus	ARG(MEN, NEU, SCR)
Senecio trichocaulon	ARG(MIS) / BRA(RGS, SCA) / PRY(APA)
Senecio trichocodon	ARG(MIS) / PRY(APA, CAU)
Senecio tricuspidatus var. dentatus	ARG(TDF) / CHL(MAG)
Senecio tricuspidatus var. dumosus	ARG(SCR, TDF)
Senecio tricuspidatus var. tricuspidatus	ARG(CHU, SCR, TDF) / CHL(AIS, MAG)
Senecio trifidus	ARG(LRI, MEN, SJU) / CHL(RME)
Senecio trifurcatus	ARG(CHU, NEU, RNE, SCR, TDF) / CHL(ARA, LLA, AIS, MAG)
Senecio trifurcifolius	CHL(TAR)
Senecio triodon var. neuquensis	ARG(NEU)
Senecio triodon var. triodon	ARG(CHU, NEU, RNE) / CHL(VAL, LBO, MAU, BIO, ARA, LLA, AIS, MAG)
Senecio tripinnatifidus	CHL(COQ, VAL)
Senecio tristis	ARG(CHU, RNE) / CHL(LBO, MAU, BIO, ARA, RME)
Senecio troncosii	CHL(ANT, ATA)
Senecio tucumanensis	ARG(TUC)
Senecio tweediei	ARG(BAI, ERI, SFE) / BRA(RGS) / URY(CAS, MON, SJO)
Senecio uspallatensis	ARG(MEN, SJU)
Senecio vaginatus	ARG(TDF)
Senecio varvarcensis var. pinnatus	ARG(NEU)
Senecio varvarcensis var. varvarcensis	ARG(NEU)
Senecio ventanensis	ARG(BAI)
Senecio vervoorstii	ARG(CAT)
Senecio vira-vira	ARG(BAI, CAT, COR, COS, ERI, FOR, LPA, RNE, SJU, SLU, SCR, SFE, SDE) / BRA(RGS) / URY(ART, LAV, MAL, MON, SJO)
Senecio viridis var. radiatus	ARG(CAT, JUJ, LRI, SAL, SJU) / CHL(TAR, ANT)
Senecio viridis var. viridis	ARG(CAT, JUJ, SAL, SJU) / CHL(TAR, ANT)
Senecio viscosissimus	CHL(ANT, COQ, VAL)
Senecio volckmannii var. pinohachense	ARG(NEU)
Senecio volckmannii	ARG(CAT, JUJ, LRI, MEN, SAL, SJU, TUC) / CHL(TAR, ANT, ATA, COQ)
Senecio vulgaris	ARG(BAI, ERI, LPA, RNE, SCR, TDF) / CHL(ATA, VAL, BIO, ARA, LLA, MAG, RME, JFE) / URY(MON)
Senecio websteri	ARG(TDF) / CHL(MAG)
Senecio werdermannii	ARG(MEN) / CHL(RME)
Senecio westermanii	BRA(PAR)
Senecio xerophilus var. deserticola	CHL(ANT)
Senecio xerophilus var. xerophilus	ARG(CAT, JUJ, LRI, SAL, SJU) / CHL(TAR, ANT)
Senecio yalae	ARG(JUJ, SAL)
Senecio yegua var. pilotus	CHL(COQ, VAL, LBO, MAU, BIO, ARA, LLA, RME)
Senecio yegua var. depilis	CHL(COQ, LBO, BIO, ARA, LLA)
Senecio zapahuirensis	CHL(TAR)
Senecio zapalae	ARG(NEU, SCR)
Senecio zoellneri	CHL(TAR)
Senecio zosterifolius	ARG(NEU, RNE) / CHL(VAL, BIO, ARA, LLA)
Senegalia bonariensis	ARG(BAI, CAT, CHA, COR, COS, ERI, FOR, JUJ, MIS, SJU, SFE, TUC) / BRA(RGS) / PRY(CAA, CAN, CEN, COA, MIE, ÑEE, PHA) / URY(ART, CAS, CLA, COL, CLA, FLA, MON, PAY, RNO, ROC, SAO, SJO, TAC)
Senegalia etilis	ARG(JUJ, SAL) / PRY(APY, BOQ)
Senegalia gilliesii	ARG(BAI, CAT, COR, FOR, LRI, MEN, MIS, SAL, SJU, SLU, SDE, TUC) / PRY(APY, BOQ, CAA)
Senegalia harleyi	BRA(PAR)
Senegalia hatschbachii	BRA(PAR)
Senegalia hoehnei	BRA(PAR, SCA)
Senegalia martii	ARG(FOR) / PRY(CON, PHA)
Senegalia monacantha 	ARG(CHA, COS, FOR, SFE) / BRA(PAR) / PRY(APY, PHA)
Senegalia nitidifolia	ARG(MIS) / BRA(PAR, RGS, SCA) / PRY(APA, CAU, MIE)
Senegalia parviceps	ARG(FOR, JUJ, SAL, TUC) / BRA(PAR) / PRY(AMA, CEN)
Senegalia polyphylla	ARG(MIS) / BRA(PAR) / PRY(APA, AMA, CAU, CAN, CON)
Senegalia praecox 	ARG(CAT, CHA, COR, COS, ERI, FOR, JUJ, SAL, SFE, SDE, TUC) / PRY(APY, BOQ, CON, PAI, PHA) / URY(ART, PAY, SAO)
Senegalia recurva	ARG(COS, JUJ, MIS) / BRA(PAR, RGS, SCA) / PRY(CON)
Senegalia tucumanensis	ARG(CAT, COS, JUJ, MIS, SAL, TUC) / BRA(PAR, RGS, SCA) / PRY(CEN, COA, GUA, PAI) / URY(ART)
Senegalia velutina	ARG(COS, MIS) / BRA(PAR, RGS, SCA) / PRY(APA, AMA, CAN, ITA)
Senna acanthoclada	ARG(CAT, COR, LRI, SJU, SLU)
Senna aculeata	BRA(Fuera del área del proyecto) / PRY(APY, AMA, CEN, CON, COA, PHA)
Senna alata	ARG(CHA, COS, FOR, MIS) / BRA(PAR, RGS, SCA) / PRY(APY, APA, AMA, CAU, CAN, CEN, CON, COA, GUA, PAI, SPE)
Senna angulata var. miscadena	BRA(PAR, SCA)
Senna aphylla var. pendula	ARG(CAT, COR, LPA, LRI, SAL, SLU, SDE, TUC)
Senna aphylla	ARG(BAI, CAT, CHU, COR, LPA, LRI, MEN, NEU, RNE, SAL, SJU, SLU, SDE, TUC)
Senna araucarietorum	BRA(PAR, SCA)
Senna arnottiana	ARG(MEN, NEU, RNE) / CHL(COQ, VAL, LBO, MAU, BIO, RME)
Senna birostris var. jallaguensis	ARG(CAT, JUJ, LRI, SAL, TUC)
Senna birostris var. arequipensis	CHL(TAR)
Senna birostris var. hookeriana	ARG(CAT, COR, JUJ, LRI, SAL, SJU, SLU, TUC)
Senna brongniartii	CHL(TAR, ANT)
Senna burkartiana	ARG(SAL, TUC)
Senna candolleana	CHL(COQ, VAL, RME)
Senna cernua	BRA(PAR) / PRY(AMA, CAU, COA, GUA, PAI)
Senna chacoënsis	ARG(CHA, COR, SDE, SFE, TUC) / PRY(APY)
Senna chloroclada	ARG(CHA, FOR, SAL, SFE) / PRY(APY, PHA)
Senna corymbosa	ARG(BAI, COR, COS, ERI, LPA, MIS, SAL, SFE, TUC) / BRA(RGS, SCA) / PRY(APY, CEN, COA, GUA, PAI, PHA) / URY(ART, CAS, COL, DUR, FLO, FLA, LAV, MAL, MON, PAY, RIV, ROC, SAO, SJO, SOR, TAC, TYT)
Senna crassiramea	ARG(CAT, JUJ, SAL, TUC)
Senna cruckshanksii	CHL(VAL, RME)
Senna cumingii var. cumingii	CHL(ANT, ATA, COQ)
Senna cumingii var. eremobia	CHL(ANT)
Senna cumingii var. alcaparra	CHL(COQ, VAL)
Senna cumingii var. coquimbensis	CHL(ANT, COQ)
Senna hilariana	BRA(RGS) / PRY(APA, AMA, CAU, CAN)
Senna hirsuta var. leptocarpa	BRA(Fuera del área del proyecto) / PRY(CEN)
Senna hirsuta var. streptocarpa	ARG(MIS) / BRA(PAR, RGS, SCA) / URY(ART, RIV)
Senna hirsuta var. puberula	ARG(CHA, FOR, JUJ, SAL, SDE, TUC) / PRY(CEN, COA)
Senna huidobriana	CHL(COQ)
Senna kurtzii	ARG(MEN, NEU)
Senna leiophylla	BRA(RGS) / PRY(GUA)
Senna macranthera	BRA(PAR, RGS, SCA) / PRY(CAU, CAN, SPE)
Senna morongii	ARG(CHA, COR, COS, ERI, FOR, JUJ, SAL, SDE, SFE, SLU) / PRY(APY, CON, MIE, PHA)
Senna mucronifera	BRA(Fuera del área del proyecto) / PRY(AMA, CAU, CAA, CAN, GUA)
Senna multijuga var. peregrinatrix	BRA(PAR, SCA)
Senna multijuga ssp. lindleyana	BRA(PAR, RGS, SCA)
Senna nana	ARG(MIS) / BRA(RGS) / URY(ART, DUR, PAY, SAO, SOR, TAC, TYT)
Senna neglecta	BRA(PAR, RGS, SCA)
Senna nudicaulis	ARG(MEN, NEU)
Senna oblongifolia	ARG(MIS) / BRA(PAR, RGS, SCA) / URY(MON, RIV, TAC)
Senna obtusifolia	ARG(CHA, COS, FOR, MIS, SAL, TUC) / BRA(PAR, RGS, SCA) / PRY(APY, APA, CAU, CAN, CEN, COA, GUA, PAI)
Senna occidentalis	ARG(COS, ERI, FOR, JUJ, MIS, SAL, SDE, TUC) / BRA(PAR, RGS, SCA) / PRY(APY, AMA, BOQ, CAU, CAA, CEN, COA, GUA, ÑEE, PAI, PHA) / URY(ART, MON, PAY, RNO, SAO, SOR)
Senna organensis var. extratropica	BRA(PAR, SCA)
Senna pachyrrhiza	ARG(CAT)
Senna paposana	CHL(ANT)
Senna paradictyon	BRA(Fuera del área del proyecto) / PRY(APA, AMA, CAU, CAN, CON, COA, SPE)
Senna pendula var. missionum	ARG(COS, MIS)
Senna pendula var. recondita	BRA(PAR, SCA)
Senna pendula var. glabrata	BRA(PAR, SCA) / PRY(AMA, CAA, CEN, COA, GUA, PAI, PHA)
Senna pendula var. paludicola	ARG(COS, ERI, FOR, MIS, SFE) / BRA(Fuera del área del proyecto) / PRY(APY, BOQ, CEN, COA, ÑEE, PAI, PHA) / URY(ART, MON)
Senna pendula var. eriocarpa	ARG(JUJ, SAL, TUC)
Senna pilifera var. pilifera	ARG(COS, JUJ, MIS, SAL) / BRA(PAR, RGS) / PRY(APA, AMA, CAU, CAA, CAN, CEN)
Senna pilifera var. tubata	BRA(Fuera del área del proyecto) / PRY(APY)
Senna rigidicaulis	ARG(SAL)
Senna rugosa	BRA(PAR, RGS) / PRY(AMA)
Senna scabriuscula	ARG(CHA, COS, ERI, MIS, SFE) / BRA(RGS) / PRY(APY, CEN, COA, PAI) / URY(MON, PAY, RNO, RIV, SAO, SOR)
Senna septemtrionalis	BRA(SCA)
Senna silvestris var. unifaria	BRA(Fuera del área del proyecto) / PRY(AMA)
Senna silvestris var. silvestris	BRA(PAR, SCA) / PRY(CAN)
Senna silvestris var. guaranitica	BRA(Fuera del área del proyecto) / PRY(AMA, CAN, COA, PAI, SPE)
Senna spectabilis	ARG(BAI, JUJ, SAL, SFE) / BRA(Fuera del área del proyecto) / PRY(APY, CEN, COA)
Senna spiniflora	ARG(CHA, FOR) / PRY(APY)
Senna splendida	BRA(PAR) / PRY(CON)
Senna stipulacea var. stipulacea	CHL(VAL, LBO, MAU, BIO, ARA, LLA)
Senna stipulacea var. anglorum	CHL(COQ, VAL, MAU, RME)
Senna subulata	ARG(CAT, COR, JUJ, LRI, SAL, SLU, TUC)
Senna tropica	BRA(PAR, SCA)
Senna urmenetae	CHL(ATA, COQ, RME)
Senna velutina	BRA(Fuera del área del proyecto) / PRY(AMA, CON)
Serjania acoma	BRA(PAR, SCA) / PRY(AMA)
Serjania ampelopsis	ARG(SAL)
Serjania caracasana	ARG(CHA, COS, FOR, JUJ, MIS, SAL, SFE) / BRA(PAR) / PRY(APY, AMA, BOQ, CAN, CEN, CHO, CON, COA, ÑEE, PAI, PHA, SPE)
Serjania cissoides	BRA(Fuera del área del proyecto) / PRY(AMA)
Serjania clematidifolia	BRA(PAR, RGS, SCA)
Serjania communis var. glabra	BRA(PAR)
Serjania communis var. communis	BRA(PAR, RGS, SCA)
Serjania confertiflora f. subincana	ARG(JUJ, SAL) / PRY(APY, CON)
Serjania cuspidata	BRA(PAR)
Serjania decemstriata	BRA(RGS)
Serjania erecta	BRA(PAR) / PRY(AMA, CAN, CON, SPE)
Serjania eriocarpa	BRA(Fuera del área del proyecto) / PRY(CON)
Serjania foveata	ARG(CAT, JUJ, SAL, TUC)
Serjania fuscifolia	ARG(COS, FOR, MIS) / BRA(PAR, RGS) / PRY(APA, AMA, CAU, CAA, CAN, CEN, COA, GUA, ITA, PAI, SPE)
Serjania glabrata	ARG(CAT, COR, COS, JUJ, MIS, SAL, SJU, TUC) / BRA(PAR, RGS, SCA) / PRY(APA, AMA, CAU, CAN, CEN, CON, COA, GUA, PAI, SPE)
Serjania glutinosa	ARG(MIS) / BRA(PAR) / PRY(APA, AMA, CAN, CON, COA, GUA, PAI)
Serjania gracilis	BRA(PAR, SCA)
Serjania hatschbachii	BRA(PAR)
Serjania hebecarpa	ARG(COS, ERI, JUJ, MIS, SAL) / BRA(PAR, RGS, SCA) / PRY(APY, AMA, CAU, CEN, CON, COA, GUA, PAI, SPE) / URY(ART, DUR, PAY, RNO, SAO, SOR, TAC)
Serjania herteri	ARG(COS, ERI) / BRA(RGS, SCA) / URY(ART, SAO)
Serjania laruotteana	ARG(COS, MIS) / BRA(PAR, RGS, SCA) / PRY(APA, AMA, COA, GUA, PAI, SPE)
Serjania leptocarpa	BRA(PAR)
Serjania lethalis	BRA(PAR, SCA)
Serjania longistipula	ARG(JUJ, SAL, TUC)
Serjania mansiana	BRA(PAR)
Serjania marginata	ARG(FOR, JUJ, SAL, SDE, TUC) / BRA(PAR) / PRY(APY, AMA, CEN, CON, COA, PAI, PHA)
Serjania meridionalis	ARG(BAI, CHA, COS, ERI, JUJ, MIS, SAL) / BRA(PAR, RGS, SCA) / PRY(APA, AMA, CAU, CAA, CEN, CON, COA, GUA, PAI, SPE) / URY(ART, COL, SAO, SOR)
Serjania minutiflora	BRA(Fuera del área del proyecto) / PRY(COA)
Serjania multiflora	BRA(PAR, RGS, SCA)
Serjania neei	PRY(APY)
Serjania orbicularis	BRA(Fuera del área del proyecto) / PRY(AMA)
Serjania paranensis	BRA(PAR)
Serjania perulacea	ARG(CHA, COS, FOR, JUJ, MIS, SAL) / BRA(Fuera del área del proyecto) / PRY(APY, AMA, CEN, CON, COA, GUA, ITA, MIE, ÑEE, PAI, PHA, SPE)
Serjania piscatoria	BRA(PAR)
Serjania punctulata	BRA(PAR)
Serjania reticulata	ARG(SAL) / BRA(PAR, SCA)
Serjania sufferruginea	ARG(JUJ)
Serjania tripleuria	ARG(JUJ, SAL) / BRA(PAR) / PRY(AMA, CON)
Serjania tristis	BRA(PAR) / PRY(AMA, CAN, PAI)
Serjania unidentata	BRA(PAR, SCA)
Serpocaulon catharinae	ARG(MIS) / BRA(PAR, RGS, SCA) / PRY(APA, COA) / URY(ROC)
Serpocaulon fraxinifolium	BRA(PAR, SCA) / PRY(APA)
Serpocaulon gilliesii	ARG(BAI, CAT, COR, JUJ, SAL, SLU, TUC)
Serpocaulon latipes	ARG(COS, MIS) / BRA(PAR, RGS, SCA) / PRY(APA, AMA, CAN, COA, PAI, SPE) / URY(ROC)
Serpocaulon latissimum	BRA(PAR)
Serpocaulon meniscifolium	BRA(PAR, RGS, SCA)
Serpocaulon polystichum	ARG(SAL)
Serpocaulon sehnemii	BRA(PAR, RGS)
Serpocaulon triseriale	BRA(PAR, RGS, SCA) / PRY(CAN)
Serpocaulon vacillans	ARG(COS, MIS) / BRA(PAR, RGS, SCA) / PRY(CAU, CAA, CAN, COA, SPE)
Sesbania bispinosa	ARG(JUJ, SAL)
Sesbania exasperata	ARG(CHA, COS, FOR, SAL, SFE) / BRA(Fuera del área del proyecto) / PRY(APY, CEN, CON, COA, PHA)
Sesbania macroptera	ARG(COS) / PRY(APY, COA, PAI)
Sesbania punicea	ARG(BAI, COS, ERI, MIS, SFE) / BRA(PAR, RGS, SCA) / PRY(CAU, ITA) / URY(ART, CAS, CLA, COL, MAL, MON, PAY, RNO, RIV, ROC, SJO, SOR)
Sesbania sesban	PRY(AMA)
Sesbania virgata	ARG(BAI, CHA, COS, ERI, FOR, MIS, SFE, SJU, TUC) / BRA(PAR, RGS) / PRY(APY, BOQ, CAN, CEN, CON, COA, ÑEE, PAI, PHA) / URY(ART, CAS, COL, DUR, MON, PAY, RNO, RIV, SJO, SOR, TAC)
Seseli libanotis	CHL(BIO)
Sessea regnellii	ARG(MIS) / BRA(PAR, SCA)
Sessea vestioides	ARG(COS) / BRA(Desconocida) / PRY(PAI) / URY(SAO, TAC)
Sesuvium portulacastrum	ARG(BAI, CHA, COR, COS, ERI, FOR, JUJ, LPA, LRI, MEN, RNE, SAL, SCR, SDE, SFE, SJU, SLU, TUC) / BRA(SCA) / CHL(TAR) / PRY(APY, PHA) / URY(MAL, MON)
Setaria alonsoi	ARG(COR, LRI)
Setaria cordobensis	ARG(CAT, COR, FOR, JUJ, LRI, SAL, SDE, SFE, SJU, SLU, TUC)
Setaria fiebrigii	ARG(CHA, COR, COS, DFE, ERI, FOR, MIS, SFE) / BRA(PAR, RGS, SCA) / PRY(APA, APY, BOQ, CAA, CEN, CON, COA, GUA, ITA, MIE, ÑEE, PAI, PHA, SPE) / URY(ART, CLA, COL, DUR, FLO, FLA, PAY, SAO, SOR)
Setaria geminata	ARG(BAI, CHA, COS, ERI, FOR, SFE) / BRA(RGS) / PRY(APY, AMA, CON, PAI, PHA) / URY(MON, ROC)
Setaria globulifera	ARG(CHA, COS, ERI, FOR, MIS, SFE) / BRA(PAR, RGS, SCA) / PRY(APA, APY, AMA, BOQ, CAA, CEN, ITA, ÑEE, PHA, SPE) / URY(CLA, DUR, RNO, SOR)
Setaria hassleri	ARG(CAT, COS, FOR, MIS, SAL, SDE, TUC) / BRA(RGS) / PRY(APY, AMA, CAU, CAA, CEN, CON, COA, GUA, PAI, SPE)
Setaria hunzikeri	ARG(CAT, CHA, COR, COS, FOR, JUJ, LRI, SAL, SDE, SFE, SJU, SLU, TUC) / PRY(APY, BOQ, CEN, PAI, PHA)
Setaria italica	ARG(BAI, CHA, COR, DFE, FOR, LPA, MEN, MIS, SFE, SLU) / BRA(RGS)
Setaria lachnea	ARG(BAI, CAT, CHA, COR, COS, DFE, ERI, FOR, JUJ, LPA, LRI, MIS, SAL, SDE, SFE, SJU, SLU, TUC) / BRA(PAR, SCA) / PRY(APY, BOQ, CEN, CHO, CON, COA, GUA, ÑEE, PAI) / URY(COL)
Setaria leucopila	ARG(BAI, CAT, COR, LPA, LRI, MEN, RNE, SJU, SLU)
Setaria macrostachya	ARG(CAT, CHA, COR, COS, FOR, JUJ, LRI, MEN, MIS, SAL, SDE, SFE, SJU, SLU, TUC) / BRA(Fuera del área del proyecto) / PRY(APY, BOQ, CEN, CHO, GUA, NAS, PHA)
Setaria magna	ARG(CHA, COS, FOR, JUJ, SAL) / BRA(RGS)
Setaria megaphylla	BRA(PAR)
Setaria mendocina	ARG(BAI, CAT, JUJ, LPA, LRI, MEN, NEU, RNE, SJU, SLU)
Setaria nicorae	ARG(CHA, COR, COS, FOR, SAL, SDE, SFE) / BRA(Fuera del área del proyecto) / PRY(APY, BOQ, CEN, NAS, PHA)
Setaria oblongata	ARG(BAI, CAT, COR, JUJ, LRI, SAL, SLU, TUC)
Setaria pampeana	ARG(BAI, CAT, COR, COS, DFE, ERI, JUJ, LPA, LRI, MEN, SAL, SDE, SFE, SJU, SLU, TUC) / URY(SAO)
Setaria paraguayensis	BRA(Fuera del área del proyecto) / PRY(APY, BOQ, CON, PHA)
Setaria parodii	ARG(COS, MIS, SFE) / BRA(RGS) / URY(CLA, FLO, FLA)
Setaria parviflora var. parviflora	ARG(BAI, CAT, CHA, COR, COS, DFE, ERI, FOR, JUJ, LPA, LRI, MEN, MIS, RNE, SAL, SDE, SFE, SJU, SLU, TUC) / BRA(PAR, RGS, SCA) / CHL(ATA, COQ, VAL, LBO, MAU, BIO, ARA, LLA, JFE, IPA) / PRY(APA, APY, AMA, BOQ, CAU, CAA, CAN, CEN, CON, COA, GUA, ITA, ÑEE, NAS, PAI, PHA) / URY(ART, COL, FLA, MAL, MON, PAY, ROC, SAO, SOR, TAC, TYT)
Setaria parviflora var. pilosissima	BRA(PAR, RGS) / PRY(AMA)
Setaria parviflora var. brachytricha	ARG(CHU) / CHL(MAU, BIO, ARA, LLA, RME)
Setaria paucifolia	ARG(COS, MIS) / BRA(RGS) / PRY(APA, AMA, CAU, CAA, CAN, CEN, CON, COA, GUA, ITA, MIE, PAI, PHA, SPE)
Setaria pflanzii	ARG(JUJ, SAL) / PRY(APY, PHA)
Setaria pumila	ARG(BAI, CAT, CHA, COR, COS, ERI, LPA, MEN, RNE, SJU, SLU, SFE) / CHL(TAR, ATA, VAL, MAU, BIO, RME) / PRY(APY, BOQ)
Setaria rosengurtii var. uruguayensis	URY(ART, MON, RIV, SAO)
Setaria rosengurtii var. rosengurtii	ARG(BAI, COS, ERI, MIS, SFE) / BRA(RGS) / URY(MAL, MON)
Setaria scabrifolia	BRA(PAR, RGS, SCA) / PRY(AMA)
Setaria scandens	ARG(BAI, JUJ, MIS) / BRA(PAR, RGS, SCA) / PRY(AMA, GUA)
Setaria setosa	BRA(PAR, SCA) / PRY(APY)
Setaria sphacelata var. sericea	ARG(CHA, COS, MIS, SAL) / BRA(RGS, SCA) / PRY(AMA, CAN, ITA) / URY(FLA, SOR)
Setaria sphacelata var. anceps	PRY(APA, AMA, ITA)
Setaria stolonifera	ARG(SFE) / BRA(RGS)
Setaria sulcata	ARG(BAI, CHA, COS, FOR, MIS, SAL, SFE) / BRA(PAR, RGS, SCA) / PRY(APA, AMA, CAU, CAA, CAN, CEN, COA, GUA, ITA, ÑEE, PAI, PHA, SPE)
Setaria tenax	BRA(PAR) / PRY(CEN, CON, COA, PAI)
Setaria vaginata var. vaginata	ARG(BAI, CHA, COR, COS, DFE, ERI, MIS, SFE) / BRA(PAR, RGS, SCA) / PRY(APY, PAI) / URY(ART, CAS, FLO, FLA, LAV, MAL, MON, ROC, SOR)
Setaria vaginata var. tandilensis	ARG(BAI)
Setaria vaginata var. bonariensis	ARG(BAI, COS, ERI, MIS) / BRA(RGS) / URY(MAL)
Setaria verticillata	ARG(BAI, CAT, CHA, COR, DFE, ERI, FOR, JUJ, LRI, MEN, NEU, RNE, SAL, SJU, SLU, SFE, SDE, TUC) / BRA(PAR) / CHL(VAL, BIO, RME) / PRY(CEN) / URY(MON, PAY)
Setaria verticilliformis	ARG(BAI, LPA, MEN)
Setaria viridis	ARG(BAI, COR, DFE, ERI, LPA, MEN, NEU, RNE, SJU, SLU, SFE) / BRA(RGS) / CHL(ATA, VAL, BIO, RME, JFE) / URY(SOR)
Setaria vulpiseta var. vulpiseta	ARG(CHA, COS, FOR, JUJ, MIS, SAL, SFE) / BRA(PAR, RGS, SCA) / PRY(APA, AMA, CAU, CAA, CAN, CEN, CON, COA, GUA, ITA, MIE, PAI, SPE)
Setaria vulpiseta var. reversipila	ARG(COS) / BRA(PAR) / PRY(APA, AMA, CAU, CAN, CEN, COA, GUA, PAI, SPE)
Setiechinopsis mirabilis	ARG(LRI, MEN, SDE, SJU)
Sherardia arvensis	ARG(BAI, ERI, NEU, RNE, TUC) / CHL(MAU, ARA) / URY(CAS, MON)
Sibara anethifolia	CHL(ANT, ATA)
Sibara dilloniorum	CHL(ANT)
Sibara macrostachya	CHL(ANT)
Sibara mendocina	ARG(MEN)
Sibara pinnata	CHL(ANT, ATA)
Sibara tehuelches	ARG(CHU, SCR)
Sibthorpia conspicua	ARG(CAT, JUJ, SAL, TUC)
Sibthorpia repens	ARG(JUJ)
Sicydium gracile	BRA(PAR, RGS, SCA)
Sicydium nereoi	ARG(COS)
Sicyos baderoa var. baderoa	CHL(TAR, ANT, ATA, COQ, VAL, RME)
Sicyos baderoa var. ambrosianus	CHL(IDE)
Sicyos ignarus	ARG(SAL)
Sicyos kunthii	ARG(CAT, JUJ, SAL, TUC)
Sicyos malvifolius	ARG(CAT, COR, SAL, SDE, SJU, TUC) / URY(MON)
Sicyos odonelli	ARG(CAT, JUJ, SAL, TUC)
Sicyos polyacanthus	ARG(CHA, COS, ERI, FOR, JUJ, MIS, SAL, TUC) / BRA(PAR, RGS, SCA) / PRY(CAN) / URY(PAY, SAO)
Sicyos warmingii var. warmingii	ARG(CAT, COR, JUJ, LRI, SAL, TUC) / BRA(Fuera del área del proyecto)
Sicyos warmingii var. longispinus	ARG(JUJ, SAL)
Sida adrianopolitana	BRA(PAR)
Sida albifora	PRY(COA, PAI)
Sida ambatense	ARG(CAT, JUJ, SAL)
Sida anomala	ARG(CHA, COR, COS, ERI, FOR, MIS, SFE) / BRA(RGS) / PRY(APY, BOQ, CAU, CEN, COA, GUA, ÑEE, PHA, SPE) / URY(PAY)
Sida argentina var. argentina	ARG(BAI, CAT, COR, ERI, JUJ, LRI, MEN, MIS, SAL, SDE, SJU, SLU, TUC) / PRY(PAI)
Sida argentina var. tucumanensis	ARG(CAT, COR, JUJ, LRI, SAL, SDE, SLU, TUC)
Sida ascendens	BRA(PAR, SCA) / PRY(COA)
Sida bordasiana	PRY(APY)
Sida cabreriana	ARG(FOR, JUJ, SAL, SDE, TUC) / PRY(APY)
Sida calchaquiensis	ARG(COS, LRI, SAL, SJU, TUC)
Sida caudata	BRA(PAR)
Sida centuriata	BRA(Fuera del área del proyecto) / PRY(APY, CAU, CON)
Sida cerradoensis	BRA(PAR) / PRY(AMA, CON, SPE)
Sida charpinii	PRY(APY)
Sida ciliaris	PRY(APY)
Sida confusa	ARG(COS, MIS) / PRY(CAU)
Sida cordifolia	ARG(BAI, CAT, CHA, COR, COS, FOR, JUJ, LRI, MIS, SAL, SFE, SDE, TUC) / BRA(PAR, SCA) / PRY(APY, AMA, CAU, CAA, CEN, COA, GUA, PAI, PHA) / URY(PAY, SAO, SJO)
Sida cristobaliana	PRY(APY, PHA)
Sida dictyocarpa	ARG(CAT, CHA, COR, ERI, FOR, JUJ, LRI, SAL, SDE, SJU, SLU, TUC) / PRY(APY, PHA) / URY(CAS, RIV)
Sida dubia	ARG(COS, ERI) / BRA(RGS) / PRY(CEN) / URY(SAO, TAC)
Sida dureana	BRA(Fuera del área del proyecto) / PRY(APY, AMA, CON)
Sida emilei	BRA(Fuera del área del proyecto) / PRY(APY, CEN, CON, PAI)
Sida esperanzae	ARG(CAT, COR, FOR, JUJ, LRI, SAL, SDE, SJU, SLU, TUC) / PRY(APY, PHA)
Sida farroupilhensis	BRA(RGS)
Sida ferrucciana	BRA(Fuera del área del proyecto) / PRY(AMA, CAU, CON, GUA, PAI, SPE)
Sida glaziovii	BRA(PAR)
Sida glomerata	BRA(Fuera del área del proyecto) / PRY(AMA, CEN, COA, PAI, SPE)
Sida gracillima	PRY(CON)
Sida hassleri	PRY(AMA, CAA, CAN, CON)
Sida hatschbachii	BRA(PAR)
Sida honoriana	ARG(MIS) / BRA(Fuera del área del proyecto)
Sida ignaciana	ARG(MIS)
Sida jussieana	ARG(JUJ, SAL) / BRA(Fuera del área del proyecto)
Sida kelleri	ARG(MIS) / PRY(AMA)
Sida kranzii	BRA(PAR)
Sida lilianae	ARG(MIS) / BRA(Fuera del área del proyecto)
Sida linearifolia	BRA(Fuera del área del proyecto) / PRY(AMA)
Sida linifolia	BRA(PAR) / PRY(CEN, CON, COA, GUA, PAI)
Sida lonchitis	BRA(PAR, SCA)
Sida loretana	ARG(MIS)
Sida monteiroi	ARG(CHA, COS, ERI, FOR, SFE) / BRA(Fuera del área del proyecto) / PRY(APY, CON, PAI, PHA)
Sida multicrena	URY(SOR)
Sida nemorensis	ARG(COS, MIS, SAL) / BRA(PAR, SCA) / PRY(AMA, COA, GUA)
Sida palustris	ARG(MIS)
Sida paradoxa	ARG(COS) / BRA(RGS)
Sida parva	BRA(SCA)
Sida pedersenii	ARG(FOR) / PRY(APY)
Sida pindapoyensis	ARG(MIS)
Sida planicaulis	ARG(MIS) / BRA(PAR, RGS, SCA)
Sida poeppigiana	ARG(COR, JUJ, LRI, MIS, SAL, TUC)
Sida potentilloides	ARG(COS, MIS) / BRA(PAR, RGS) / PRY(AMA, CEN, PAI) / URY(CLA)
Sida pseudocymbalaria	PRY(CON)
Sida pseudopotentilloides var. manresana	BRA(RGS)
Sida pseudorubiflora	BRA(RGS)
Sida ramoniana	ARG(MIS)
Sida regnellii	ARG(COS, MIS) / BRA(PAR, RGS) / PRY(ITA, PAI)
Sida reitzii	BRA(SCA)
Sida rhizomatosa	ARG(MIS)
Sida rhombifolia	ARG(BAI, CAT, CHA, COR, COS, ERI, FOR, JUJ, LPA, MIS, SAL, SDE, SFE, SJU, SLU, TUC) / BRA(PAR, RGS, SCA) / CHL(COQ) / PRY(APY, BOQ, COA, ÑEE, PHA) / URY(MON, PAY, RIV, SAO, TAC, TYT)
Sida riedelii	ARG(CHA, COS, ERI, FOR, MIS, SDE) / BRA(Fuera del área del proyecto) / PRY(APY, GUA, PHA)
Sida rodrigoi	ARG(CHA, COS, FOR, JUJ, SAL) / PRY(CAU, CAA, CEN, COA, GUA, ÑEE, PAI, PHA)
Sida rufescens	ARG(MIS) / BRA(Fuera del área del proyecto) / PRY(AMA, CON, PAI, SPE)
Sida rupicola	ARG(CHA, COS, FOR) / BRA(PAR) / PRY(APY, AMA, CEN, COA, PAI, PHA)
Sida salviaefolia var. submutica	ARG(SAL)
Sida santaremensis	ARG(CHA, COS, FOR, JUJ, MIS, SAL) / BRA(PAR) / PRY(APY, CAU, CEN, COA, GUA, PAI, PHA)
Sida saraviae	ARG(COR, JUJ, SAL, TUC)
Sida schumanniana	ARG(SAL) / BRA(Fuera del área del proyecto) / PRY(AMA)
Sida setosa	PRY(APA)
Sida spinosa	ARG(BAI, CAT, CHA, COR, COS, DFE, ERI, FOR, JUJ, LRI, MEN, MIS, SAL, SDE, SJU, SLU, TUC) / BRA(PAR, RGS) / CHL(TAR, ATA) / PRY(APY, COA, GUA, PHA) / URY(CAS, MON)
Sida tapiraguensis	PRY(AMA, SPE)
Sida tressensiae	ARG(COS)
Sida tuberculata var. pseudorhombifolia	ARG(COS, ERI, MIS) / BRA(PAR, RGS) / PRY(APA, APY, AMA, CAU, CAA, CAN, CEN, CON, COA, ITA, PAI, PHA) / URY(SAO)
Sida tuberculata var. tuberculata	BRA(PAR) / PRY(PHA)
Sida urens	ARG(CHA, COS, FOR, JUJ, MIS, SAL, SFE) / BRA(PAR, RGS, SCA) / PRY(APY, APA, AMA, CAU, CAA, CEN, CON, COA, GUA, ITA, MIE, ÑEE, PAI, PHA)
Sida variegata	ARG(CAT, CHA, COR, COS, ERI, FOR, JUJ, LRI, SAL, SDE, SFE, SJU, SLU, TUC) / PRY(APY, BOQ, PHA) / URY(SJO)
Sida vespertina	ARG(COS, ERI, MIS) / BRA(RGS) / PRY(ITA)
Sida viarum	ARG(CHA, COS, MIS) / BRA(PAR, RGS) / PRY(APA, AMA, CAU, CAN, COA, GUA, ITA, MIE, PAI, SPE)
Sidastrum micranthum	BRA(PAR)
Sidastrum multiflorum	ARG(CHA, COS, FOR) / BRA(Fuera del área del proyecto) / PRY(APY, PHA)
Sidastrum paniculatum	ARG(COS, FOR) / BRA(PAR) / PRY(APY, BOQ, CAU, CAN, CEN, COA, GUA, MIE, ÑEE, PAI, PHA, SPE)
Sideroxylon obtusifolium	ARG(CHA, COR, COS, ERI, FOR, JUJ, MIS, SAL, SDE, SFE, TUC) / BRA(RGS, SCA) / PRY(APY, CEN, CON, MIE, PAI, PHA) / URY(ART, ROC)
Sigesbeckia orientalis	BRA(PAR) / PRY(PAI)
Sigesbeckia serrata	ARG(CAT, COR, JUJ, LRI, SAL, TUC) / CHL(VAL, BIO, ARA, LLA, AIS, RME)
Silene andicola	ARG(MEN, NEU, RNE) / CHL(LBO, BIO, ARA, LLA, MAG)
Silene antarctica	ARG(SCR) / CHL(MAG)
Silene antirrhina var. divaricata	PRY(CEN)
Silene antirrhina var. antirrhina	ARG(BAI, CHU, COR, COS, ERI, JUJ, LRI, MEN, MIS, NEU, RNE, SAL, SLU, SFE, SDE) / BRA(PAR, RGS) / PRY(APA) / URY(MON)
Silene argentina	ARG(BAI, COR, SLU)
Silene argentinensis	ARG(CAT, COR, JUJ, MEN, TUC)
Silene armeria	ARG(COR, NEU, RNE) / BRA(PAR) / CHL(BIO, ARA)
Silene bersieri	ARG(JUJ, SAL)
Silene chilensis	ARG(CHU, MEN, NEU, RNE, SCR) / CHL(COQ, LBO, MAU, BIO, ARA, LLA, MAG, RME)
Silene chubutensis	ARG(CHU, SCR) / CHL(AIS)
Silene cuspidata f. inuncta	ARG(NEU)
Silene cuspidata f. cuspidata	ARG(NEU) / CHL(ARA)
Silene dioica	ARG(BAI, TDF)
Silene echegarayi	ARG(MEN, SJU)
Silene filifolia	ARG(CHU, SCR)
Silene gallica	ARG(BAI, CHU, COR, COS, ERI, LRI, NEU, RNE, SAL, SJU, SCR, SFE, SDE) / BRA(PAR, RGS) / CHL(VAL, ARA) / URY(LAV, ROC, SJO)
Silene haumanii var. haumanii	ARG(JUJ, SAL)
Silene haumanii var. densa	ARG(JUJ)
Silene magellanica	ARG(CHU, MEN, RNE, SCR, TDF) / CHL(MAG)
Silene mandonii	ARG(CAT, JUJ, LRI, SAL, TUC) / CHL(TAR, ANT)
Silene margaritae	ARG(CAT)
Silene maritima	ARG(BAI)
Silene melanopotamica ssp. agrostophylla	ARG(RNE)
Silene melanopotamica ssp. nivosimontana	ARG(MEN)
Silene melanopotamica ssp. melanopotamica	ARG(BAI, CHU, NEU, RNE)
Silene patagonica	ARG(CHU, RNE) / CHL(MAG)
Silene pendula	ARG(BAI) / URY(MON)
Silene plutonica	ARG(RNE) / CHL(LBO, ARA, LLA, RME)
Silene pratensis	ARG(BAI, CHU, NEU, RNE, SFE)
Silene vulgaris	ARG(BAI, COR, NEU, RNE) / CHL(ARA, RME)
Silybum marianum	ARG(BAI, CAT, CHA, COR, DFE, ERI, JUJ, LPA, MEN, RNE, SAL, SDE, SFE, TDF, TUC) / BRA(RGS) / CHL(COQ, VAL, LBO, MAU, BIO, ARA, LLA, RME, JFE) / URY(MAL)
Simaba glabra	ARG(MIS) / BRA(Fuera del área del proyecto) / PRY(AMA, CAA, CON)
Simaba praecox	PRY(APA, CAU, CAN)
Simaba trichilioides	PRY(AMA)
Simira paraguayensis	PRY(APY)
Simira sampaioana	ARG(MIS) / BRA(PAR, SCA) / PRY(APY)
Simsia dombeyana	ARG(CAT, CHA, COR, ERI, JUJ, LRI, MEN, SAL, SDE, SFE, SJU, SLU, TUC) / BRA(RGS) / PRY(APY)
Sinapis alba	ARG(BAI, TDF)
Sinapis arvensis	ARG(BAI, COR, COS, ERI, LPA, MEN, RNE, SFE, TDF) / PRY(APY)
Sinningia aggregata	BRA(PAR, SCA) / PRY(AMA, COA, PAI)
Sinningia allagophylla	ARG(CHA, COR, COS, ERI, FOR, MIS) / BRA(PAR, RGS, SCA) / PRY(APA, AMA, CAU, CAA, CAN, CEN, CON, COA, GUA, MIE, PAI, PHA, SPE) / URY(RIV)
Sinningia amambayensis	BRA(Fuera del área del proyecto) / PRY(AMA)
Sinningia bullata	BRA(SCA)
Sinningia calcaria	BRA(PAR)
Sinningia canescens	BRA(PAR)
Sinningia conspicua	BRA(PAR, SCA)
Sinningia cooperi	BRA(PAR, SCA)
Sinningia curtiflora	BRA(PAR, RGS, SCA)
Sinningia douglasii	ARG(MIS) / BRA(PAR, RGS, SCA)
Sinningia elatior	ARG(COS, ERI, MIS) / BRA(PAR, RGS, SCA) / PRY(APA, AMA, CAU, CAA, CAN, CEN, CON, COA, GUA, ITA, MIE, ÑEE, PAI, SPE) / URY(CLA, RNO)
Sinningia eumorpha	BRA(PAR)
Sinningia gerdtiana	BRA(PAR)
Sinningia hatschbachii	BRA(PAR)
Sinningia leopoldii	BRA(SCA)
Sinningia leucotricha	BRA(PAR)
Sinningia lineata	BRA(RGS, SCA)
Sinningia lutea	BRA(RGS)
Sinningia macropoda	BRA(PAR, SCA) / PRY(COA, PAI)
Sinningia macrostachya	BRA(RGS, SCA) / URY(CLA)
Sinningia mauroana	BRA(PAR)
Sinningia nivalis	BRA(RGS, SCA)
Sinningia polyantha	BRA(RGS, SCA)
Sinningia ramboi	BRA(RGS)
Sinningia reitzii	BRA(SCA)
Sinningia sellowii	ARG(COS, MIS) / BRA(PAR, RGS, SCA) / PRY(AMA, CAN, CON, GUA, PAI) / URY(RIV)
Sinningia tubiflora	ARG(CHA, COR, COS, ERI, FOR, SDE, SFE) / PRY(CAA, CEN, ÑEE, PHA, SPE) / URY(PAY, RNO, SAO)
Sinningia warmingii	ARG(CAT, CHA, COR, COS, FOR, JUJ, MIS, SAL, TUC) / BRA(PAR, RGS, SCA) / PRY(APY, AMA, CAN, CEN, CON, COA, ÑEE, PHA, SPE)
Sinningia x vacariensis	BRA(RGS)
Siolmatra brasiliensis	ARG(JUJ, SAL) / BRA(Fuera del área del proyecto) / PRY(APY, CAN, COA, GUA, PAI, SPE)
Sipanea hispida	BRA(Fuera del área del proyecto) / PRY(AMA, CAN, CON, SPE)
Siparuna guianensis	PRY(AMA)
Siphanthera cordata	BRA(PAR)
Siphocampylus argentinus var. argentinus	ARG(CAT, JUJ, SAL, TUC)
Siphocampylus argentinus var. hirticorollinus	ARG(TUC)
Siphocampylus betulaefolius	BRA(PAR, SCA)
Siphocampylus convolvulaceus	BRA(PAR, SCA)
Siphocampylus fiebrigii	ARG(JUJ, SAL)
Siphocampylus fimbriatus	BRA(PAR, SCA)
Siphocampylus foliosus var. minor	ARG(COR)
Siphocampylus foliosus var. subcanus	ARG(CAT, COR, SAL, TUC)
Siphocampylus foliosus var. diversifolius	ARG(CAT, COR, JUJ, LRI, SAL, TUC)
Siphocampylus foliosus var. foliosus	ARG(CAT, COR, JUJ, SAL, TUC)
Siphocampylus foliosus var. glabratus	ARG(COR)
Siphocampylus foliosus var. lessenii	ARG(COR)
Siphocampylus hypopogon	ARG(MIS)
Siphocampylus longepedunculatus	BRA(PAR, SCA)
Siphocampylus lorentzii	ARG(COR)
Siphocampylus lycioides	BRA(PAR)
Siphocampylus nemoralis	ARG(CAT, JUJ, SAL, TUC)
Siphocampylus orbignyanus	ARG(JUJ, SAL)
Siphocampylus sulphureus	BRA(PAR, SCA)
Siphocampylus umbellatus	BRA(PAR)
Siphocampylus verticillatus	ARG(MIS) / BRA(PAR, RGS, SCA) / PRY(APA, AMA, CAU, CAA, CAN, COA, GUA, PAI) / URY(RIV)
Siphocampylus yerbalensis	ARG(MIS)
Siphoneugena crassifolia	BRA(PAR)
Siphoneugena occidentalis	ARG(SAL)
Siphoneugena reitzii	BRA(PAR, RGS, SCA)
Sisymbrium altissimum	ARG(BAI, CHU, LPA, LRI, MEN, NEU, RNE, SCR) / CHL(BIO)
Sisymbrium austriacum	ARG(CHU, SCR) / CHL(COQ, VAL, LBO, ARA, LLA, RME)
Sisymbrium erysimoides	ARG(DFE)
Sisymbrium irio	ARG(BAI, CAT, CHA, CHU, COR, COS, DFE, ERI, FOR, JUJ, LPA, LRI, MEN, MIS, NEU, RNE, SAL, SJU, SLU, SCR, SFE, SDE, TDF, TUC) / CHL(RME) / URY(MON)
Sisymbrium officinale	ARG(BAI, CAT, CHU, COR, ERI, JUJ, LPA, LRI, MEN, NEU, RNE, SAL, SJU, SLU, SCR, SFE, TDF, TUC) / BRA(PAR, RGS) / CHL(ATA, COQ, VAL, LBO, MAU, BIO, ARA, LLA, RME, JFE) / URY(CAS, FLA, MON, SOR)
Sisymbrium orientale	ARG(BAI, CHU, COR, ERI, JUJ, LPA, MEN, NEU, RNE, SAL, SJU, SLU, SCR) / CHL(ANT, COQ, VAL, LBO, BIO, ARA, LLA, MAG, RME) / URY(MON)
Sisymbrium runcinatum	ARG(SCR)
Sisyrinchium acaule	ARG(JUJ, SAL, TUC)
Sisyrinchium alatum	ARG(CHA, JUJ, MIS, TUC) / BRA(Fuera del área del proyecto) / PRY(CAN, PAI)
Sisyrinchium albilapidense	BRA(SCA)
Sisyrinchium andinopatagonicum	ARG(CHU, NEU, RNE)
Sisyrinchium annuum	BRA(RGS)
Sisyrinchium antemeridianum	BRA(RGS, SCA)
Sisyrinchium antucense	CHL(BIO)
Sisyrinchium arenarium ssp. adenostemon	ARG(MEN, SCR) / CHL(VAL, LBO, RME)
Sisyrinchium arenarium ssp. arenarium	ARG(CHA, CHU, MEN, NEU, RNE, SCR) / CHL(COQ, VAL, LBO, MAU, BIO, ARA, AIS, MAG, RME)
Sisyrinchium arrayanicum	CHL(RME)
Sisyrinchium avenaceum	ARG(BAI, ERI, SAL, TUC) / BRA(RGS) / URY(MON, PAY)
Sisyrinchium balansae	PRY(CAA, GUA)
Sisyrinchium biflorum	ARG(TUC)
Sisyrinchium brasiliense	ARG(COS) / BRA(PAR)
Sisyrinchium breviarmium	CHL(RME)
Sisyrinchium brevipes	ARG(JUJ, TUC)
Sisyrinchium bromelioides ssp. bromelioides	BRA(PAR, RGS)
Sisyrinchium bromelioides ssp. angustius	ARG(COS, MIS) / BRA(PAR)
Sisyrinchium calathinum	PRY(CAU, CAN, SPE)
Sisyrinchium chilense ssp. chilense	ARG(BAI, CAT, CHA, CHU, COR, COS, ERI, JUJ, LRI, MEN, MIS, NEU, RNE, SAL, SJU, SLU, SCR, SFE, TDF, TUC) / BRA(PAR) / CHL(COQ, VAL, LBO, MAU, BIO, ARA, LLA, AIS, MAG, RME) / PRY(ÑEE) / URY(CAS, CLA, TAC)
Sisyrinchium chilense ssp. macranthum	ARG(CAT, COR)
Sisyrinchium ciliolatum	ARG(COS, ERI)
Sisyrinchium claritae	ARG(COS) / BRA(RGS) / URY(LAV, ROC)
Sisyrinchium coalitum	BRA(SCA)
Sisyrinchium commutatum	ARG(CHA, COS, ERI, MIS) / BRA(PAR, RGS) / PRY(CEN, COA, ITA, MIE, ÑEE, PAI) / URY(CLA)
Sisyrinchium congestum	BRA(PAR, RGS)
Sisyrinchium cuspidatum	ARG(CHU, NEU, RNE, SCR) / CHL(COQ, VAL, LBO, MAU, BIO, ARA, RME)
Sisyrinchium cylindrocarpium	URY(Desconocida)
Sisyrinchium dasypathum ssp. glabrum	ARG(COS)
Sisyrinchium dasypathum ssp. dasyspathum	ARG(MIS) / BRA(SCA) / PRY(ITA, PAI)
Sisyrinchium decumbens	BRA(RGS, SCA)
Sisyrinchium densiflorum	BRA(PAR)
Sisyrinchium deseadense	ARG(CHU, SCR)
Sisyrinchium exifolium	ARG(MEN)
Sisyrinchium fasciculatum ssp. hoehneii	ARG(COS, MIS) / BRA(PAR, RGS) / PRY(APA, CAU, MIE)
Sisyrinchium fasciculatum ssp. fasciculatum	ARG(COS, MIS) / BRA(PAR, RGS) / PRY(CAU, CAA, CAN, COA, PAI, SPE)
Sisyrinchium fiebrigii	BRA(RGS) / PRY(CAA, CAN, COA, PAI)
Sisyrinchium flabellatum	BRA(RGS)
Sisyrinchium foliosum	ARG(CHA, COS, FOR, TUC) / PRY(COA, PAI)
Sisyrinchium glaziovii	BRA(RGS, SCA)
Sisyrinchium graminifolium	ARG(RNE, TDF) / CHL(ANT, ATA, COQ, VAL, LBO, MAU, BIO, ARA, RME)
Sisyrinchium gratissimum	CHL(RME)
Sisyrinchium hasslerianum	ARG(CHA, COS, MIS) / BRA(PAR, RGS) / PRY(CAN, CEN, CON, GUA, ITA, MIE, PAI, SPE)
Sisyrinchium hirsutum	BRA(SCA) / PRY(AMA, CAN, SPE)
Sisyrinchium humidum	BRA(PAR, SCA)
Sisyrinchium humile	ARG(CHU, MEN, NEU, RNE)
Sisyrinchium hypsophilum	ARG(JUJ, TUC)
Sisyrinchium igatimiense	PRY(CON)
Sisyrinchium inclinatum	ARG(SCR, TDF) / CHL(MAG)
Sisyrinchium incurvatum	ARG(MIS) / BRA(PAR) / URY(CLA, PAY, RIV, SJO)
Sisyrinchium jamesonii	ARG(CAT, SAL)
Sisyrinchium laevigatum	CHL(VAL, RME)
Sisyrinchium latiusculum	ARG(MIS)
Sisyrinchium laxum	ARG(BAI, CHU, COR, COS, JUJ, RNE, TUC) / BRA(PAR, RGS) / PRY(COA, PAI) / URY(CAS, CLA, COL, FLO, FLA, MON, ROC, SOR)
Sisyrinchium limarinum	CHL(COQ)
Sisyrinchium luzula	ARG(COS, ERI, MIS) / BRA(PAR, SCA) / PRY(AMA, CON, COA, PAI, SPE)
Sisyrinchium macrocarpum	ARG(CAT, CHU, LRI, MEN, RNE, SJU)
Sisyrinchium maipoanum	CHL(RME)
Sisyrinchium marchioides	ARG(COS, FOR, MIS) / PRY(APA, CAU, CAN, ITA, PAI, PHA)
Sisyrinchium megapotamicum	ARG(BAI, COR, COS, ERI, FOR, MIS, SFE) / BRA(PAR, RGS) / URY(ART, SOR)
Sisyrinchium micranthum ssp. micranthum	ARG(BAI, CAT, COS, ERI, JUJ, MIS, SAL, SJU, SFE, TUC) / BRA(PAR, RGS, SCA) / PRY(CAA, CAN, CEN, CON, GUA, ITA, PAI)
Sisyrinchium micranthum ssp. valdivianum	ARG(COR, MEN, NEU, SJU, SLU) / CHL(LLA) / PRY(CAA, GUA, ITA, PAI) / URY(MON)
Sisyrinchium minus ssp. everrucosum	ARG(BAI, CHA, COS, ERI, MIS, SFE)
Sisyrinchium minus ssp. minus	ARG(BAI, CHA, COS, ERI) / PRY(ITA) / URY(PAY, SJO)
Sisyrinchium minutiflorum	ARG(BAI, CHA, COR, COS, ERI, FOR, LPA, MIS, SFE, SLU) / BRA(RGS) / PRY(COA, PAI) / URY(CAS, MON)
Sisyrinchium nanum	ARG(CHU, NEU, RNE, SCR) / CHL(LLA, AIS, MAG)
Sisyrinchium nembyense	ARG(CHA, COS) / PRY(CEN, COA)
Sisyrinchium nidulare	BRA(PAR)
Sisyrinchium orbiculatum	CHL(LBO)
Sisyrinchium oxyspathum	PRY(CAU)
Sisyrinchium pachyrhizum ssp. pachyrhizum	ARG(BAI, CAT, CHA, COR, COS, ERI, FOR, MEN, MIS, SAL, SDE, SFE, SLU, TUC) / BRA(PAR, RGS) / PRY(APY, CAA, CEN, CON, COA, GUA, PAI, PHA) / URY(CLA, FLO, FLA, MAL, MON, PAY, RNO, SAO, SOR)
Sisyrinchium pachyrhizum ssp. procerum	ARG(BAI)
Sisyrinchium pachyrhizum ssp. pertenue	ARG(COS)
Sisyrinchium pachyrhizum ssp. columellosum	ARG(SAL, TUC)
Sisyrinchium pachyrhizum f. cyaneum	ARG(COR, COS, SLU) / PRY(CAA, CON, COA, PHA)
Sisyrinchium palmifolium ssp. palmifolium	ARG(BAI, CHA, COR, COS, ERI, FOR, JUJ, MIS, SAL, SDE, TUC) / BRA(PAR, RGS, SCA) / PRY(CAU, CAN, COA, GUA, ITA, SPE) / URY(CLA, FLA, MAL, RNO, SJO)
Sisyrinchium palmifolium ssp. fuscoviride	ARG(BAI, ERI, SFE) / PRY(CAU)
Sisyrinchium patagonicum	ARG(CHU, NEU, RNE, SCR, TDF) / CHL(COQ, VAL, MAU, BIO, ARA, LLA, AIS, MAG)
Sisyrinchium paucispathum	ARG(CHU, MIS, SCR)
Sisyrinchium pearcei	CHL(ARA, LLA, AIS, MAG)
Sisyrinchium pendulum	BRA(PAR)
Sisyrinchium pictum	PRY(CAN, COA, SPE)
Sisyrinchium platense	ARG(BAI, CHA, COR, COS, DFE, ERI, FOR, JUJ, LPA, SJU, SLU, SFE) / BRA(PAR, SCA) / PRY(GUA, MIE) / URY(CAS, CLA, MON, PAY, SJO, SOR)
Sisyrinchium platycaule	ARG(BAI, CHA, COS, MIS) / PRY(APA, CAU, CEN, GUA, PAI, PHA)
Sisyrinchium plicatulum	BRA(PAR, RGS, SCA) / PRY(ITA)
Sisyrinchium purpurellum ssp. trichospathum	BRA(PAR)
Sisyrinchium purpurellum ssp. purpurellum	ARG(COS) / BRA(PAR)
Sisyrinchium rambonis	BRA(PAR, RGS)
Sisyrinchium rectilineum	BRA(PAR, SCA)
Sisyrinchium reitzii	BRA(SCA) / PRY(APA, CAN)
Sisyrinchium restioides	ARG(COS) / BRA(PAR, SCA) / PRY(COA, SPE) / URY(LAV, RIV)
Sisyrinchium rigidifolium	ARG(JUJ)
Sisyrinchium rosengurttii	URY(CLA, FLA, MAL)
Sisyrinchium scalarium	ARG(CHA, COS)
Sisyrinchium scariosum	ARG(MIS) / BRA(PAR, RGS) / URY(CAS, MAL, MON, ROC)
Sisyrinchium schottii	URY(Desconocida)
Sisyrinchium sellowianum	ARG(COS, MIS) / BRA(PAR, RGS, SCA) / PRY(ITA) / URY(DUR, MON, SJO)
Sisyrinchium setaceum	ARG(CAT, COR, COS, MIS, SDE, TUC) / BRA(PAR, RGS, SCA)
Sisyrinchium sinuosum	PRY(CAU)
Sisyrinchium soboliferum	ARG(COS, FOR, MIS) / BRA(PAR, SCA) / PRY(COA, PAI)
Sisyrinchium somuncurense	ARG(RNE)
Sisyrinchium striatum	ARG(CHU, MEN) / CHL(COQ, VAL, LBO, MAU, BIO, ARA, RME)
Sisyrinchium subnudum	ARG(COS, MIS) / BRA(Fuera del área del proyecto) / PRY(APA, AMA, PAI)
Sisyrinchium subtile	PRY(COA)
Sisyrinchium tafiense	ARG(TUC)
Sisyrinchium teleanthum	BRA(PAR)
Sisyrinchium tinctorium	ARG(CAT, JUJ, SAL)
Sisyrinchium tofoense	CHL(COQ)
Sisyrinchium tucumanum	ARG(TUC)
Sisyrinchium uliginosum	ARG(ERI) / BRA(PAR, RGS, SCA)
Sisyrinchium unguiculatum	ARG(CAT, COR, JUJ, LRI, MEN, SJU, SLU, TUC)
Sisyrinchium vaginatum ssp. marchio	ARG(CHA, FOR) / BRA(RGS) / PRY(CAN)
Sisyrinchium vaginatum ssp. vaginatum	ARG(BAI, COS, ERI, MIS) / BRA(PAR, RGS, SCA) / PRY(APA, AMA, CAU, CAN, CEN, CON, COA, ITA, PAI, PHA, SPE) / URY(CAS, COL, MON)
Sisyrinchium valparadiseum	CHL(VAL)
Sisyrinchium vestitum	CHL(RME)
Sisyrinchium weirii	BRA(Fuera del área del proyecto) / PRY(AMA, CAN)
Sisyrinchium wettsteinii	BRA(PAR, RGS, SCA) / PRY(ITA, SPE)
Sium latifolium	CHL(ATA, COQ, VAL)
Skeptrostachys arechavaletanii	BRA(PAR, RGS, SCA) / URY(MAL, RIV, TAC)
Skeptrostachys balanophorastachya	ARG(CHA) / BRA(PAR, RGS, SCA) / PRY(GUA) / URY(MAL, SJO)
Skeptrostachys berroana	URY(LAV)
Skeptrostachys congestiflora	BRA(PAR)
Skeptrostachys correana	ARG(COS)
Skeptrostachys disoides	ARG(MIS) / BRA(PAR)
Skeptrostachys gigantea	ARG(COS, MIS) / BRA(RGS) / PRY(APA) / URY(MAL, TAC)
Skeptrostachys montevidensis	BRA(PAR, RGS) / URY(MAL, MON)
Skeptrostachys paraguayensis	ARG(CHA, COS, ERI, MIS, SAL) / BRA(PAR, RGS, SCA) / PRY(AMA, CAN, MIE) / URY(MAL, RNO, ROC)
Skeptrostachys rupestris	BRA(PAR, RGS) / PRY(COA)
Skytanthus acutus	CHL(ANT, ATA, COQ)
Sloanea garckeana	BRA(PAR, SCA)
Sloanea guianensis	BRA(PAR, SCA)
Sloanea lasiocoma	ARG(MIS) / BRA(PAR, RGS, SCA)
Sloanea monosperma	BRA(PAR, RGS, SCA)
Smallanthus connatus	ARG(BAI, COS, ERI, MIS) / BRA(PAR, RGS, SCA) / CHL(VAL) / PRY(APA, CAN, MIE, PAI) / URY(COL, MAL, RNO, ROC, TAC, TYT)
Smallanthus macroscyphus	ARG(JUJ, MIS, SAL, TUC) / BRA(PAR, RGS, SCA) / PRY(CAA)
Smallanthus siegesbeckia	BRA(PAR) / PRY(GUA)
Smilax assumptionis	ARG(COS, FOR, MIS) / PRY(APY, CEN, CON, COA, GUA, PHA, SPE)
Smilax campestris	ARG(BAI, CHA, COR, COS, ERI, FOR, JUJ, MIS, SAL, SDE, SFE, TUC) / BRA(PAR, RGS, SCA) / PRY(CAU, CAA, CAN, CEN, COA, GUA, ITA, ÑEE, PAI) / URY(COL, FLO, FLA, MAL, RNO, ROC, SAO, SJO)
Smilax cognata	ARG(COS, MIS) / BRA(PAR, RGS, SCA) / PRY(CAA, COA, GUA, ITA, ÑEE)
Smilax elastica	BRA(PAR, SCA)
Smilax fluminensis	ARG(COS, MIS) / BRA(PAR) / PRY(AMA, CAU, CAN, CON, COA, GUA, MIE, SPE)
Smilax goyazana	BRA(Fuera del área del proyecto) / PRY(AMA, CAN, CON, SPE)
Smilax lappacea	BRA(PAR, SCA)
Smilax larvata	BRA(PAR)
Smilax pilcomayensis	ARG(COS, FOR, MIS) / PRY(APY, CEN, CON, SPE)
Smilax polyantha	BRA(PAR) / PRY(AMA)
Smilax quinquenervia	BRA(PAR, RGS, SCA)
Smilax rufescens	BRA(PAR, SCA)
Smilax staminea	BRA(PAR, SCA)
Smilax stenophylla	BRA(PAR)
Solanum abutiloides	ARG(JUJ, SAL, TUC)
Solanum acaule	ARG(CAT, JUJ, LRI, SAL, SJU, TUC)
Solanum aculeatissimum	BRA(PAR, RGS, SCA) / PRY(GUA)
Solanum adscendens	ARG(COS, MIS) / BRA(RGS) / PRY(CON)
Solanum adspersum	BRA(PAR)
Solanum aenictum	ARG(COS, MIS) / PRY(GUA, ITA)
Solanum affine	BRA(PAR, RGS, SCA)
Solanum alatirameum	BRA(PAR, RGS, SCA)
Solanum albidum	ARG(SAL)
Solanum aligerum	ARG(CAT, JUJ, SAL, TUC)
Solanum aloysiifolium	ARG(CAT, COR, JUJ, LRI, SAL, SFE, TUC)
Solanum alphonsei var. alphonsei	CHL(LBO, MAU)
Solanum alternatopinnatum	ARG(MIS) / BRA(PAR, SCA) / PRY(APA, CAU, CAA, CAN, COA, GUA)
Solanum americanum	ARG(BAI, CHA, COR, COS, ERI, FOR, LPA, LRI, MIS, SFE, TUC) / BRA(PAR, RGS, SCA) / CHL(ANT, VAL, LBO) / PRY(APY, APA, AMA, CAA, CAN, CEN, COA, GUA, ITA, ÑEE, PAI, PHA) / URY(MON, TAC)
Solanum amygdalifolium	ARG(BAI, CAT, CHA, COR, COS, DFE, ERI, FOR, LRI, MEN, MIS, SAL, SJU, SFE, SDE, TUC) / BRA(RGS) / PRY(APY, BOQ, CEN, CON, COA, GUA, ITA, MIE, PAI, PHA) / URY(COL, MON, TAC)
Solanum angustifidum	ARG(BAI, CAT, CHA, COR, COS, ERI, FOR, JUJ, LRI, SAL, SJU, SLU, SFE, TUC)
Solanum annuum	ARG(CAT, JUJ, LRI, SAL, TUC)
Solanum anoacanthum	BRA(PAR)
Solanum apaense	BRA(Fuera del área del proyecto) / PRY(CON)
Solanum aparadense	BRA(RGS, SCA)
Solanum apiahyense	BRA(PAR, SCA)
Solanum arenarium	BRA(RGS)
Solanum argenteum	BRA(PAR)
Solanum argentinum	ARG(CAT, CHA, COR, COS, FOR, JUJ, LPA, LRI, SAL, SFE, SDE, TUC) / PRY(APA, APY, BOQ, CAA, CEN, PHA)
Solanum aridum	ARG(CAT, CHA, COR, FOR, JUJ, SAL, SFE, SDE, TUC) / PRY(APY, PHA)
Solanum atriplicifolium	ARG(CAT, COR, ERI, JUJ, LPA, LRI, MEN, RNE, SAL, SJU, SLU, SDE, TUC)
Solanum atropurpureum	ARG(CHA, COS, ERI, FOR, MIS, SFE) / BRA(PAR, RGS, SCA) / PRY(APA, AMA, CAA, CAN, CON, GUA, ITA, PAI, PHA, SPE) / URY(TAC)
Solanum berthaultii	ARG(CAT, JUJ, SAL)
Solanum betaceum	ARG(JUJ, SAL, SDE, TUC) / BRA(Fuera del área del proyecto)
Solanum bistellatum	BRA(PAR, RGS, SCA)
Solanum boliviense	ARG(CAT, JUJ, SAL, TUC)
Solanum bonariense	ARG(BAI, DFE, ERI, MIS) / URY(CLA, MON, SOR)
Solanum brachyantherum	CHL(TAR, ANT, ATA, IDE)
Solanum brevicaule	ARG(CAT, JUJ, LRI, SAL, SJU, TUC)
Solanum brevipedunculatum	ARG(JUJ, SAL)
Solanum bridgesii var. ocellatum	CHL(RME)
Solanum bridgesii var. bridgesii	CHL(LBO, RME)
Solanum bullatum	BRA(PAR, SCA)
Solanum caavurana	ARG(CHA, COS, FOR, MIS) / BRA(PAR, SCA) / PRY(APA, AMA, CAU, CAN, CEN, CON, COA, GUA, ITA, MIE, ÑEE, PAI, PHA, SPE)
Solanum caesium	ARG(JUJ, SAL)
Solanum calileguae	ARG(JUJ, SAL)
Solanum campaniforme	BRA(PAR, RGS, SCA)
Solanum canoasense	BRA(PAR, SCA)
Solanum capsicoides	ARG(COS, MIS) / BRA(PAR, RGS, SCA) / PRY(ÑEE)
Solanum cassioides	BRA(PAR, RGS, SCA)
Solanum castaneum	BRA(PAR)
Solanum chacoense	ARG(BAI, CAT, CHA, COR, COS, ERI, FOR, JUJ, LPA, LRI, MIS, SAL, SDE, SFE, SLU, TUC) / BRA(PAR, RGS, SCA) / PRY(APA, APY, CAA, CEN, COA, GUA, ITA, MIE, PAI, PHA) / URY(SOR)
Solanum chamaesarachidium	ARG(CAT, JUJ, LRI, SAL, TUC)
Solanum chenopodioides	ARG(BAI, COR, COS, ERI, LPA, LRI, MEN, MIS, RNE, SAL, SJU, SFE) / BRA(PAR, RGS, SCA) / PRY(ÑEE, PHA) / URY(COL, FLA, MON, ROC, SJO)
Solanum chilense	CHL(TAR, ANT)
Solanum cinnamomeum	BRA(PAR)
Solanum commersonii ssp. commersonii	ARG(BAI, CHA, COS, ERI, MIS) / BRA(RGS, SCA) / URY(CAS, COL, DUR, FLA, LAV, MAL, MON, PAY, RNO, RIV, ROC, SAO, SJO, SOR)
Solanum compressum	ARG(MIS, SAL) / BRA(PAR, RGS, SCA) / PRY(ITA)
Solanum comptum	ARG(CHA, COS, FOR) / PRY(APY, APA, CEN)
Solanum concarense	ARG(SLU)
Solanum concinnum	BRA(PAR, RGS, SCA)
Solanum confusum	ARG(CAT, JUJ, SAL, TUC)
Solanum consimile	ARG(JUJ, SAL)
Solanum coquimbense	CHL(COQ)
Solanum corumbense	BRA(Fuera del área del proyecto) / PRY(CON)
Solanum corymbiflorum ssp. mortoniana	BRA(PAR, SCA)
Solanum corymbiflorum ssp. corymbiflorum	ARG(COS, MIS) / BRA(PAR, RGS, SCA)
Solanum coxii	CHL(LLA)
Solanum crispum	ARG(MEN, NEU) / CHL(COQ, VAL, LBO, MAU, BIO, ARA, LLA, RME)
Solanum cylindricum	ARG(MIS) / BRA(PAR, RGS, SCA)
Solanum delicatulum	ARG(COS, MIS) / BRA(PAR, RGS, SCA) / PRY(CAN, GUA)
Solanum delitescens	ARG(CAT, JUJ, SAL, TUC)
Solanum didymum	ARG(MIS) / BRA(PAR, RGS, SCA)
Solanum diploconos	BRA(PAR, RGS, SCA) / PRY(APA)
Solanum echegarayi	ARG(CAT, JUJ, LRI, MEN, SAL, SJU) / CHL(VAL)
Solanum elaeagnifolium	ARG(BAI, CAT, CHA, CHU, COR, COS, DFE, ERI, FOR, JUJ, LPA, LRI, MEN, NEU, RNE, SAL, SJU, SLU, SFE, SDE, TUC) / CHL(TAR, ANT, ATA, COQ, VAL, RME) / PRY(APY, CEN, PHA) / URY(COL, MON, PAY, SOR)
Solanum endoadenium	ARG(CAT, COR, LRI, SAL, SJU, SDE, TUC)
Solanum etuberosum	CHL(VAL, LBO, MAU, BIO, ARA, RME)
Solanum euacanthum	ARG(CAT, COR, JUJ, LPA, LRI, MEN, NEU, RNE, SAL, SJU, SLU, SDE, TUC)
Solanum excisirhombeum	ARG(JUJ)
Solanum fernandezianum	CHL(JFE)
Solanum fiebrigii	ARG(CAT, JUJ, SAL, TUC)
Solanum flaccidum	BRA(PAR, RGS, SCA) / PRY(AMA, SPE)
Solanum fragile	CHL(TAR)
Solanum furcatum	ARG(CHU, NEU, RNE) / CHL(TAR, ANT, ATA, COQ, VAL, LBO, MAU, BIO, ARA, LLA, AIS, RME, JFE)
Solanum fusiforme	ARG(MIS) / BRA(PAR, RGS, SCA) / PRY(APA)
Solanum gaudichaudii	CHL(COQ, VAL)
Solanum gertii	BRA(PAR)
Solanum gilioides	ARG(JUJ, SAL, TUC)
Solanum glandulosipilosum	ARG(JUJ, SAL, TUC)
Solanum glaucophyllum	ARG(BAI, CHA, COR, COS, DFE, ERI, FOR, MIS, SAL, SFE, TUC) / BRA(RGS, SCA) / PRY(APY, CEN, CON, COA, MIE, ÑEE, PAI, PHA, SPE) / URY(CAS, CLA, COL, MON, ROC, SJO)
Solanum gnaphalocarpon	BRA(PAR)
Solanum granulosum-leprosum	ARG(BAI, CHA, COS, ERI, FOR, MIS, SFE) / BRA(PAR, RGS, SCA) / PRY(APA, AMA, CAA, CAN, CEN, CON, COA, GUA, ÑEE, PAI, PHA, SPE) / URY(ROC, SJO)
Solanum guaraniticum	ARG(COS, MIS) / BRA(PAR, RGS, SCA) / PRY(APA, CAU, CAA, CAN, CEN, GUA, ITA, MIE, PAI, PHA)
Solanum hasslerianum	ARG(COS, MIS) / BRA(PAR, RGS) / PRY(APA, AMA, CAU, CAA, CAN, GUA, PAI, PHA, SPE)
Solanum hastatilobum	ARG(CAT, COR, LRI, MEN, SJU, SLU)
Solanum heleonastes	ARG(CHA, COS, MIS) / PRY(CAA, ÑEE)
Solanum herbabona	CHL(ATA)
Solanum hieronymi	ARG(CAT, CHA, COR, COS, ERI, FOR, JUJ, LRI, SAL, SJU, SLU, SDE, TUC) / PRY(APY)
Solanum hirtellum	ARG(COS, MIS) / BRA(PAR, RGS, SCA) / PRY(APA, AMA, CAU, CAA, CAN, GUA, PAI, SPE)
Solanum hoehnei	BRA(PAR, SCA)
Solanum homalospermum	ARG(CAT, COR)
Solanum huayavillense	ARG(JUJ, TUC)
Solanum incarceratum	BRA(PAR) / PRY(CAN, CEN)
Solanum incisum var. paucilobatum	ARG(CAT, COR, TUC)
Solanum indivisum	CHL(VAL)
Solanum infundibuliforme	ARG(JUJ, SAL) / CHL(TAR)
Solanum inodorum	BRA(PAR, RGS, SCA)
Solanum interandinum	CHL(JFE)
Solanum julocrotonoides	ARG(MIS) / BRA(Fuera del área del proyecto) / PRY(APA, AMA, CAU)
Solanum juvenale	ARG(BAI, CAT, COR, LPA, LRI, SJU, SLU, SFE, SDE, TUC) / PRY(APY) / URY(PAY, RNO)
Solanum kleinii	BRA(PAR, RGS, SCA)
Solanum kurtzianum	ARG(CAT, LRI, MEN, SJU)
Solanum lacerdae	BRA(PAR, SCA)
Solanum laxum	ARG(BAI, COR, COS, DFE, ERI, MEN, MIS) / BRA(PAR, RGS, SCA) / PRY(APA, CAA, CAN, COA, GUA, ITA, PAI, SPE) / URY(CAS, COL, FLA, MON, RIV, ROC, SAO, SJO, TAC)
Solanum luridifuscescens	BRA(PAR)
Solanum lycocarpum	BRA(PAR) / PRY(APA, AMA, CAN, CON, SPE)
Solanum lycopersicoides	CHL(TAR)
Solanum maglia	ARG(MEN) / CHL(COQ, VAL, MAU, BIO, ARA, LLA)
Solanum malmeanum	ARG(BAI, CHA, COS, ERI, FOR, MIS, SFE) / BRA(RGS) / PRY(CEN, COA, GUA, ITA)
Solanum marginatum	CHL(VAL, MAU, BIO, JFE)
Solanum matadori	BRA(SCA)
Solanum maturecalvans	ARG(JUJ, SAL)
Solanum mauritianum	BRA(PAR, RGS, SCA) / URY(MON, PAY, RIV, ROC, SAO, TAC)
Solanum medians	CHL(TAR, ANT)
Solanum megalochiton	BRA(PAR, RGS, SCA)
Solanum melissarum	BRA(PAR, SCA)
Solanum microdontum	ARG(CAT, JUJ, LRI, SAL, TUC)
Solanum montanum	CHL(TAR, ANT, ATA, COQ)
Solanum montigenum	ARG(CAT, JUJ, TUC)
Solanum mortonii	ARG(CAT)
Solanum multispinum	ARG(FOR, SFE) / PRY(APY, PHA)
Solanum neei	ARG(MIS) / BRA(PAR, RGS, SCA)
Solanum neorossii	ARG(JUJ, SAL)
Solanum nigrum	CHL(VAL, MAU)
Solanum nitidibaccatum	ARG(BAI, CAT, CHU, COR, ERI, LPA, LRI, MEN, NEU, RNE, SJU, SLU, SCR, SDE) / CHL(MAG)
Solanum nitidum	CHL(TAR)
Solanum odoriferum	BRA(PAR, RGS, SCA)
Solanum olympicum	ARG(JUJ, SAL, TUC) / BRA(Fuera del área del proyecto) / PRY(APY, AMA, CAU, CAN, CON, COA, PAI)
Solanum pabstii	BRA(PAR, RGS, SCA)
Solanum palinacanthum	ARG(CAT, CHA, COR, COS, FOR, JUJ, MIS, SAL, SLU, SDE, TUC) / BRA(PAR, RGS, SCA) / PRY(APA, APY, AMA, CAU, CAA, CAN, CEN, CON, COA, GUA, ITA, MIE, ÑEE, PAI, SPE)
Solanum palitans	ARG(BAI, CAT, COR, JUJ, SAL, TUC)
Solanum palustre	ARG(NEU, RNE) / CHL(VAL, LBO, BIO, ARA, LLA)
Solanum paniculatum	ARG(COS) / BRA(PAR, RGS, SCA) / PRY(APY, AMA, CAA, CAN, CEN, CON, ITA, MIE, SPE)
Solanum paposanum	CHL(TAR, ANT, ATA, COQ)
Solanum paranense	BRA(PAR, RGS, SCA)
Solanum pedersenii	ARG(COS, ERI)
Solanum pelagicum	BRA(SCA)
Solanum pennellii var. elachistus	CHL(TAR)
Solanum pentlandii	CHL(TAR)
Solanum peruvianum	CHL(TAR)
Solanum physalifolium var. physalifolium	ARG(CAT, FOR, JUJ, SAL, TUC)
Solanum pilcomayense	ARG(CHA, COR, COS, DFE, ERI, FOR, LRI, MIS, SAL, SLU, SFE, SDE, TUC) / BRA(PAR, RGS, SCA) / PRY(APY, BOQ, CAN, CEN, CON, COA, PHA)
Solanum piluliferum	BRA(PAR, SCA)
Solanum pimpinellifolium	CHL(ATA)
Solanum pinetorum	BRA(PAR, SCA)
Solanum pinnatum	CHL(TAR, ANT, ATA, COQ, VAL, LBO, MAU, BIO, RME)
Solanum platense	ARG(BAI, ERI, MIS) / BRA(RGS, SCA) / URY(MAL, RIV, ROC, TYT)
Solanum platycypellon	ARG(JUJ, SAL)
Solanum polyphyllum	CHL(TAR)
Solanum premnifolium	BRA(PAR)
Solanum profusum	ARG(JUJ, SAL)
Solanum pseudocapsicum	ARG(BAI, CAT, CHA, COS, DFE, ERI, FOR, JUJ, LRI, MIS, SLU, SFE) / BRA(PAR, RGS, SCA) / CHL(ANT, COQ, BIO, RME, JFE) / PRY(APY, AMA, CAU, CAA, CAN, CEN, COA, GUA, MIE, ÑEE, PHA, SPE) / URY(CAS, FLA, LAV, MON, RNO, RIV, ROC, SJO, SOR)
Solanum pseudodaphnopsis	BRA(PAR, SCA)
Solanum pseudoquina	ARG(COS, MIS) / BRA(PAR, RGS, SCA) / PRY(APA, CAN, COA, SPE)
Solanum pygmaeum var. pygmaeum	ARG(BAI, CHA, COR, COS, ERI, LPA, LRI, NEU, SLU, SFE, SDE)
Solanum radicans	CHL(TAR, ATA, COQ, LBO)
Solanum ramulosum	ARG(COS, MIS) / BRA(PAR, RGS, SCA) / PRY(APA, CAU, GUA, PAI)
Solanum reductum	ARG(CAT, JUJ, LRI, SAL, SDE, TUC)
Solanum reflexum	BRA(PAR, RGS, SCA)
Solanum reineckii	BRA(RGS, SCA)
Solanum reitzii	BRA(PAR, RGS, SCA)
Solanum remyanum	CHL(ANT, ATA, COQ)
Solanum riparium	ARG(CAT, JUJ, LPA, SAL, TUC)
Solanum robustum	ARG(CHA, COS, FOR, MIS) / BRA(PAR, SCA) / PRY(APA, CEN, COA, GUA, ITA, MIE, ÑEE, PAI, PHA, SPE)
Solanum rostratum	ARG(SLU)
Solanum rufescens	BRA(PAR, SCA)
Solanum salamancae	ARG(CAT, SAL, TUC)
Solanum saldanhae	BRA(PAR)
Solanum salicifolium	ARG(CAT, COR, JUJ, LPA, LRI, MEN, RNE, SAL, SJU, SLU, TUC) / PRY(APY, COA, PHA) / URY(LAV)
Solanum sanctae-catharinae	ARG(MIS) / BRA(PAR, RGS, SCA) / PRY(APA, APY, CAN, COA, PAI) / URY(CLA, RIV, TAC, TYT)
Solanum sanfurgoi	CHL(MAU)
Solanum sarrachoides	ARG(BAI, CAT, COR, ERI, MEN, NEU, SAL, SJU) / BRA(RGS) / CHL(VAL, LBO, MAU) / PRY(APY, PHA) / URY(MAL, MON, SOR)
Solanum schlechtendalianum	ARG(JUJ, SAL) / BRA(Fuera del área del proyecto)
Solanum schwackei	BRA(PAR, SCA)
Solanum sciadostylis	ARG(COS, MIS) / BRA(PAR, RGS) / PRY(AMA, CAA, GUA)
Solanum scuticum	BRA(PAR, SCA) / PRY(AMA)
Solanum seaforthianum	BRA(PAR, RGS) / PRY(APA, CEN, COA)
Solanum sellowianum	BRA(PAR)
Solanum setosissimum	BRA(PAR, SCA)
Solanum sinuatiexcisum	ARG(CAT, JUJ, SAL, TUC)
Solanum sinuatirecurvum	ARG(CAT, JUJ, LRI, SAL) / CHL(ANT)
Solanum sisymbriifolium	ARG(BAI, CAT, CHA, COR, COS, ERI, FOR, JUJ, LRI, MIS, SAL, SDE, SFE, SLU, TUC) / BRA(PAR, RGS, SCA) / CHL(VAL, BIO) / PRY(APY, CEN, COA, ÑEE, PAI, PHA) / URY(COL, MON)
Solanum sitiens	CHL(ANT)
Solanum stipulatum	BRA(PAR, SCA)
Solanum stuckertii	ARG(CAT, COR, JUJ, LRI, SAL, SDE, SLU, TUC)
Solanum subsylvestris	BRA(PAR, RGS, SCA)
Solanum swartzianum	BRA(PAR, SCA)
Solanum symmetricum	ARG(CAT, COS, FOR, JUJ, MIS, SAL, SFE, TUC) / BRA(PAR) / PRY(APA, CAA, CAN, CEN, COA, GUA, ITA, PAI)
Solanum tenuispinum	ARG(CAT, JUJ, SAL, TUC)
Solanum toldense	ARG(SAL)
Solanum trachytrichium	ARG(MIS) / BRA(PAR, RGS, SCA) / PRY(APA, CAN, GUA, ITA)
Solanum trichoneuron	ARG(JUJ, SAL, TUC)
Solanum triflorum	ARG(BAI, CHU, COR, LPA, LRI, MEN, NEU, RNE, SCR, SJU, SLU, TUC)
Solanum trinomium	CHL(ATA, COQ, VAL)
Solanum tripartitum	ARG(JUJ, SAL)
Solanum tuberosum ssp. tuberosum	CHL(ANT, VAL, LBO, BIO, ARA, LLA, AIS, RME)
Solanum tucumanense	ARG(CAT, CHA, COR, COS, FOR, JUJ, LRI, MIS, SAL, TUC)
Solanum turneroides	ARG(JUJ, SAL) / BRA(Fuera del área del proyecto) / PRY(APY, AMA, CAU, CAN, CON, COA, PAI)
Solanum tweedianum	ARG(BAI, CAT, COR, JUJ, LRI, MEN, SAL, SJU, SLU, SDE, TUC) / CHL(VAL) / PRY(APY, BOQ) / URY(MON)
Solanum uncinellum	ARG(CHA, COS, ERI, FOR, JUJ, MIS, SAL) / BRA(Fuera del área del proyecto) / PRY(APY, COA, PAI, PHA, SPE)
Solanum vaillantii	ARG(MIS) / BRA(PAR, RGS, SCA)
Solanum valdiviense	ARG(NEU) / CHL(BIO, ARA, LLA, AIS)
Solanum variabile	BRA(PAR, RGS, SCA) / PRY(APA)
Solanum velleum	BRA(SCA)
Solanum venturii	ARG(CAT, JUJ, LRI, SAL, TUC)
Solanum vernei	ARG(CAT, JUJ, SAL, TUC)
Solanum viarum	ARG(CHA, COS, ERI, FOR, MIS, SFE) / BRA(PAR, RGS, SCA) / PRY(APA, APY, CAA, CEN, COA, GUA, ÑEE, PAI, SPE) / URY(MON, RIV, TAC, TYT)
Solanum viscosissimum	BRA(PAR, RGS, SCA)
Solanum wacketii	BRA(PAR, RGS, SCA)
Solanum weddellii	CHL(TAR, ANT)
Solanum x aemulans	ARG(JUJ, LRI, SAL)
Solanum x brucheri	ARG(JUJ)
Solanum x rechei	ARG(LRI)
Solanum zuloagae	ARG(JUJ, SAL)
Solaria brevicoalita	CHL(MAU)
Solaria curacavina	CHL(RME)
Solaria miersioides	ARG(NEU) / CHL(MAU, BIO, RME)
Soleirolia soleirolii	CHL(COQ, VAL, BIO, ARA, LLA, RME)
Solenomelus pedunculatus	CHL(COQ, VAL, LBO, MAU, BIO, ARA, LLA, RME)
Solenomelus segethii	ARG(CHU, NEU, RNE, SCR) / CHL(COQ, VAL, LBO, MAU, BIO, ARA, LLA, MAG, RME)
Solidago argentinensis	ARG(CHU, MEN, NEU, RNE) / CHL(VAL)
Solidago chilensis var. chilensis	ARG(BAI, CAT, CHA, CHU, COR, COS, ERI, FOR, JUJ, LPA, LRI, MEN, MIS, NEU, RNE, SAL, SJU, SLU, SCR, SFE, SDE, TUC) / BRA(RGS, SCA) / CHL(TAR, ATA, COQ, VAL, LBO, MAU, BIO, ARA, LLA, AIS, RME, JFE) / PRY(APY, COA) / URY(MON, PAY, SOR)
Solidago microglossa	ARG(CHA, COS, ERI, FOR, JUJ, MIS, SFE, SDE) / BRA(PAR, RGS, SCA) / PRY(APA, APY, CAU, CAA, CEN, COA, GUA, PAI, PHA, SPE)
Solidago patagonica	CHL(AIS)
Solidago virgaurea	ARG(RNE)
Soliva anthemifolia	ARG(BAI, CHA, COR, COS, DFE, ERI, FOR, JUJ, MIS, SAL, SFE, TUC) / BRA(RGS, SCA) / PRY(APY, COA, ITA) / URY(ART, MON)
Soliva macrocephala	ARG(BAI, CHA, COS, DFE, ERI, SFE) / BRA(RGS) / URY(CAS, COL, FLA, MON, SOR)
Soliva sessilis	ARG(BAI, CHA, COR, COS, DFE, ERI, JUJ, LPA, LRI, MIS, RNE, SAL, SFE, TUC) / BRA(PAR, RGS, SCA) / CHL(COQ, VAL, LBO, MAU, BIO, ARA, LLA, RME) / PRY(APA, CON, COA, GUA, MIE, SPE) / URY(COL, FLO, MON)
Soliva stolonifera	ARG(BAI, COS, DFE, ERI) / CHL(MAU, RME) / URY(FLA, MON)
Soliva triniifolia	ARG(COR)
Sommerfeltia cabrerae	URY(RIV, TAC)
Sommerfeltia spinulosa	ARG(BAI) / BRA(RGS, SCA) / URY(CAS, COL, MAL, MON, ROC)
Sonchus arvensis	ARG(MEN) / CHL(MAG)
Sonchus asper	ARG(BAI, CAT, CHA, CHU, COR, COS, DFE, ERI, JUJ, LPA, LRI, MEN, MIS, NEU, RNE, SAL, SJU, SLU, SCR, SFE, TDF) / BRA(RGS, SCA) / CHL(TAR, ANT, ATA, COQ, VAL, LBO, MAU, BIO, ARA, LLA, AIS, MAG, RME, IDE, JFE, IPA) / PRY(GUA) / URY(CLA, FLO, ROC, SOR)
Sonchus oleraceus	ARG(BAI, CAT, CHA, CHU, COR, COS, DFE, ERI, FOR, JUJ, LPA, LRI, MEN, MIS, NEU, RNE, SAL, SJU, SLU, SCR, SFE, SDE, TDF, TUC) / BRA(PAR, RGS, SCA) / CHL(TAR, ANT, ATA, COQ, VAL, LBO, MAU, BIO, LLA, RME, IDE, JFE) / PRY(APY, CAN) / URY(CAS, COL, MAL, MON, PAY, RNO, SJO, SOR)
Sonchus tenerrimus	ARG(BAI, DFE) / CHL(TAR, ANT, ATA, COQ, VAL, LBO, BIO, ARA, LLA, MAG, RME, JFE)
Sophora cassioides	CHL(VAL, MAU, BIO, ARA, LLA, AIS)
Sophora donihuensis	CHL(LBO)
Sophora fernandeziana var. reedeana	CHL(JFE)
Sophora fernandeziana var. fernandeziana	CHL(JFE)
Sophora linearifolia	ARG(COR, SLU)
Sophora macrocarpa	CHL(COQ, VAL, LBO, MAU, BIO, ARA, RME)
Sophora masafuerana	CHL(JFE)
Sophora rhynchocarpa	ARG(SAL, TUC)
Sophora tomentosa	BRA(SCA)
Sophronitis coccinea	ARG(MIS) / BRA(PAR, RGS, SCA)
Sophronitis purpurata	BRA(RGS, SCA)
Sorbus aucuparia	ARG(NEU, RNE)
Sorghastrum balansae	BRA(Fuera del área del proyecto) / PRY(CEN, MIE)
Sorghastrum minarum	ARG(COS, MIS) / BRA(PAR, RGS, SCA) / PRY(CEN, COA)
Sorghastrum nutans	BRA(SCA)
Sorghastrum pellitum	ARG(BAI, CHA, COR, COS, ERI, JUJ, LPA, MEN, MIS, SAL, SFE, SLU, TUC) / BRA(PAR, RGS, SCA) / PRY(COA) / URY(ART, FLA, MAL, ROC, SOR)
Sorghastrum scaberrimum	BRA(PAR, RGS, SCA)
Sorghastrum setosum	ARG(CHA, COS, DFE, ERI, FOR, JUJ, MIS, SFE, TUC) / BRA(PAR, RGS, SCA) / PRY(APY, CEN, CON, GUA) / URY(RIV, TAC)
Sorghastrum stipoides	ARG(BAI, CHA, COS, FOR, JUJ, MIS, SAL, TUC) / BRA(PAR, RGS, SCA) / PRY(CAU) / URY(DUR, TAC)
Sorghastrum viride	ARG(CHA, COS, ERI, MIS) / BRA(PAR, RGS, SCA) / PRY(AMA, CAU, COA, GUA, MIE, SPE) / URY(RIV)
Sorghum almum	BRA(Fuera del área del proyecto) / PRY(AMA)
Sorghum halepense var. halepense	ARG(BAI, CHA, COR, COS, DFE, ERI, LPA, LRI, MIS, RNE, SAL, SJU, SLU, SFE, TUC) / BRA(RGS) / CHL(TAR, ANT, ATA, COQ, VAL, LBO, BIO, ARA, MAG, RME, IPA) / PRY(CEN) / URY(MON)
Sorghum halepense var. muticum	ARG(BAI, CHA, COS, FOR, JUJ, LPA, MIS, NEU, SJU)
Sorocea bonplandii	ARG(COS, MIS) / BRA(PAR, RGS, SCA) / PRY(APA, AMA, CAU, CAA, CAN, COA, GUA, ITA, PAI, SPE)
Sorocea sprucei ssp. saxicola	ARG(CHA, COS, FOR) / BRA(Fuera del área del proyecto) / PRY(APY, CAN, CEN, CON, COA, MIE, ÑEE, PAI, PHA, SPE)
Sparattosperma leucanthum	BRA(Fuera del área del proyecto) / PRY(AMA, CAN, CON, SPE)
Sparaxis bulbifera	ARG(BAI)
Sparaxis tricolor	ARG(BAI)
Spartium junceum	ARG(BAI, ERI, LPA) / CHL(ANT, VAL, MAU, BIO, ARA, RME) / URY(CAS, MON, SOR)
Spathantheum orbignyanum	ARG(JUJ, SAL)
Spathicarpa hastifolia	ARG(CHA, COS, JUJ, MIS, SAL, SFE, TUC) / BRA(PAR, RGS, SCA) / PRY(APY, APA, AMA, CAU, CAA, CAN, CON, COA, GUA, ITA, PAI, SPE) / URY(ART)
Spathicarpa lanceolata	BRA(PAR, RGS, SCA) / PRY(CAU, COA, GUA)
Specklinia fernandiana	BRA(PAR)
Specklinia grobyi	ARG(MIS) / BRA(PAR, RGS, SCA)
Specklinia guimaraensii	BRA(PAR)
Specklinia microtis	BRA(RGS)
Specklinia muscosa var. parvifolia	BRA(SCA)
Specklinia sororcula	BRA(PAR)
Specklinia subpicta	BRA(PAR)
Speea humilis	CHL(VAL, LBO, RME)
Spergula arvensis	ARG(BAI, COR, COS, ERI, NEU, RNE, SCR, TDF) / BRA(RGS) / CHL(COQ, VAL, LBO, MAU, BIO, ARA, LLA, MAG, RME) / PRY(APY) / URY(MON)
Spergula bocconii	ARG(BAI, CHU, SFE) / CHL(VAL, BIO, ARA, RME) / URY(ART, MON, SOR)
Spergula calva	ARG(NEU, RNE)
Spergula cerviana	CHL(ATA, MAU, BIO, ARA, RME)
Spergula depauperata	ARG(MEN, NEU, RNE, SJU) / CHL(VAL, BIO, ARA, LLA, RME)
Spergula diandra	ARG(RNE)
Spergula grandis	ARG(BAI, COR, COS, ERI, LPA, SDE, SFE) / BRA(RGS) / PRY(PHA) / URY(MON, TYT)
Spergula laevis	ARG(BAI, ERI, SCR, SFE) / BRA(RGS) / URY(MON)
Spergula pissisi	ARG(SJU) / CHL(ATA, COQ)
Spergula platensis var. balansae	ARG(COS, ERI)
Spergula platensis var. platensis	ARG(BAI, CHU, COR, COS, ERI, FOR, LPA, RNE, SAL, SCR, SFE, TUC) / CHL(BIO, ARA, RME) / PRY(PHA) / URY(ART, MON)
Spergula ramosa ssp. rossbachiae	ARG(BAI, CHU, LPA, NEU, RNE, SCR) / URY(MON)
Spergula ramosa ssp. ramosa	ARG(BAI, CAT, CHA, CHU, COR, COS, ERI, JUJ, LRI, MEN, NEU, RNE, SAL, SCR, SFE, SJU, SLU, TUC) / BRA(SCA) / PRY(APY, PHA) / URY(SOR, TAC)
Spergula salina	ARG(BAI, CHU, JUJ, MEN, SCR, SFE, TDF)
Spergula villosa	ARG(BAI, CAT, CHA, CHU, COR, COS, ERI, JUJ, LRI, RNE, SJU, SLU, SCR, SFE) / CHL(COQ, VAL, LBO, MAU, BIO, LLA, RME) / URY(MON)
Spergularia aberrans	CHL(ANT)
Spergularia arbuscula	CHL(TAR, ANT, ATA, COQ)
Spergularia confertiflora	CHL(IDE, JFE)
Spergularia cremnophila	CHL(ANT, ATA)
Spergularia denticulata	CHL(ANT, ATA)
Spergularia dillenii	CHL(COQ, MAU, RME)
Spergularia fasciculata	CHL(TAR, ANT)
Spergularia floribunda	CHL(ATA, COQ)
Spergularia marina	ARG(BAI, JUJ, TDF) / CHL(COQ, BIO, AIS, MAG)
Spergularia masafuerana	CHL(JFE)
Spergularia media	CHL(ANT, COQ, VAL, LBO, MAU, BIO, ARA, LLA, AIS, MAG, RME, IDE, JFE)
Spergularia pycnantha	CHL(ATA, COQ, VAL, RME)
Spergularia rupestris	URY(LAV, MAL, SAO, TYT)
Spergularia stenocarpa	CHL(TAR, ANT, ATA)
Spermacoce eryngioides	ARG(BAI, CHA, COS, ERI, FOR, JUJ, MIS, SAL, SFE, SDE, TUC) / BRA(PAR, RGS) / PRY(APY, BOQ, CAU, CEN, CHO, CON, GUA, MIE, ÑEE, PAI, PHA) / URY(FLA)
Spermacoce glabra	ARG(BAI, CHA, COS, ERI, FOR, MIS, SAL, SDE, SFE, TUC) / PRY(APY, ÑEE, PAI, PHA) / URY(FLA, ROC)
Spermacoce hassleri	ARG(CAT, CHA, COS, FOR, JUJ, SAL, SFE, TUC) / BRA(Fuera del área del proyecto) / PRY(APA, APY, BOQ, CAA, CEN, GUA, PHA) / URY(MAL)
Spermacoce ostenii	ARG(COR, SLU)
Spermacoce tenuior	ARG(CAT, JUJ, LRI, SAL, TUC)
Spermacoce viridiflora	PRY(CAU, CON, PAI)
Spermolepis castellanosi	ARG(BAI, CHU, COR, LPA, MEN, NEU, RNE)
Sphaeralcea australis	ARG(BAI, LPA, RNE)
Sphaeralcea bonariensis	ARG(BAI, CAT, CHA, COR, COS, DFE, ERI, FOR, JUJ, LPA, LRI, SAL, SDE, SFE, SJU, SLU, TUC) / BRA(RGS) / PRY(APY, PHA) / URY(COL, MON, PAY, RNO, SJO, SOR)
Sphaeralcea brevipes	ARG(CAT, LRI, MEN, SJU, SLU, TUC)
Sphaeralcea chenopodifolia	ARG(CHA, COS, ERI, SFE)
Sphaeralcea cordobensis	ARG(COR, SDE, SLU)
Sphaeralcea crispa	ARG(BAI, LPA, LRI, MEN, RNE, SLU)
Sphaeralcea decipiens	URY(CAS, MON)
Sphaeralcea laciniata	ARG(COR, SLU, SFE, SDE, TUC)
Sphaeralcea mendocina	ARG(BAI, CHU, LPA, MEN, NEU, RNE, SLU)
Sphaeralcea miniata	ARG(BAI, CAT, CHA, COR, FOR, LRI, MEN, RNE, SDE, SJU, SLU, TUC)
Sphaeralcea obtusiloba	CHL(COQ, VAL, LBO, RME)
Sphaeralcea philippiana	ARG(MEN, SJU)
Sphaeralcea purpurata	ARG(BAI) / CHL(COQ, LBO, MAU, BIO, ARA)
Sphaeralcea tehuelches	ARG(CHU, SCR)
Sphaerophysa salsula	ARG(MEN)
Sphaeropteris gardneri	BRA(SCA)
Sphagneticola brachycarpa	ARG(CHA, COS, ERI, FOR, MIS, SFE) / BRA(SCA) / PRY(CEN, CON, COA, ITA, MIE, ÑEE, PAI, PHA)
Sphagneticola trilobata	BRA(PAR, RGS, SCA)
Sphenoclea zeylanica	ARG(ERI, FOR, SAL) / BRA(Fuera del área del proyecto) / PRY(APY, CEN)
Sphinctanthus hasslerianus	PRY(APY, CON)
Spigelia andina	ARG(JUJ, SAL, TUC)
Spigelia beccabungoides	PRY(CAN)
Spigelia blanchetiana	BRA(PAR)
Spigelia breviflora	ARG(JUJ) / BRA(PAR) / PRY(CON)
Spigelia caaguazuensis	ARG(MIS) / BRA(PAR) / PRY(CAU)
Spigelia catarinensis	BRA(SCA)
Spigelia dusenii	BRA(PAR, SCA)
Spigelia hatschbachii	BRA(PAR)
Spigelia humboldtiana	ARG(BAI, CHA, COS, ERI, FOR, JUJ, MIS, SAL, SFE, TUC) / BRA(PAR, RGS, SCA) / PRY(CAN, CEN, COA, GUA, PAI) / URY(RIV, SJO, TAC)
Spigelia insignis	ARG(MIS) / BRA(PAR, SCA) / PRY(MIE)
Spigelia kleinii var. kleinii	BRA(PAR, RGS, SCA) / PRY(CAU)
Spigelia kleinii var. paranaensis	BRA(PAR)
Spigelia martiana	ARG(COS, ERI, MIS) / BRA(PAR, RGS, SCA) / PRY(CAN, PAI) / URY(ART, SJO, SOR, TYT)
Spigelia nicotianaeflora	ARG(COS) / PRY(CAN)
Spigelia paraguariensis	ARG(MIS) / BRA(SCA) / PRY(APA, AMA, CAU, CAA, CAN, CEN, COA, MIE, PAI)
Spigelia pusilla	BRA(PAR, SCA)
Spigelia ramosa	PRY(PAI)
Spigelia riedeliana	BRA(RGS)
Spigelia rojasiana	BRA(PAR, SCA) / PRY(APA, AMA, CAU)
Spigelia stenophylla	ARG(COS, ERI, MIS) / BRA(PAR, RGS, SCA) / URY(CLA, PAY, RNO, RIV, TAC)
Spigelia tetraptera	BRA(PAR, SCA)
Spigelia valenzuelae var. major	PRY(SPE)
Spigelia valenzuelae var. valenzuelae	PRY(COA)
Spigelia vestita	BRA(PAR, SCA)
Spilanthes leiocarpa	CHL(TAR)
Spilanthes nervosa	BRA(Fuera del área del proyecto) / PRY(AMA, CAN, CON, SPE)
Spilanthes paraguayensis	PRY(APY, PHA)
Spiraea cantoniensis	BRA(RGS, SCA)
Spiraea douglasii	ARG(NEU, RNE)
Spirodela intermedia	ARG(BAI, CHA, COS, ERI, FOR, JUJ, MEN, MIS, NEU, SAL, SFE, TUC) / BRA(PAR, RGS, SCA) / CHL(VAL) / PRY(APY, CEN, CHO, COA, ÑEE, PHA) / URY(CAS, MON, ROC, SJO)
Spirotheca rivieri var. passifloroides	BRA(PAR, SCA)
Spirotheca rivierii var. rivieri	BRA(SCA)
Sporobolus × longispicus	ARG(BAI, CHA) / URY(CAS, MAL)
Sporobolus aeneus var. eximius	BRA(PAR, RGS) / PRY(AMA)
Sporobolus aeneus var. aeneus	ARG(MIS) / BRA(Fuera del área del proyecto) / PRY(AMA, CON, COA, SPE)
Sporobolus aeneus var. angustifolia	ARG(COS, ERI) / BRA(PAR, RGS, SCA) / PRY(APY, PAI) / URY(DUR, FLO, FLA, LAV, MAL, PAY, RIV, SJO, TAC)
Sporobolus alterniflorus	ARG(BAI, RNE) / BRA(PAR, RGS, SCA) / URY(MON)
Sporobolus ciliatus	BRA(PAR)
Sporobolus coarctatus	ARG(BAI) / BRA(PAR, RGS, SCA) / URY(ROC)
Sporobolus cryptandrus	ARG(BAI, COR, LPA, MEN, RNE, SJU, SLU, SFE)
Sporobolus densiflorus	ARG(BAI, CHA, CHU, COR, DFE, LPA, RNE, SLU, SCR, SFE) / BRA(PAR, RGS, SCA) / CHL(BIO, ARA, LLA) / URY(MON)
Sporobolus indicus var. indicus	ARG(BAI, CAT, CHA, COR, COS, DFE, ERI, FOR, JUJ, LPA, LRI, MEN, MIS, SAL, SJU, SLU, SFE, TUC) / BRA(PAR, RGS, SCA) / CHL(TAR, VAL, LBO, MAU, BIO, ARA, LLA, RME, IPA) / PRY(AMA, CEN, COA, GUA, ITA, ÑEE, PAI, PHA, SPE) / URY(CLA, COL, MAL, MON, RNO, ROC)
Sporobolus indicus var. andinus	ARG(CAT, COR, JUJ, SAL, TUC)
Sporobolus linearifolius	BRA(PAR, RGS, SCA)
Sporobolus maximus	ARG(CAT, LRI, SAL, TUC)
Sporobolus mendocinus	ARG(MEN, NEU)
Sporobolus metallicolus	BRA(PAR)
Sporobolus monandrus	ARG(CHA, COS, ERI, FOR, MIS, SAL, SFE) / BRA(RGS) / PRY(APY) / URY(ART)
Sporobolus multinodis	BRA(RGS) / URY(RIV)
Sporobolus phleoides	ARG(CAT, COR, JUJ, LPA, LRI, MEN, SAL, SJU, SLU, SFE, SDE, TUC)
Sporobolus platensis	ARG(BAI, ERI) / BRA(RGS) / URY(FLA, SAO)
Sporobolus pseudairoides	ARG(MIS) / BRA(PAR, RGS, SCA) / PRY(Desconocida)
Sporobolus pyramidalis	BRA(PAR)
Sporobolus pyramidatus	ARG(BAI, CAT, CHA, COR, COS, ERI, FOR, JUJ, LPA, LRI, MEN, SAL, SJU, SLU, SFE, SDE, TUC) / BRA(Fuera del área del proyecto) / PRY(APY) / URY(CAS, MON)
Sporobolus rigens var. expansa	ARG(BAI, CAT, CHU, COR, LPA, LRI, MEN, NEU, RNE, SAL, SJU, SLU, TUC)
Sporobolus rigens var. rigens	ARG(BAI, CAT, CHU, COR, JUJ, LPA, MEN, NEU, RNE, SAL, SFE, SJU, SLU, TUC)
Sporobolus rigens var. atacamensis	ARG(JUJ, SAL)
Sporobolus spartinus	ARG(COS, SFE) / PRY(APY, BOQ)
Sporobolus virginicus	BRA(PAR, RGS, SCA) / CHL(TAR)
Stachycephalum argentinum	ARG(CAT, JUJ, SAL, TUC)
Stachys albicaulis	ARG(MEN, NEU) / CHL(VAL, LBO, MAU, BIO, ARA, RME)
Stachys arvensis	ARG(BAI, CAT, COR, DFE, ERI, FOR, MIS, NEU, SAL, SFE, SDE, TUC) / BRA(RGS, SCA) / CHL(LLA, JFE, IPA) / PRY(ITA) / URY(MON)
Stachys bridgesii	CHL(COQ, LBO, MAU, LLA, RME)
Stachys eremicola	CHL(ANT, ATA, COQ)
Stachys gilliesii	ARG(CAT, CHA, COR, COS, FOR, JUJ, LRI, MEN, MIS, TUC) / BRA(PAR, RGS, SCA) / CHL(COQ, VAL, LBO, MAU, BIO, RME) / PRY(APY, PHA) / URY(ART, CLA, FLO, FLA, LAV, PAY, RIV, SAO, SOR, TYT)
Stachys grandidentata	CHL(ANT, ATA, COQ, VAL, LBO, MAU, BIO, ARA, LLA, RME)
Stachys macraei	CHL(COQ, VAL, LBO, MAU, BIO, ARA, LLA, AIS, RME)
Stachys ochroleuca	CHL(COQ, VAL, LBO, MAU, BIO, ARA)
Stachys pannosa	CHL(ANT, ATA, COQ, VAL, BIO)
Stachys philippiana	CHL(COQ, VAL, BIO, ARA, RME)
Stachys sericea	CHL(VAL, LBO, MAU, BIO, ARA, LLA, RME)
Stachys truncata	CHL(COQ, VAL, MAU, AIS)
Stachytarpheta angustifolia	PRY(APY)
Stachytarpheta cayennensis	ARG(CHA, COS, ERI, FOR, JUJ, MIS, SAL, SFE) / BRA(PAR, RGS, SCA) / PRY(APA, APY, AMA, CAU, CAA, CAN, CEN, CON, COA, GUA, ITA, MIE, ÑEE, PAI, PHA, SPE) / URY(ART)
Stachytarpheta fiebrigii	PRY(CON)
Stachytarpheta gesnerioides	PRY(AMA)
Stachytarpheta hassleri	PRY(COA)
Stachytarpheta laevis	BRA(RGS)
Stachytarpheta paraguariensis	BRA(SCA) / PRY(APY)
Stachytarpheta polyura	BRA(PAR)
Staelia juarezii	ARG(FOR)
Staelia nelidae	PRY(APY)
Staelia thymoides	ARG(COS, ERI, MIS) / BRA(RGS) / PRY(APY, BOQ, CAU, CEN, COA, PAI) / URY(ART)
Staelia virgata var. virgata	ARG(CHA, COS, FOR, JUJ, SAL, SDE, TUC) / BRA(Fuera del área del proyecto) / PRY(APY, CON, COA, ÑEE, PAI, PHA)
Staelia virgata var. correntina	ARG(COS)
Stangea calchaquina	ARG(CAT, JUJ, TUC)
Stangea paulae	CHL(TAR)
Stanhopea insignis	BRA(PAR, RGS, SCA)
Stanhopea lietzei	BRA(PAR, RGS, SCA)
Stanhopea xytriophora	ARG(SAL)
Stapfochloa berroi	ARG(BAI, COR, DFE, ERI, SFE) / URY(MON, PAY, RNO, SJO, SJO)
Stapfochloa canterae	ARG(BAI, CHA, COR, COS, DFE, ERI, FOR, JUJ, LPA, MEN, MIS, SAL, SFE, SDE, TUC) / BRA(RGS) / PRY(APY, AMA, BOQ, CEN, CHO, CON, COA, MIE, PAI, PHA) / URY(ART, CAS, CLA, COL, CLA, FLA, LAV, MON, PAY, RNO, RIV, ROC, SAO, TAC, TYT)
Stapfochloa elata	ARG(BAI, CAT, CHA, COR, COS, DFE, ERI, FOR, JUJ, LRI, MIS, SAL, SFE, SDE, TUC) / BRA(PAR, RGS, SCA) / PRY(APA, APY, AMA, BOQ, CEN, CON, COA, GUA, ITA, MIE, PAI, PHA) / URY(ART, FLA, RNO, SAO)
Stapfochloa parvispicula	ARG(CAT, CHA, COR, FOR, JUJ, LRI, SAL, SJU, SDE, TUC) / PRY(APY)
Staurogyne eustachya	BRA(SCA)
Staurogyne mandioccana	BRA(PAR, SCA)
Steinchisma decipiens	ARG(BAI, COS, ERI, MIS, SAL, TUC) / BRA(PAR, RGS, SCA) / PRY(AMA, CAU, CEN, CON, COA, GUA, PAI) / URY(LAV, MAL, ROC, TAC)
Steinchisma hians	ARG(BAI, CHA, COR, COS, DFE, ERI, FOR, JUJ, LPA, MIS, SAL, SDE, SFE, TUC) / BRA(PAR, RGS, SCA) / PRY(APA, APY, AMA, BOQ, CAU, CEN, CON, COA, GUA, ITA, PAI, PHA, SPE) / URY(ART, CLA, DUR, FLA, MAL, SJO, SOR, TAC)
Steinchisma laxa	ARG(BAI, CHA, COS, ERI, FOR, JUJ, MIS, SAL, SFE, TUC) / BRA(PAR, RGS, SCA) / PRY(APA, APY, AMA, BOQ, CAU, CAA, CAN, CEN, CON, COA, GUA, MIE, ÑEE, PAI, PHA, SPE) / URY(SJO)
Steinchisma spathellosa	ARG(BAI, CHA, DFE, ERI, MIS) / BRA(PAR, RGS, SCA) / PRY(APA, COA, PAI)
Stelis aprica	BRA(PAR, RGS, SCA)
Stelis aquinoana	BRA(PAR)
Stelis ciliaris	BRA(PAR, SCA)
Stelis fraterna	BRA(PAR, RGS, SCA)
Stelis intermedia	BRA(PAR, RGS, SCA)
Stelis megantha	BRA(PAR, RGS, SCA)
Stelis neorubens	BRA(PAR, SCA)
Stelis papaquerensis	BRA(PAR, RGS, SCA)
Stelis parvifolia	BRA(SCA)
Stelis pauciflora	BRA(PAR, RGS, SCA)
Stelis reitzii	BRA(SCA)
Stelis ruprechtiana	BRA(PAR, SCA)
Stellaria alsine	CHL(MAG)
Stellaria antoniana	ARG(JUJ, TUC)
Stellaria aphanantha	ARG(CAT, TUC)
Stellaria arvalis	ARG(CHU, NEU, RNE, SCR, TDF) / CHL(TAR, VAL, MAU, BIO, ARA, LLA, AIS, MAG)
Stellaria celsa	CHL(RME)
Stellaria chilensis	CHL(TAR, ANT, COQ, VAL, LBO, MAU, BIO, ARA, LLA, RME)
Stellaria circinata	CHL(RME)
Stellaria concinna	CHL(LBO, RME)
Stellaria cryptopetala	ARG(JUJ, SAL, TUC)
Stellaria cuspidata	ARG(CAT, CHU, JUJ, NEU, RNE, SAL, TUC)
Stellaria debilis	ARG(CAT, CHU, MEN, NEU, RNE, SJU, SCR, TDF) / CHL(COQ, BIO, MAG)
Stellaria graminea	ARG(TDF)
Stellaria media var. gymnocalyx	ARG(BAI, CAT, CHA, CHU, COR, COS, DFE, ERI, FOR, JUJ, LPA, LRI, MEN, MIS, NEU, RNE, SAL, SCR, SDE, SFE, SJU, TDF, TUC) / PRY(ITA)
Stellaria media var. media	ARG(BAI, CAT, CHA, CHU, COR, COS, DFE, ERI, FOR, JUJ, LPA, LRI, MEN, MIS, NEU, RNE, SAL, SCR, SDE, SFE, SJU, TDF, TUC) / BRA(RGS) / CHL(ANT, COQ, VAL, LBO, MAU, BIO, ARA, LLA, AIS, MAG, RME, JFE) / URY(ROC)
Stellaria pallida	ARG(BAI, CHU, COS, DFE, ERI, RNE) / CHL(RME)
Stellaria parva	ARG(CHA, COS, ERI, SFE) / BRA(Fuera del área del proyecto) / PRY(CEN, COA, GUA)
Stellaria parviflora ssp. ignis	ARG(TDF) / CHL(MAG)
Stellaria pedersenii	ARG(JUJ, SAL)
Stellaria serpens	CHL(RME)
Stellaria weddellii	ARG(JUJ) / CHL(TAR)
Stellaria yungasensis	ARG(SAL)
Stemodia diplohyptoides	ARG(MIS)
Stemodia durantifolia var. chilensis	ARG(RNE) / CHL(ANT, COQ, VAL, ARA)
Stemodia ericifolia	ARG(CHA, COS, FOR, SAL, SFE) / PRY(APY, BOQ, PHA)
Stemodia hassleriana	BRA(Fuera del área del proyecto) / PRY(AMA, CON)
Stemodia hyptoides	ARG(BAI, CHA, COS, ERI, FOR, MIS, SFE, TUC) / BRA(PAR, RGS, SCA) / PRY(APY, BOQ, CAA, CEN, COA, PHA) / URY(ART, CAS, CLA, COL, MAL, MON, PAY, RNO, RIV, ROC, SAO, SJO, SOR, TAC)
Stemodia lanceolata	ARG(BAI, CHA, COR, COS, ERI, FOR, MEN, MIS, RNE, SAL, SDE, SFE, TUC) / BRA(RGS) / PRY(APY, BOQ, CEN, CON, COA, ÑEE, PHA, SPE) / URY(SJO, SOR)
Stemodia palustris	ARG(CHA, COR, COS, ERI, FOR, MIS, SDE, SFE) / BRA(RGS) / PRY(APY, BOQ, CEN, COA, ÑEE, PAI, PHA) / URY(ART, CAS, CLA, FLO, FLA, PAY, RNO, RIV, SAO, SOR, TAC)
Stemodia scoparioides	ARG(COS) / PRY(AMA)
Stemodia stricta	ARG(CAT, COR, COS, ERI, JUJ, MIS, SAL, TUC) / BRA(PAR, RGS, SCA) / PRY(APY, AMA, CEN, COA, GUA, ITA, ÑEE, PAI) / URY(ART, PAY)
Stemodia tetragona	ARG(BAI, DFE, ERI, SFE) / URY(COL, RNO, ROC, SJO)
Stemodia trifoliata	BRA(PAR, SCA)
Stemodia vandellioides	BRA(PAR)
Stemodia verticillata	ARG(BAI, CHA, COR, COS, ERI, FOR, JUJ, MIS, SAL, SFE, TUC) / BRA(PAR, RGS, SCA) / PRY(CAA, CAN, COA, ÑEE) / URY(ART, CLA, PAY, RNO, RIV, SAO, TAC)
Stenachaenium adenanthum	BRA(PAR, RGS, SCA)
Stenachaenium campestre	ARG(COS, ERI, MIS) / BRA(PAR, RGS, SCA) / PRY(GUA) / URY(CLA, COL, MON, SJO, SOR)
Stenachaenium megapotamicum var. megapotamicum	ARG(COS) / BRA(PAR, RGS, SCA) / PRY(AMA, GUA) / URY(CAS, CLA, LAV, MAL, MON, PAY, RIV, ROC, SJO, TAC)
Stenachaenium megapotamicum f. minor	PRY(COA)
Stenachaenium megapotamicum var. pedunculata	PRY(SPE)
Stenachaenium riedelii	ARG(CHA, COS, ERI, MIS, SFE) / BRA(PAR, RGS, SCA) / PRY(APA, AMA, CAU, CAN, COA, GUA, MIE, PAI) / URY(RIV, TAC)
Stenandrium affine	PRY(AMA)
Stenandrium diphyllum	ARG(CAT, COR, COS, ERI, FOR, JUJ, LRI, MIS, SAL, SDE, SFE, SLU, TUC) / BRA(RGS) / PRY(APY, CAN, CEN, CON, COA, PAI, SPE)
Stenandrium dulce	ARG(BAI, CAT, CHA, COR, COS, ERI, FOR, JUJ, LPA, LRI, MEN, MIS, SAL, SDE, SFE, SJU, SLU, TUC) / BRA(RGS) / CHL(COQ, VAL, LBO, BIO, ARA, RME) / PRY(AMA, CEN, CON, COA, GUA, ÑEE, PAI) / URY(SAO, TAC)
Stenandrium mandioccanum	ARG(CHA, JUJ, MIS, SAL) / BRA(RGS, SCA) / PRY(APY, APA, AMA, CEN, CON, COA)
Stenandrium pohlii var. pusillum	BRA(PAR)
Stenandrium pohlii var. breviscapum	BRA(Fuera del área del proyecto) / PRY(AMA, CON)
Stenandrium tenellum	BRA(RGS, SCA)
Stenocephalum hexanthum	ARG(COS, ERI, MIS, SFE) / BRA(PAR, SCA) / PRY(APA, AMA, CAU, CAA, COA, MIE, PAI)
Stenocephalum megapotamicum	ARG(COS, ERI, MIS) / BRA(PAR, RGS, SCA) / PRY(GUA) / URY(ART, CLA, LAV, PAY, RNO, RIV, SAO, TAC)
Stenodrepanum bergii	ARG(CAT, COR, LRI, SJU)
Stenotaphrum secundatum	ARG(BAI, COR, ERI, SLU, SFE, TUC) / BRA(PAR, RGS, SCA) / CHL(TAR, BIO, LLA) / PRY(CEN) / URY(ROC)
Stephostachys mertensii	ARG(CHA, COS, FOR, MIS, SFE) / BRA(PAR, SCA) / PRY(APY, AMA, CEN, CON, ÑEE, PAI, PHA, SPE)
Sterculia striata	BRA(Fuera del área del proyecto) / PRY(APY, AMA, CEN, CON, COA)
Stetsonia coryne	ARG(CAT, CHA, COR, FOR, JUJ, LRI, SAL, SDE, SFE) / PRY(APY, CON, PHA)
Stevia achalensis	ARG(COR, JUJ, MEN, SAL, TUC)
Stevia alpina var. alpina	ARG(CAT, JUJ, LRI, SAL, TUC)
Stevia alpina var. glutinosa	ARG(CAT)
Stevia alternifolia	BRA(PAR, RGS, SCA)
Stevia amambayensis	PRY(AMA, COA, PAI)
Stevia ammotropha	PRY(CAU, CEN, MIE)
Stevia amplexicaulis	PRY(AMA)
Stevia apensis	PRY(CON, PAI)
Stevia aristata	ARG(BAI, COR, COS, ERI, MIS, SFE) / PRY(APA, CAU, CEN, CON, COA, GUA, PAI, SPE) / URY(PAY, SJO)
Stevia balansae	BRA(PAR, SCA) / PRY(AMA, CAU, CEN, CON, COA, GUA, PAI, SPE)
Stevia breviaristata	ARG(CAT, COR, JUJ, LRI, SAL, SJU, TUC) / PRY(APY)
Stevia burkartii	ARG(COS, ERI) / URY(TAC)
Stevia camachensis	ARG(JUJ, SAL)
Stevia carapariensis	ARG(SAL)
Stevia catharinensis	BRA(PAR, RGS, SCA) / PRY(CON)
Stevia centinelae	ARG(JUJ)
Stevia chamaedrys var. glandulifera	ARG(CAT, JUJ, LRI)
Stevia chamaedrys var. chamaedrys	ARG(CAT, JUJ, LRI, SAL, TUC) / CHL(TAR)
Stevia cinerascens	ARG(MIS) / BRA(PAR, RGS, SCA) / URY(RNO, RIV, SOR)
Stevia clausseni	BRA(PAR, SCA)
Stevia commixta	BRA(PAR, RGS, SCA) / PRY(AMA, CAU)
Stevia congesta	URY(CAS, MAL)
Stevia crassicephala	ARG(JUJ)
Stevia crenulata	BRA(PAR)
Stevia cruziana	BRA(RGS)
Stevia cuneata	PRY(AMA)
Stevia entreriensis	ARG(CHA, COS, ERI, FOR, MIS, SFE) / PRY(APY, AMA, CEN, CON, COA, PAI, PHA) / URY(COL, RNO, TAC)
Stevia estrellensis	PRY(AMA)
Stevia fiebrigii var. jujuiensis	ARG(JUJ)
Stevia fiebrigii var. vattuonei	ARG(CAT, SAL)
Stevia fiebrigii var. fiebrigii	ARG(JUJ, SAL)
Stevia gardneriana	BRA(PAR)
Stevia gilliesii var. glandulosa	ARG(CAT, LRI, SJU)
Stevia gilliesii var. gilliesii	ARG(CAT, LRI, MEN, SDE, SJU, SLU)
Stevia gratioloides	BRA(RGS) / URY(ART, DUR, RIV, ROC, TAC, TYT)
Stevia involucrata	BRA(RGS, SCA)
Stevia jujuyensis	ARG(JUJ)
Stevia leptophylla	BRA(PAR) / PRY(COA, PAI)
Stevia lilloi	ARG(JUJ, SAL, TUC)
Stevia lundiana	ARG(CHA, ERI, MIS) / BRA(PAR, RGS, SCA)
Stevia maimarensis	ARG(CAT, COR, JUJ, SAL, SLU, TUC)
Stevia menthaefolia	BRA(PAR)
Stevia mercedensis var. glanditecta	ARG(CAT, COR, JUJ, SLU)
Stevia mercedensis var. pereyrae	ARG(JUJ, SAL)
Stevia mercedensis var. mercedensis	ARG(CAT, COR, JUJ, LRI, SAL, SLU, SDE, TUC)
Stevia minor	ARG(CAT, JUJ, LRI, MEN, SAL, TUC)
Stevia multiaristata	ARG(BAI, COR, COS, ERI, MIS) / BRA(RGS) / URY(COL, FLA, LAV, MON, PAY, RIV, SJO, TYT)
Stevia myriadenia	BRA(SCA)
Stevia okadae	ARG(SAL)
Stevia ophryodonta	URY(TYT)
Stevia ophryophylla	BRA(PAR, SCA)
Stevia parvifolia	BRA(PAR, SCA) / PRY(AMA)
Stevia philippiana	CHL(TAR, ANT, ATA)
Stevia pohliana	BRA(PAR)
Stevia potrerensis	ARG(JUJ, SAL)
Stevia procumbens	ARG(JUJ, LRI, SAL)
Stevia rebaudiana	BRA(Fuera del área del proyecto) / PRY(APA, AMA, CAA, CEN, CON, COA, ITA)
Stevia regnellii	BRA(PAR)
Stevia rojasii	PRY(AMA)
Stevia sabulonis	PRY(MIE) / URY(MAL)
Stevia sanguinea	ARG(JUJ, SAL, TUC)
Stevia satureiifolia var. satureiifolia	ARG(BAI, CAT, COR, ERI, LPA, MEN, NEU, RNE, SLU, SDE) / BRA(PAR, RGS) / URY(CAS, COL, MAL, MON, ROC, SJO, SOR)
Stevia satureiifolia var. ventanensis	ARG(BAI)
Stevia satureiifolia var. patagonica	ARG(BAI, COR, LPA, MEN, NEU, RNE)
Stevia schreiteri	ARG(SAL)
Stevia selloi	ARG(COS, MIS) / BRA(RGS, SCA) / PRY(AMA, CAU, CAA, CAN, COA, GUA, ITA, MIE, PAI, SPE) / URY(MAL)
Stevia spathulata	BRA(RGS) / PRY(CAU)
Stevia tarijensis	ARG(JUJ)
Stevia tenuis	BRA(PAR, RGS, SCA)
Stevia vaga var. effusa	ARG(CAT, COR, JUJ, LRI, SAL, SJU, TUC)
Stevia vaga var. vaga	ARG(CAT, JUJ, LRI, SAL, SJU, TUC)
Stevia vaga var. saltensis	ARG(CAT, JUJ, SAL, TUC)
Stevia veronicae	BRA(PAR, RGS, SCA)
Stevia villaricensis	ARG(MIS) / PRY(GUA)
Stevia yaconensis var. subeglandulosa	ARG(CAT, JUJ, SAL, TUC)
Stevia yaconensis var. yaconensis	ARG(JUJ, SAL)
Stevia yaconensis var. aristifera	ARG(JUJ, SAL, TUC)
Stevia yaconensis var. saltensis	ARG(JUJ, SAL, SJU)
Stevia yalae	ARG(JUJ)
Sticherus bifidus	BRA(PAR, RGS, SCA) / PRY(AMA, PAI) / URY(RIV)
Sticherus cryptocarpus	ARG(CHU, NEU, RNE, SCR, TDF) / CHL(BIO, ARA, LLA, AIS, MAG)
Sticherus decurrens	BRA(PAR, RGS, SCA)
Sticherus ferrugineus	BRA(PAR, RGS, SCA)
Sticherus gracilis	BRA(PAR, SCA)
Sticherus lanuginosus	BRA(PAR, RGS) / PRY(CAN)
Sticherus lepidotus	CHL(JFE)
Sticherus litoralis	CHL(LLA, AIS, MAG)
Sticherus nigropaleaceus	BRA(SCA)
Sticherus pruinosus	BRA(PAR, RGS, SCA)
Sticherus quadripartitus	ARG(CHU, NEU, RNE, TDF) / CHL(BIO, ARA, LLA, AIS, MAG, JFE)
Sticherus remotus	BRA(PAR, SCA)
Sticherus squamosus	BRA(PAR, SCA)
Sticherus squamulosus var. squamulosus	CHL(BIO, ARA, LLA, AIS, JFE)
Sticherus squamulosus var. gunckelianus	CHL(ARA, LLA)
Stigmaphyllon arenicola	BRA(PAR)
Stigmaphyllon bonariense	ARG(BAI, CHA, COS, DFE, ERI, MIS, SFE) / BRA(PAR, RGS) / PRY(APY, APA, ITA, MIE, ÑEE) / URY(COL, MON, RNO)
Stigmaphyllon calcaratum	ARG(CHA, COS, ERI, FOR, SFE) / BRA(Fuera del área del proyecto) / PRY(APY, CEN, CON, PHA)
Stigmaphyllon ciliatum	BRA(PAR, RGS, SCA) / URY(MON)
Stigmaphyllon jatrophifolium	ARG(COS, ERI, MIS) / BRA(PAR, RGS, SCA) / PRY(APA, APY, CAU, CAA, CON, COA, GUA, ITA, MIE, PAI, PHA, SPE) / URY(MON, SAO)
Stigmaphyllon tomentosum	BRA(PAR, SCA)
Stigmatopteris brevinervis	BRA(PAR, SCA)
Stigmatopteris caudata	BRA(PAR, SCA)
Stigmatopteris heterocarpa	BRA(PAR, SCA)
Stigmatopteris ulei	BRA(SCA)
Stigmatosema garayana	BRA(PAR)
Stigmatosema hatschbachii	BRA(PAR)
Stigmatosema odileana	ARG(COS) / BRA(SCA)
Stillingia bodenbenderi	ARG(COR) / BRA(PAR)
Stillingia oppositifolia	BRA(RGS)
Stillingia patagonica	ARG(CHU, MEN, NEU, RNE, SCR)
Stillingia salpingadenia	ARG(CHA, COS, MIS) / PRY(AMA, COA, GUA)
Stillingia scutellifera	ARG(COS, MIS) / PRY(AMA, CAA, CAN, GUA, PAI, SPE)
Stillingia tenella	ARG(JUJ, SAL)
Stilpnopappus regnellii	BRA(PAR)
Stipa speciosa var. comosa	ARG(MEN)
Stizophyllum perforatum	BRA(PAR)
Stomatanthes oblongifolius	ARG(ERI, MIS, TUC) / BRA(PAR, RGS, SCA) / PRY(CAU, MIE) / URY(MAL, PAY, RNO, RIV, ROC, TAC)
Streblacanthus dubiosus	ARG(MIS, SAL) / PRY(APY, APA, CAA, CAN, CEN, COA, GUA, ITA, PAI)
Streptochaeta spicata	ARG(MIS) / BRA(PAR, RGS, SCA) / PRY(AMA, CAN, GUA)
Strigosella africana	ARG(LPA, MEN, NEU, RNE)
Stromanthe papillosa 	BRA(PAR, SCA)
Stromanthe thalia	BRA(PAR, SCA)
Stromanthe tonckat	BRA(PAR, RGS)
Struchium sparganophorum	BRA(SCA)
Struthanthus acuminatus	ARG(SAL) / PRY(APY, PHA)
Struthanthus sessiliflorus	BRA(PAR, SCA)
Struthanthus uraguensis	ARG(COR, COS, ERI, FOR, LRI, MIS, SAL, SDE) / BRA(PAR, RGS, SCA) / PRY(APY, CON, PHA) / URY(PAY, SAO, TYT)
Strychnos brasiliensis	ARG(COS, MIS) / BRA(PAR, RGS, SCA) / PRY(APA, CAU, CAA, CON, COA, GUA) / URY(ART)
Strychnos fulvotomentosa	BRA(PAR)
Strychnos nigricans	BRA(PAR)
Strychnos parvifolia	BRA(Fuera del área del proyecto) / PRY(COA)
Strychnos pseudoquina	BRA(Fuera del área del proyecto) / PRY(AMA)
Strychnos rubiginosa	BRA(PAR)
Strychnos trinervis	BRA(PAR, RGS, SCA)
Stryphnodendron adstringens	BRA(PAR)
Stryphnodendron obovatum	BRA(PAR) / PRY(AMA, CAN)
Stuckenia filiformis ssp. alpina	ARG(CAT, CHU, JUJ, LRI, MEN, NEU, SAL, SCR, SJU, TDF, TUC) / CHL(ANT, ATA, COQ, MAG)
Stuckenia pectinata	ARG(BAI, JUJ, MEN, RNE) / CHL(VAL, MAU, RME)
Stuckenia striata	ARG(BAI, CAT, CHU, COR, ERI, FOR, JUJ, LPA, LRI, MEN, NEU, RNE, SAL, SDE, SFE, SJU, SLU, TUC) / CHL(VAL, LLA, RME) / PRY(PHA) / URY(MON)
Stuckertiella capitata	ARG(JUJ, SAL, TUC)
Stuckertiella peregrina	ARG(BAI, CAT, COR, LPA, LRI, MEN, RNE, SAL, SLU, TUC)
Stylogyne pauciflora	BRA(PAR)
Stylosanthes acuminata	BRA(PAR) / PRY(CAN, COA)
Stylosanthes bracteata	BRA(PAR) / PRY(AMA, CAN, SPE)
Stylosanthes capitata	BRA(PAR) / PRY(APY)
Stylosanthes gracilis	BRA(PAR) / PRY(AMA, CON)
Stylosanthes guianensis var. robusta	ARG(MIS) / BRA(Fuera del área del proyecto) / PRY(AMA, ITA, SPE)
Stylosanthes guianensis var. guianensis	ARG(COR, COS, MIS) / BRA(PAR) / PRY(AMA, CAU, CAN, CON, COA, ÑEE, PHA, SPE)
Stylosanthes guianensis var. subviscosa	ARG(BAI, COR, COS, ERI, MIS) / BRA(PAR, RGS, SCA) / PRY(CEN, GUA) / URY(ART, CAS, COL, PAY, RNO, RIV, SAO, SOR, TAC)
Stylosanthes leiocarpa	BRA(PAR, RGS, SCA) / PRY(CEN, COA) / URY(CAS, CLA, COL, MAL, MON, RIV, ROC, SJO, TAC, TYT)
Stylosanthes longiseta	BRA(PAR) / PRY(CAU)
Stylosanthes macrosoma	ARG(CHA, COS, TUC) / PRY(APY, CEN)
Stylosanthes montevidensis var. intermedia	ARG(COS, ERI, MIS, TUC) / BRA(PAR, SCA) / PRY(AMA, CEN, COA, GUA, SPE) / URY(ART, CAS, COL, LAV, MON, PAY, RNO, RIV, ROC, SAO, TAC)
Stylosanthes montevidensis var. montevidensis	ARG(BAI, CHA, COR, COS, ERI, JUJ, LPA, MIS, SAL, SFE, TUC) / BRA(PAR, RGS, SCA) / PRY(AMA, PAI, PHA) / URY(ART, CLA, MON, PAY, RNO, RIV, ROC, SAO, SJO, SOR, TAC)
Stylosanthes nervosa	ARG(COS, SAL)
Stylosanthes recta	PRY(APY, PHA)
Stylosanthes rostrata	ARG(COS) / URY(COL)
Stylosanthes scabra	ARG(JUJ, SAL) / BRA(RGS) / PRY(APY)
Stylosanthes viscosa	ARG(CHA) / BRA(PAR, SCA) / PRY(AMA, CON)
Styrax acuminatus	BRA(PAR, RGS, SCA) / PRY(AMA, CAN) / URY(MON)
Styrax camporum	BRA(PAR) / PRY(AMA, CAA, CAN, CON, PAI, SPE)
Styrax ferrugineus	BRA(PAR) / PRY(AMA, CAN, COA)
Styrax glabratus	BRA(PAR, SCA)
Styrax latifolius	BRA(PAR, SCA)
Styrax leprosus	ARG(COS, MIS) / BRA(PAR, RGS, SCA) / PRY(APA, AMA, CAU, CAA, CAN, GUA) / URY(CLA, MAL, RIV, TYT)
Styrax martii	BRA(PAR, RGS)
Styrax pohlii	PRY(AMA, CAN)
Styrax subargenteus	ARG(JUJ, SAL, TUC)
Suaeda altissima	ARG(RNE)
Suaeda argentinensis	ARG(BAI, CHU, MEN, RNE, SCR, TDF) / CHL(MAG)
Suaeda densiflora	ARG(RNE)
Suaeda divaricata	ARG(BAI, CAT, CHU, COR, FOR, JUJ, LPA, LRI, MEN, NEU, RNE, SAL, SJU, SLU, SFE, SDE, TUC)
Suaeda foliosa	CHL(TAR, ANT, ATA, COQ)
Suaeda fruticosa	ARG(BAI)
Suaeda multiflora	CHL(ATA)
Suaeda nesophila	CHL(IDE)
Suaeda neuquenensis	ARG(NEU)
Suaeda patagonica	ARG(BAI, CHU, COR, ERI, LPA, MEN, RNE, SCR, SFE) / CHL(MAG)
Suksdorfia alchemilloides	ARG(JUJ, SAL, TUC)
Swartzia multijuga	BRA(PAR)
Sweetia atrata	PRY(CAU)
Sweetia fruticosa var. fruticosa	ARG(MIS) / BRA(PAR) / PRY(AMA, CAN, CEN, CON, COA, PAI)
Syagrus campylospatha	PRY(CEN, CON, COA, PAI)
Syagrus graminifolia	BRA(Fuera del área del proyecto) / PRY(CAN, SPE)
Syagrus oleracea	BRA(PAR) / PRY(AMA)
Syagrus petraea	BRA(Fuera del área del proyecto) / PRY(AMA, CAU, CAA, CAN, CON)
Syagrus romanzoffiana	ARG(BAI, CHA, COS, ERI, FOR, MEN, MIS, SFE, SJU, SLU) / BRA(PAR, RGS, SCA) / PRY(APA, AMA, CAN, CEN, COA, GUA, ÑEE, PAI) / URY(MAL, MON, RIV, ROC, SAO, TAC, TYT)
Symphoricarpos albus	ARG(NEU, RNE)
Symphyotrichum glabrifolium	ARG(MEN, NEU, RNE, SCR) / CHL(MAU, BIO, ARA, LLA, AIS, MAG)
Symphyotrichum graminifolium	ARG(BAI, CHA, COR, COS, ERI, SFE) / BRA(PAR, RGS, SCA) / PRY(APY) / URY(FLA)
Symphyotrichum patagonicum	ARG(CHU, MEN, NEU, SCR)
Symphyotrichum peteroanum	ARG(NEU) / CHL(LBO, MAU, BIO, ARA, LLA)
Symphyotrichum regnellii	ARG(COS, MIS) / BRA(PAR, RGS, SCA)
Symphyotrichum squamatum	ARG(BAI, CAT, CHA, CHU, COR, COS, ERI, FOR, JUJ, LRI, MEN, MIS, RNE, SAL, SJU, SLU, SCR, SFE, SDE, TUC) / BRA(PAR, RGS) / CHL(TAR, ATA, COQ, VAL, LBO, MAU, BIO, ARA, RME) / PRY(APY, CAU, CAA, CEN, CON, COA, GUA, PAI, PHA, SPE) / URY(MON, TYT)
Symphyotrichum vahlii	ARG(CHU, MEN, NEU, RNE, SCR, TDF) / CHL(LBO, MAU, BIO, ARA, LLA, AIS, MAG)
Symphytum officinale	ARG(BAI)
Symplocos bidana	BRA(PAR, SCA)
Symplocos celastrinea	ARG(MIS) / BRA(PAR, SCA) / PRY(APA, AMA, CAU, CAA, CAN, COA, PAI, SPE)
Symplocos corymboclados	BRA(PAR, SCA)
Symplocos estrellensis	BRA(PAR)
Symplocos glandulosomarginata	BRA(PAR, SCA)
Symplocos incrassata	BRA(PAR)
Symplocos kleinii	BRA(PAR)
Symplocos lanceolata	BRA(PAR) / PRY(APA, CAN, PHA)
Symplocos laxiflora	BRA(PAR, SCA)
Symplocos nitens	BRA(PAR) / PRY(PAI)
Symplocos nitidiflora	BRA(PAR, SCA)
Symplocos pentandra	BRA(PAR, RGS, SCA)
Symplocos pubescens	BRA(PAR) / PRY(CAN)
Symplocos pustulosa	BRA(PAR, SCA)
Symplocos tenuifolia	BRA(PAR, SCA)
Symplocos tetrandra	BRA(PAR, RGS, SCA)
Symplocos trachycarpos	BRA(RGS, SCA) / PRY(AMA)
Symplocos uniflora	ARG(BAI, COS, ERI, MIS) / BRA(PAR, RGS, SCA) / PRY(APA, CAU, CAA, COA, GUA, SPE) / URY(CLA, RIV, TAC)
Symplocos variabilis	BRA(PAR, SCA)
Synammia espinosae	CHL(ANT, ATA)
Synammia feuillei var. ibañezii	CHL(LLA)
Synammia feuillei var. feuillei	ARG(CHU, NEU, RNE, SCR) / CHL(COQ, VAL, MAU, BIO, ARA, LLA, AIS, MAG)
Synammia intermedia ssp. intermedia	CHL(JFE)
Synammia intermedia ssp. masafuerana	CHL(JFE)
Synandrospadix vermitoxicum	ARG(CAT, CHA, COR, COS, FOR, JUJ, SAL, SDE, TUC) / PRY(APY, CEN, PHA)
Synanthes bertonii	ARG(MIS) / PRY(AMA)
Synedrella nodiflora	BRA(PAR, RGS, SCA) / PRY(APA)
Synedrellopsis grisebachii	ARG(CAT, CHA, COR, COS, ERI, FOR, JUJ, LRI, SAL, SLU, SDE, TUC) / PRY(APY, AMA)
Syngonanthus anthemidiflorus	ARG(MIS) / BRA(Fuera del área del proyecto)
Syngonanthus caulescens var. caulescens	ARG(COS, MIS) / BRA(PAR, RGS, SCA) / PRY(APA, AMA, CAU, CAA, CAN, CEN, CON, COA, GUA, ITA, MIE, ÑEE, PAI, SPE) / URY(MAL)
Syngonanthus chrysanthus var. chrysanthus	BRA(PAR, RGS, SCA) / URY(CAS, MAL, MON)
Syngonanthus fischerianus	BRA(PAR, SCA)
Syngonanthus gracilis	BRA(SCA) / PRY(APA, AMA, CAU, CON) / URY(CAS)
Syngonanthus helminthorrhizus	BRA(RGS) / PRY(AMA)
Syngonanthus nanus	BRA(PAR)
Syngonanthus nitens	BRA(PAR) / PRY(AMA, CAU, CON, PHA, SPE)
Syringa vulgaris	ARG(RNE)
